Week,TargetSubnet,TargetIP,Connections,Outbound,Inbound,TotalBytes,SourceIPs,SourcePorts,TargetPorts,Difference,Color
Feb 2020,1,21,43,4886568,4800416,9686984,2,7,1,86152,Out > In
Feb 2020,100,132,137,28763911,11761284,40525195,87,93,31,17002627,Out > In
Feb 2020,100,80,4,463774,233091,696865,4,4,2,230683,Out > In
Feb 2020,101,104,3,18783717,3624263,22407980,3,3,3,15159454,Out > In
Feb 2020,101,105,10,112483655,9693857,122177512,2,10,10,102789798,Out > In
Feb 2020,101,160,367,1568443035,100069158,1668512193,192,289,4,1468373877,Out > In
Feb 2020,101,171,1,2124636,489204,2613840,1,1,1,1635432,Out > In
Feb 2020,101,175,1,45255,109841,155096,1,1,1,64586,In > Out
Feb 2020,101,176,1,65203848,38694344,103898192,1,1,1,26509504,Out > In
Feb 2020,101,186,5,84151352,4831501,88982853,2,5,1,79319851,Out > In
Feb 2020,101,204,1,428552,127128,555680,1,1,1,301424,Out > In
Feb 2020,101,208,8,6709800,128554,6838354,5,8,1,6581246,Out > In
Feb 2020,101,211,5,15462076,3769386,19231462,1,5,1,11692690,Out > In
Feb 2020,101,215,1,92240,89472,181712,1,1,1,2768,Out > In
Feb 2020,101,217,4,449030998,15680997,464711995,2,4,4,433350001,Out > In
Feb 2020,101,218,2,83159982,1171159,84331141,1,2,2,81988823,Out > In
Feb 2020,101,224,1,4228,414196,418424,1,1,1,409968,In > Out
Feb 2020,101,231,2,2199957,589056,2789013,1,2,2,1610901,Out > In
Feb 2020,101,69,134,284899306,5434045,290333351,65,134,1,279465261,Out > In
Feb 2020,101,91,4,284393,7658075,7942468,2,3,4,7373682,In > Out
Feb 2020,102,102,211,1478337613,529926924,2008264537,64,210,1,948410689,Out > In
Feb 2020,103,231,335,180422970,67682571,248105541,159,231,1,112740399,Out > In
Feb 2020,103,237,6,4672870628,67381640,4740252268,1,6,6,4605488988,Out > In
Feb 2020,103,246,1,52107,145808,197915,1,1,1,93701,In > Out
Feb 2020,104,108,3,541088916,6838622,547927538,3,3,3,534250294,Out > In
Feb 2020,104,111,3,6165320053,2203665461,8368985514,2,3,2,3961654592,Out > In
Feb 2020,104,127,2,875567674,8474898,884042572,2,2,1,867092776,Out > In
Feb 2020,104,152,1,28992014,77646877,106638891,1,1,1,48654863,In > Out
Feb 2020,104,161,9,16590345,22221248,38811593,1,9,1,5630903,In > Out
Feb 2020,104,163,1,25114007,1187242,26301249,1,1,1,23926765,Out > In
Feb 2020,104,211,10,8426509,18629334,27055843,3,10,3,10202825,In > Out
Feb 2020,104,224,1,4288577,3937868,8226445,1,1,1,350709,Out > In
Feb 2020,104,85,1,15372,144080,159452,1,1,1,128708,In > Out
Feb 2020,104,96,1,10647927,2949096,13597023,1,1,1,7698831,Out > In
Feb 2020,109,188,4,1535470079,1293889346,2829359425,2,4,4,241580733,Out > In
Feb 2020,110,161,5,3494823,363565,3858388,2,5,2,3131258,Out > In
Feb 2020,111,5,56,174918754,136664860,311583614,20,32,16,38253894,Out > In
Feb 2020,112,100,2,35630890,89735005,125365895,2,2,2,54104115,In > Out
Feb 2020,112,102,1,291513,606734,898247,1,1,1,315221,In > Out
Feb 2020,112,104,36,195467,5248111,5443578,36,33,8,5052644,In > Out
Feb 2020,112,107,2,167908533,120701957,288610490,2,2,2,47206576,Out > In
Feb 2020,112,111,15,1632902152,426643923,2059546075,8,10,4,1206258229,Out > In
Feb 2020,112,112,9,146238672,155281832,301520504,4,9,5,9043160,In > Out
Feb 2020,112,114,1,455471,670761,1126232,1,1,1,215290,In > Out
Feb 2020,112,115,260,1558061610,3382340318,4940401928,184,178,3,1824278708,In > Out
Feb 2020,112,119,2,158898009,418431362,577329371,2,2,1,259533353,In > Out
Feb 2020,112,123,1,13099761,12337508,25437269,1,1,1,762253,Out > In
Feb 2020,112,129,2,559156,1269397,1828553,2,2,2,710241,In > Out
Feb 2020,112,130,4,141014370,95356206,236370576,3,4,4,45658164,Out > In
Feb 2020,112,131,8,6253936,6279958,12533894,5,5,6,26022,In > Out
Feb 2020,112,133,2,4983817,6149071,11132888,2,1,1,1165254,In > Out
Feb 2020,112,134,1,55990160,43973866,99964026,1,1,1,12016294,Out > In
Feb 2020,112,135,6,206964611,288353506,495318117,4,6,2,81388895,In > Out
Feb 2020,112,138,8,739228176,3225569794,3964797970,7,7,4,2486341618,In > Out
Feb 2020,112,140,2,706444,15325398,16031842,2,2,2,14618954,In > Out
Feb 2020,112,141,5,14993066,52188424,67181490,5,5,5,37195358,In > Out
Feb 2020,112,145,10,613365696,561259755,1174625451,9,9,10,52105941,Out > In
Feb 2020,112,147,3,36827719,319846,37147565,2,2,2,36507873,Out > In
Feb 2020,112,148,1,33425,176231,209656,1,1,1,142806,In > Out
Feb 2020,112,15,158,2254101345,3541688163,5795789508,97,156,2,1287586818,In > Out
Feb 2020,112,151,1,84453508,514676309,599129817,1,1,1,430222801,In > Out
Feb 2020,112,152,1,302734001,215604568,518338569,1,1,1,87129433,Out > In
Feb 2020,112,153,6,106308764,119096814,225405578,4,6,6,12788050,In > Out
Feb 2020,112,154,3,59028327,48931885,107960212,3,2,3,10096442,Out > In
Feb 2020,112,155,1,531716,553007,1084723,1,1,1,21291,In > Out
Feb 2020,112,159,2,76097898,109858529,185956427,2,2,2,33760631,In > Out
Feb 2020,112,162,1,29250,88314,117564,1,1,1,59064,In > Out
Feb 2020,112,164,1,69271,239145,308416,1,1,1,169874,In > Out
Feb 2020,112,166,12,22059480,22087046,44146526,12,8,3,27566,In > Out
Feb 2020,112,167,1,57482708,56931633,114414341,1,1,1,551075,Out > In
Feb 2020,112,168,1,28797,122360,151157,1,1,1,93563,In > Out
Feb 2020,112,170,2,424912,391931,816843,2,2,2,32981,Out > In
Feb 2020,112,171,12,289232893,142620635,431853528,6,11,10,146612258,Out > In
Feb 2020,112,173,8,562760820,1040580857,1603341677,5,4,4,477820037,In > Out
Feb 2020,112,174,1,688617,508159,1196776,1,1,1,180458,Out > In
Feb 2020,112,176,22,9849682,23105489,32955171,21,7,3,13255807,In > Out
Feb 2020,112,177,9,40757660,61727393,102485053,3,5,8,20969733,In > Out
Feb 2020,112,178,1,38812521,45247469,84059990,1,1,1,6434948,In > Out
Feb 2020,112,181,1,209209180,94537433,303746613,1,1,1,114671747,Out > In
Feb 2020,112,182,11,1299901208,1643919281,2943820489,4,4,1,344018073,In > Out
Feb 2020,112,183,2,318912,676902,995814,2,2,2,357990,In > Out
Feb 2020,112,184,3,1167612,995852,2163464,3,1,3,171760,Out > In
Feb 2020,112,186,2,566762,1338483,1905245,2,2,2,771721,In > Out
Feb 2020,112,188,2,137816837,58643843,196460680,2,2,2,79172994,Out > In
Feb 2020,112,189,66,47514337,86990748,134505085,48,39,5,39476411,In > Out
Feb 2020,112,190,1,2418371,2189553,4607924,1,1,1,228818,Out > In
Feb 2020,112,193,3,15477378,26740652,42218030,3,3,3,11263274,In > Out
Feb 2020,112,199,1,183361857,67243086,250604943,1,1,1,116118771,Out > In
Feb 2020,112,202,4,259978988,355780312,615759300,3,3,3,95801324,In > Out
Feb 2020,112,204,1,17259638,22883077,40142715,1,1,1,5623439,In > Out
Feb 2020,112,205,2,2865181,2255015,5120196,2,2,2,610166,Out > In
Feb 2020,112,206,1,525479,108856,634335,1,1,1,416623,Out > In
Feb 2020,112,207,2,28635652,98713806,127349458,2,2,2,70078154,In > Out
Feb 2020,112,208,7,8342401,15765174,24107575,5,6,7,7422773,In > Out
Feb 2020,112,211,76,4799779656,237587581,5037367237,62,61,8,4562192075,Out > In
Feb 2020,112,212,3,533849212,55800095,589649307,1,3,3,478049117,Out > In
Feb 2020,112,213,3,112654622,210185344,322839966,2,2,3,97530722,In > Out
Feb 2020,112,216,1,7424,138743,146167,1,1,1,131319,In > Out
Feb 2020,112,219,49,687356,16951209,17638565,49,47,8,16263853,In > Out
Feb 2020,112,22,1,254156925,268511452,522668377,1,1,1,14354527,In > Out
Feb 2020,112,220,3,176374,2264278,2440652,3,2,3,2087904,In > Out
Feb 2020,112,25,1,645425,576839,1222264,1,1,1,68586,Out > In
Feb 2020,112,30,3,880940720,845794243,1726734963,3,2,2,35146477,Out > In
Feb 2020,112,32,123,853876373,17211159,871087532,98,51,3,836665214,Out > In
Feb 2020,112,49,3,219813782,128174439,347988221,3,3,3,91639343,Out > In
Feb 2020,112,63,1,230742,662369,893111,1,1,1,431627,In > Out
Feb 2020,112,64,3,134911801,73714272,208626073,3,3,3,61197529,Out > In
Feb 2020,112,72,2,2953317,41239580,44192897,2,2,2,38286263,In > Out
Feb 2020,112,73,2,531345039,445820050,977165089,2,2,2,85524989,Out > In
Feb 2020,112,74,2,757779,541808,1299587,2,2,2,215971,Out > In
Feb 2020,112,76,1,75179,462778,537957,1,1,1,387599,In > Out
Feb 2020,112,88,1,861576,553315271,554176847,1,1,1,552453695,In > Out
Feb 2020,112,90,6,41651104,35209754,76860858,6,6,6,6441350,Out > In
Feb 2020,112,91,1,241415,175514,416929,1,1,1,65901,Out > In
Feb 2020,112,93,2,702407,2229447,2931854,2,2,2,1527040,In > Out
Feb 2020,112,94,1,38252855,39118838,77371693,1,1,1,865983,In > Out
Feb 2020,112,99,14,555638915,657102544,1212741459,10,11,12,101463629,In > Out
Feb 2020,114,110,1,1246060,78532,1324592,1,1,1,1167528,Out > In
Feb 2020,115,185,3,740432233,6314664,746746897,2,3,3,734117569,Out > In
Feb 2020,117,149,59,11782006,3753819,15535825,4,59,2,8028187,Out > In
Feb 2020,117,16,17,7118186,213542,7331728,1,17,1,6904644,Out > In
Feb 2020,117,177,31,3923712,5858669,9782381,1,1,1,1934957,In > Out
Feb 2020,117,208,27,392403005,5202705,397605710,2,26,3,387200300,Out > In
Feb 2020,117,209,8,89032513,207561703,296594216,4,4,8,118529190,In > Out
Feb 2020,117,236,93,25242781,3967861,29210642,7,93,2,21274920,Out > In
Feb 2020,117,238,4,376000,373384,749384,1,1,1,2616,Out > In
Feb 2020,117,254,427,758973360,27954436,786927796,56,359,1,731018924,Out > In
Feb 2020,117,50,209,339717086,17631387,357348473,1,57,205,322085699,Out > In
Feb 2020,117,61,4,100487752,16344732,116832484,1,1,1,84143020,Out > In
Feb 2020,117,76,86,36745156,24401904,61147060,1,1,1,12343252,Out > In
Feb 2020,118,128,3,1541383,814430,2355813,1,1,3,726953,Out > In
Feb 2020,118,143,58,1434032,12227600,13661632,2,1,1,10793568,In > Out
Feb 2020,118,168,2,20384,1330807,1351191,2,2,2,1310423,In > Out
Feb 2020,118,174,3,334004,14751,348755,3,3,2,319253,Out > In
Feb 2020,118,182,1,120516,67118,187634,1,1,1,53398,Out > In
Feb 2020,118,187,4,287372,724899,1012271,4,1,4,437527,In > Out
Feb 2020,118,190,1,13880,134976,148856,1,1,1,121096,In > Out
Feb 2020,118,207,20,76480904,1269290681,1345771585,3,18,20,1192809777,In > Out
Feb 2020,118,213,2,233380265,18782050,252162315,1,2,2,214598215,Out > In
Feb 2020,118,233,2,13393004,1945012,15338016,2,2,2,11447992,Out > In
Feb 2020,118,242,32,34976182,4897593,39873775,28,27,2,30078589,Out > In
Feb 2020,118,247,31,145852671,1255732885,1401585556,31,31,31,1109880214,In > Out
Feb 2020,118,27,1,14550,662785,677335,1,1,1,648235,In > Out
Feb 2020,118,28,9,111395670,12064614,123460284,1,9,5,99331056,Out > In
Feb 2020,118,46,12,14223411,2723178,16946589,1,12,12,11500233,Out > In
Feb 2020,118,59,6,569509,8336399,8905908,5,6,1,7766890,In > Out
Feb 2020,118,63,18,2181135,2180208,4361343,1,1,1,927,Out > In
Feb 2020,118,85,1,82285,2473075,2555360,1,1,1,2390790,In > Out
Feb 2020,118,97,1,78960532,1047543,80008075,1,1,1,77912989,Out > In
Feb 2020,119,152,10,911223,19565490,20476713,10,10,1,18654267,In > Out
Feb 2020,119,159,162,414125714,161401243,575526957,132,147,139,252724471,Out > In
Feb 2020,119,16,2,391806,14293,406099,2,2,1,377513,Out > In
Feb 2020,119,160,1,20196,357764,377960,1,1,1,337568,In > Out
Feb 2020,119,168,180,285608877,70488663,356097540,6,180,2,215120214,Out > In
Feb 2020,119,171,1,13049298,79939,13129237,1,1,1,12969359,Out > In
Feb 2020,119,194,1,262236,14729160,14991396,1,1,1,14466924,In > Out
Feb 2020,119,32,1,206501769,111049524,317551293,1,1,1,95452245,Out > In
Feb 2020,119,34,1,52668,123198,175866,1,1,1,70530,In > Out
Feb 2020,119,42,7,1384498,46914,1431412,5,7,1,1337584,Out > In
Feb 2020,119,96,5,837605,371050,1208655,2,3,2,466555,Out > In
Feb 2020,12,21,2,9072,207369,216441,1,2,1,198297,In > Out
Feb 2020,120,107,1,34373068,38638373,73011441,1,1,1,4265305,In > Out
Feb 2020,120,54,1,72078,787932,860010,1,1,1,715854,In > Out
Feb 2020,120,71,5,721368,226700,948068,4,5,2,494668,Out > In
Feb 2020,122,10,33,9066752,4589492,13656244,17,1,1,4477260,Out > In
Feb 2020,122,108,9,177663523,15885684,193549207,6,8,4,161777839,Out > In
Feb 2020,122,119,15,6571654,332978,6904632,3,5,1,6238676,Out > In
Feb 2020,122,160,2,10900870,1094824,11995694,1,2,1,9806046,Out > In
Feb 2020,122,165,33,140461765,28895520,169357285,7,33,1,111566245,Out > In
Feb 2020,122,176,10,3142104,411394,3553498,1,10,1,2730710,Out > In
Feb 2020,122,214,311,138373939,45761404,184135343,53,213,2,92612535,Out > In
Feb 2020,122,222,5803,37427947833,1830175234,39258123067,890,2162,2,35597772599,Out > In
Feb 2020,122,229,10,545247869,3811836,549059705,1,10,1,541436033,Out > In
Feb 2020,122,237,1136,15918340846,1420806115,17339146961,54,1113,5,14497534731,Out > In
Feb 2020,123,101,2,62672803,69501704,132174507,1,2,2,6828901,In > Out
Feb 2020,123,104,2,318136539,288726805,606863344,2,2,2,29409734,Out > In
Feb 2020,123,11,1,79695,243663,323358,1,1,1,163968,In > Out
Feb 2020,123,110,3,12263835,39457582,51721417,3,3,3,27193747,In > Out
Feb 2020,123,111,5,18266032,52889412,71155444,5,5,5,34623380,In > Out
Feb 2020,123,112,1,1051542,1442225,2493767,1,1,1,390683,In > Out
Feb 2020,123,113,2,1182855973,964874861,2147730834,1,1,2,217981112,Out > In
Feb 2020,123,116,2,138786461,65301127,204087588,2,2,1,73485334,Out > In
Feb 2020,123,117,1,78762261,76905635,155667896,1,1,1,1856626,Out > In
Feb 2020,123,119,2,29411158,23876846,53288004,2,2,2,5534312,Out > In
Feb 2020,123,124,1,35848776,144779,35993555,1,1,1,35703997,Out > In
Feb 2020,123,126,7,718702,5833061,6551763,7,6,3,5114359,In > Out
Feb 2020,123,128,2,901537,905098,1806635,2,2,2,3561,In > Out
Feb 2020,123,129,7,511361945,127322037,638683982,4,7,3,384039908,Out > In
Feb 2020,123,132,4,112728367,124263834,236992201,4,4,2,11535467,In > Out
Feb 2020,123,133,3,66590161,34071748,100661909,1,2,3,32518413,Out > In
Feb 2020,123,134,1,469901,919291,1389192,1,1,1,449390,In > Out
Feb 2020,123,135,28,138350218,310885882,449236100,1,1,1,172535664,In > Out
Feb 2020,123,138,1,237792538,137720848,375513386,1,1,1,100071690,Out > In
Feb 2020,123,141,1,89769,194617,284386,1,1,1,104848,In > Out
Feb 2020,123,142,2,173427,250040,423467,2,2,2,76613,In > Out
Feb 2020,123,144,9,120230126,101140268,221370394,5,6,2,19089858,Out > In
Feb 2020,123,148,1,115754,4824,120578,1,1,1,110930,Out > In
Feb 2020,123,150,2,1036659,1164938,2201597,2,2,2,128279,In > Out
Feb 2020,123,151,3,3607267,14403243,18010510,3,3,3,10795976,In > Out
Feb 2020,123,153,3,15623550,15961711,31585261,3,3,2,338161,In > Out
Feb 2020,123,155,126,1116302,24170236,25286538,1,1,126,23053934,In > Out
Feb 2020,123,156,1,287342707,333617700,620960407,1,1,1,46274993,In > Out
Feb 2020,123,157,1,3942293,4402234,8344527,1,1,1,459941,In > Out
Feb 2020,123,158,29,25094904,141571394,166666298,10,9,25,116476490,In > Out
Feb 2020,123,159,2,297932315,325720919,623653234,2,2,2,27788604,In > Out
Feb 2020,123,16,1,7215597,4374971,11590568,1,1,1,2840626,Out > In
Feb 2020,123,166,1,1743913,37469757,39213670,1,1,1,35725844,In > Out
Feb 2020,123,169,10,7788535,6958382,14746917,4,10,4,830153,Out > In
Feb 2020,123,170,4,58793,1574102,1632895,4,4,1,1515309,In > Out
Feb 2020,123,171,1,28236,1034485,1062721,1,1,1,1006249,In > Out
Feb 2020,123,174,1,47149287,8443057,55592344,1,1,1,38706230,Out > In
Feb 2020,123,177,2,189671,178104,367775,2,1,2,11567,Out > In
Feb 2020,123,178,1,314114638,268094313,582208951,1,1,1,46020325,Out > In
Feb 2020,123,179,4,924137798,1049491261,1973629059,2,4,1,125353463,In > Out
Feb 2020,123,187,8,454115687,315571891,769687578,7,8,8,138543796,Out > In
Feb 2020,123,189,1,105467771,100720288,206188059,1,1,1,4747483,Out > In
Feb 2020,123,190,1,5027727,30015285,35043012,1,1,1,24987558,In > Out
Feb 2020,123,191,2,3547593,3976897,7524490,2,2,2,429304,In > Out
Feb 2020,123,192,3,27811208,26852855,54664063,1,3,3,958353,Out > In
Feb 2020,123,20,5,202931902,152823006,355754908,2,2,2,50108896,Out > In
Feb 2020,123,201,2,1685208,757948,2443156,2,2,2,927260,Out > In
Feb 2020,123,203,14,71545161,241011551,312556712,12,14,14,169466390,In > Out
Feb 2020,123,204,17,672725704,471536441,1144262145,4,7,7,201189263,Out > In
Feb 2020,123,206,42,1043696861,153551393,1197248254,41,20,3,890145468,Out > In
Feb 2020,123,208,13,832254218,863306349,1695560567,9,9,2,31052131,In > Out
Feb 2020,123,21,1,1531247,2345680,3876927,1,1,1,814433,In > Out
Feb 2020,123,211,10,65994192,823972784,889966976,2,9,10,757978592,In > Out
Feb 2020,123,216,1,10319,176238,186557,1,1,1,165919,In > Out
Feb 2020,123,217,2,116706071,112347433,229053504,2,2,2,4358638,Out > In
Feb 2020,123,22,1,14943553,43946098,58889651,1,1,1,29002545,In > Out
Feb 2020,123,221,2,70752,838900,909652,2,1,2,768148,In > Out
Feb 2020,123,222,11,1134889,102973264,104108153,10,10,5,101838375,In > Out
Feb 2020,123,223,1,131664,94272,225936,1,1,1,37392,Out > In
Feb 2020,123,23,1,806652,144630,951282,1,1,1,662022,Out > In
Feb 2020,123,24,5,3778590,35987067,39765657,4,4,3,32208477,In > Out
Feb 2020,123,27,4,508717,1523363,2032080,4,3,4,1014646,In > Out
Feb 2020,123,28,4,632316616,633626780,1265943396,2,2,2,1310164,In > Out
Feb 2020,123,29,1,274412,146547,420959,1,1,1,127865,Out > In
Feb 2020,123,31,5,282434815,317086306,599521121,4,5,5,34651491,In > Out
Feb 2020,123,33,7,43332113,77643662,120975775,4,7,6,34311549,In > Out
Feb 2020,123,35,5,1359398,3656391,5015789,4,5,5,2296993,In > Out
Feb 2020,123,36,3,12371228,8025717,20396945,3,3,3,4345511,Out > In
Feb 2020,123,37,1,466440,443751,910191,1,1,1,22689,Out > In
Feb 2020,123,39,1,330154,15175872,15506026,1,1,1,14845718,In > Out
Feb 2020,123,4,1,2006775,2113174,4119949,1,1,1,106399,In > Out
Feb 2020,123,40,5,98243,1480464,1578707,1,1,5,1382221,In > Out
Feb 2020,123,42,2,50932,414192,465124,2,2,2,363260,In > Out
Feb 2020,123,43,4,11439310,12933767,24373077,4,4,2,1494457,In > Out
Feb 2020,123,5,1,19807,119035,138842,1,1,1,99228,In > Out
Feb 2020,123,53,27,239137958,267627094,506765052,18,20,11,28489136,In > Out
Feb 2020,123,55,1,7801496,4483217,12284713,1,1,1,3318279,Out > In
Feb 2020,123,56,1,65598195,68884172,134482367,1,1,1,3285977,In > Out
Feb 2020,123,57,2,20789823,23443747,44233570,2,2,2,2653924,In > Out
Feb 2020,123,59,4,46593096,40498141,87091237,2,4,4,6094955,Out > In
Feb 2020,123,62,5,12120446,17223342,29343788,4,5,5,5102896,In > Out
Feb 2020,123,63,1,383124,374226,757350,1,1,1,8898,Out > In
Feb 2020,123,64,1,1434072,1557520,2991592,1,1,1,123448,In > Out
Feb 2020,123,72,2,13891381,22643064,36534445,1,2,2,8751683,In > Out
Feb 2020,123,75,1,705938,275634,981572,1,1,1,430304,Out > In
Feb 2020,123,77,5,44238,2434478,2478716,1,1,5,2390240,In > Out
Feb 2020,123,81,1,73504,35392,108896,1,1,1,38112,Out > In
Feb 2020,123,86,1,83213,76030,159243,1,1,1,7183,Out > In
Feb 2020,123,89,1,53435,81093,134528,1,1,1,27658,In > Out
Feb 2020,123,90,14,185624639,361861915,547486554,14,13,7,176237276,In > Out
Feb 2020,123,92,1,8914019,8902109,17816128,1,1,1,11910,Out > In
Feb 2020,123,93,78,1809250094,1403133552,3212383646,63,60,24,406116542,Out > In
Feb 2020,123,94,2,118860,74779240,74898100,2,2,1,74660380,In > Out
Feb 2020,123,97,1,81313,165634,246947,1,1,1,84321,In > Out
Feb 2020,123,98,1,983263870,1526458960,2509722830,1,1,1,543195090,In > Out
Feb 2020,123,99,3,4081288,2891788,6973076,3,3,3,1189500,Out > In
Feb 2020,124,105,1,288242948,629694843,917937791,1,1,1,341451895,In > Out
Feb 2020,124,106,1,60897060,47948670,108845730,1,1,1,12948390,Out > In
Feb 2020,124,108,11,17233740,355617044,372850784,5,7,9,338383304,In > Out
Feb 2020,124,121,1,352049,349460,701509,1,1,1,2589,Out > In
Feb 2020,124,124,1,793876090,330355182,1124231272,1,1,1,463520908,Out > In
Feb 2020,124,129,3,93163951,215439971,308603922,2,2,1,122276020,In > Out
Feb 2020,124,130,3,12035402,23015540,35050942,3,3,3,10980138,In > Out
Feb 2020,124,133,56,23586784,25145444,48732228,49,55,37,1558660,In > Out
Feb 2020,124,134,1,78745,80662,159407,1,1,1,1917,In > Out
Feb 2020,124,135,2,135100762,108444294,243545056,2,2,2,26656468,Out > In
Feb 2020,124,136,13,560026297,65426928,625453225,8,13,13,494599369,Out > In
Feb 2020,124,139,1,667309,224691,892000,1,1,1,442618,Out > In
Feb 2020,124,14,1,126180,30377,156557,1,1,1,95803,Out > In
Feb 2020,124,142,104,854598171,917517292,1772115463,99,26,7,62919121,In > Out
Feb 2020,124,143,3,27124156,85991088,113115244,1,3,3,58866932,In > Out
Feb 2020,124,146,1,73822,91713,165535,1,1,1,17891,In > Out
Feb 2020,124,148,155,6534216,31364915,37899131,4,4,155,24830699,In > Out
Feb 2020,124,149,1,201037580,267153044,468190624,1,1,1,66115464,In > Out
Feb 2020,124,153,1,1219933,1958361,3178294,1,1,1,738428,In > Out
Feb 2020,124,155,7,3160049,21770151,24930200,3,5,7,18610102,In > Out
Feb 2020,124,159,2,69726625,62954085,132680710,2,2,2,6772540,Out > In
Feb 2020,124,16,13,10811717,21073864,31885581,13,11,5,10262147,In > Out
Feb 2020,124,160,1,550596,997262,1547858,1,1,1,446666,In > Out
Feb 2020,124,161,16,4049760,23102913,27152673,16,15,4,19053153,In > Out
Feb 2020,124,163,1,239185,19093,258278,1,1,1,220092,Out > In
Feb 2020,124,165,1,31127,428351,459478,1,1,1,397224,In > Out
Feb 2020,124,167,2,2285924,2209612,4495536,2,2,2,76312,Out > In
Feb 2020,124,169,2,45185,426495,471680,2,2,2,381310,In > Out
Feb 2020,124,17,29,126899209,268627133,395526342,14,27,4,141727924,In > Out
Feb 2020,124,170,1,1792915,1629613,3422528,1,1,1,163302,Out > In
Feb 2020,124,174,1,321682,944676,1266358,1,1,1,622994,In > Out
Feb 2020,124,177,6,6564047,255308,6819355,5,6,1,6308739,Out > In
Feb 2020,124,179,3,71139960,149958693,221098653,3,3,3,78818733,In > Out
Feb 2020,124,184,2,49414185,12013387,61427572,2,2,2,37400798,Out > In
Feb 2020,124,185,1,44991211,65082953,110074164,1,1,1,20091742,In > Out
Feb 2020,124,186,3,416417661,198810709,615228370,3,3,2,217606952,Out > In
Feb 2020,124,188,44,593717,16151388,16745105,44,44,2,15557671,In > Out
Feb 2020,124,189,3,21169516,34456297,55625813,3,2,1,13286781,In > Out
Feb 2020,124,19,161,8313136388,3994403892,12307540280,114,104,27,4318732496,Out > In
Feb 2020,124,190,2,1160128341,1137280678,2297409019,1,1,2,22847663,Out > In
Feb 2020,124,191,7,14292190,34440850,48733040,7,6,1,20148660,In > Out
Feb 2020,124,195,3,911775341,955432279,1867207620,2,3,1,43656938,In > Out
Feb 2020,124,197,2,3139228,1261647,4400875,1,1,2,1877581,Out > In
Feb 2020,124,201,4,8176528728,6031168302,14207697030,2,4,4,2145360426,Out > In
Feb 2020,124,202,2,280300,299955,580255,1,2,2,19655,In > Out
Feb 2020,124,205,2,153848004,2087207,155935211,2,2,2,151760797,Out > In
Feb 2020,124,206,2,182466370,20370920,202837290,1,2,2,162095450,Out > In
Feb 2020,124,207,7,47079071,121294557,168373628,3,7,7,74215486,In > Out
Feb 2020,124,212,1,71846,1174090,1245936,1,1,1,1102244,In > Out
Feb 2020,124,213,15,11767432,31471263,43238695,10,6,15,19703831,In > Out
Feb 2020,124,215,4,9000528,12405856,21406384,3,3,4,3405328,In > Out
Feb 2020,124,219,1,179166,387858,567024,1,1,1,208692,In > Out
Feb 2020,124,22,1,34070252,33444760,67515012,1,1,1,625492,Out > In
Feb 2020,124,223,306,358277999,503938734,862216733,289,128,25,145660735,In > Out
Feb 2020,124,24,61,52848774,1740156,54588930,9,61,1,51108618,Out > In
Feb 2020,124,25,8,339976736,336919127,676895863,5,3,1,3057609,Out > In
Feb 2020,124,26,2,684251,567046,1251297,2,2,2,117205,Out > In
Feb 2020,124,32,2,1358094361,458303216,1816397577,2,2,2,899791145,Out > In
Feb 2020,124,35,4,3738619,8621366,12359985,4,4,4,4882747,In > Out
Feb 2020,124,36,1,31484,725550,757034,1,1,1,694066,In > Out
Feb 2020,124,43,2,146463563,159682835,306146398,2,1,2,13219272,In > Out
Feb 2020,124,44,2,197148,350877,548025,2,2,2,153729,In > Out
Feb 2020,124,46,19,667944055,756746417,1424690472,14,15,18,88802362,In > Out
Feb 2020,124,5,1,14252683,15106750,29359433,1,1,1,854067,In > Out
Feb 2020,124,51,13,448145831,248555315,696701146,10,4,13,199590516,Out > In
Feb 2020,124,52,3,530973281,524906980,1055880261,2,2,2,6066301,Out > In
Feb 2020,124,54,2,9693482,13454061,23147543,2,2,2,3760579,In > Out
Feb 2020,124,55,2,4231120,3359066,7590186,2,2,2,872054,Out > In
Feb 2020,124,56,5,11614554,12229311,23843865,5,5,5,614757,In > Out
Feb 2020,124,60,13,306464,5285207,5591671,13,13,2,4978743,In > Out
Feb 2020,124,64,1,297311461,339190198,636501659,1,1,1,41878737,In > Out
Feb 2020,124,65,1,113707967,62571999,176279966,1,1,1,51135968,Out > In
Feb 2020,124,67,1,5288172,13604691,18892863,1,1,1,8316519,In > Out
Feb 2020,124,69,3,14302009,13144624,27446633,1,3,3,1157385,Out > In
Feb 2020,124,74,1,2195531,891184,3086715,1,1,1,1304347,Out > In
Feb 2020,124,79,1,12891979,12577666,25469645,1,1,1,314313,Out > In
Feb 2020,124,81,2,899978,133153,1033131,2,2,2,766825,Out > In
Feb 2020,124,85,1,108044095,276037054,384081149,1,1,1,167992959,In > Out
Feb 2020,124,87,1,58135,528700,586835,1,1,1,470565,In > Out
Feb 2020,124,91,5,18768443,388664,19157107,4,4,1,18379779,Out > In
Feb 2020,124,96,8,954173163,853188554,1807361717,1,6,8,100984609,Out > In
Feb 2020,124,97,7,1586723206,1696899645,3283622851,4,5,3,110176439,In > Out
Feb 2020,125,162,1,28296,147659,175955,1,1,1,119363,In > Out
Feb 2020,125,182,1,59049593,144714692,203764285,1,1,1,85665099,In > Out
Feb 2020,125,194,2934,6071519903,446559060179,452630580082,1298,2197,17,440487540276,In > Out
Feb 2020,125,196,1,30156,147366,177522,1,1,1,117210,In > Out
Feb 2020,125,201,1,124379677,342356843,466736520,1,1,1,217977166,In > Out
Feb 2020,125,210,1,48000,144940,192940,1,1,1,96940,In > Out
Feb 2020,125,52,5,608433162,12961289,621394451,1,5,5,595471873,Out > In
Feb 2020,126,108,7,141264,624748,766012,1,7,1,483484,In > Out
Feb 2020,126,25,52,24426177,4985764,29411941,1,52,1,19440413,Out > In
Feb 2020,127,100,1,6042566,33434679,39477245,1,1,1,27392113,In > Out
Feb 2020,127,105,1,53711,117540,171251,1,1,1,63829,In > Out
Feb 2020,127,106,1,179699364,11628837,191328201,1,1,1,168070527,Out > In
Feb 2020,127,11,2,117724,329018,446742,2,2,2,211294,In > Out
Feb 2020,127,111,3,390184684,173188541,563373225,3,3,2,216996143,Out > In
Feb 2020,127,114,8,267269239,311064760,578333999,5,3,7,43795521,In > Out
Feb 2020,127,117,1,124467,74122,198589,1,1,1,50345,Out > In
Feb 2020,127,122,15,47934531,163025998,210960529,14,12,12,115091467,In > Out
Feb 2020,127,123,2,162751201,134894537,297645738,2,2,2,27856664,Out > In
Feb 2020,127,124,1,1234925,2272198,3507123,1,1,1,1037273,In > Out
Feb 2020,127,126,3,2354917147,1469339138,3824256285,3,3,1,885578009,Out > In
Feb 2020,127,128,2,78943419,85892948,164836367,2,2,2,6949529,In > Out
Feb 2020,127,129,9,70728556,11529945,82258501,9,9,2,59198611,Out > In
Feb 2020,127,13,1,3449673,8550341,12000014,1,1,1,5100668,In > Out
Feb 2020,127,130,2,8996744,10689353,19686097,2,2,2,1692609,In > Out
Feb 2020,127,131,1,1588284,1426998,3015282,1,1,1,161286,Out > In
Feb 2020,127,132,4,689451,2840008,3529459,4,4,4,2150557,In > Out
Feb 2020,127,133,1,1777930470,1859993724,3637924194,1,1,1,82063254,In > Out
Feb 2020,127,134,1,63662,126423,190085,1,1,1,62761,In > Out
Feb 2020,127,135,22,37128168,49836266,86964434,22,22,3,12708098,In > Out
Feb 2020,127,138,1,6467776,7685112,14152888,1,1,1,1217336,In > Out
Feb 2020,127,14,30,160040756,60063854,220104610,22,14,7,99976902,Out > In
Feb 2020,127,140,6,96750291,150357004,247107295,4,4,3,53606713,In > Out
Feb 2020,127,141,1,586761583,369421335,956182918,1,1,1,217340248,Out > In
Feb 2020,127,143,4,746252,2449348,3195600,3,2,4,1703096,In > Out
Feb 2020,127,144,5,4525,744426,748951,2,5,5,739901,In > Out
Feb 2020,127,146,8,2113804,5981086,8094890,8,7,8,3867282,In > Out
Feb 2020,127,148,6,3671089,11306454,14977543,4,3,4,7635365,In > Out
Feb 2020,127,149,7,47643503,51180620,98824123,3,7,7,3537117,In > Out
Feb 2020,127,150,18,317494361,318965268,636459629,17,18,10,1470907,In > Out
Feb 2020,127,154,1,1854595,6610476,8465071,1,1,1,4755881,In > Out
Feb 2020,127,155,1,40083,371818,411901,1,1,1,331735,In > Out
Feb 2020,127,157,2,79632,3459902,3539534,1,1,2,3380270,In > Out
Feb 2020,127,158,2,37564174,32132987,69697161,2,2,2,5431187,Out > In
Feb 2020,127,159,3,263675629,197156530,460832159,1,1,3,66519099,Out > In
Feb 2020,127,167,10,407635,8312190,8719825,7,1,10,7904555,In > Out
Feb 2020,127,168,3,724789523,700694812,1425484335,2,3,3,24094711,Out > In
Feb 2020,127,170,5,103184314,108350871,211535185,4,5,5,5166557,In > Out
Feb 2020,127,172,1,161367,148538,309905,1,1,1,12829,Out > In
Feb 2020,127,173,9,121552634,135159070,256711704,5,3,9,13606436,In > Out
Feb 2020,127,174,1,8276881,9579964,17856845,1,1,1,1303083,In > Out
Feb 2020,127,175,7,64108817,82182790,146291607,7,7,4,18073973,In > Out
Feb 2020,127,176,1,49429,848364,897793,1,1,1,798935,In > Out
Feb 2020,127,177,6,21354071,37115720,58469791,5,5,6,15761649,In > Out
Feb 2020,127,180,14,242844818,306716027,549560845,4,10,12,63871209,In > Out
Feb 2020,127,181,1,22295,265296,287591,1,1,1,243001,In > Out
Feb 2020,127,182,2,1028439,8854849,9883288,1,1,1,7826410,In > Out
Feb 2020,127,183,1,250277077,97490459,347767536,1,1,1,152786618,Out > In
Feb 2020,127,185,2,104545694,101316490,205862184,1,2,1,3229204,Out > In
Feb 2020,127,187,7,11526276,16271296,27797572,4,6,3,4745020,In > Out
Feb 2020,127,189,1,36162372,36515399,72677771,1,1,1,353027,In > Out
Feb 2020,127,191,1,300465951,307813609,608279560,1,1,1,7347658,In > Out
Feb 2020,127,193,1,81447,16884203,16965650,1,1,1,16802756,In > Out
Feb 2020,127,195,3,389176113,322090948,711267061,3,3,3,67085165,Out > In
Feb 2020,127,196,2,243140408,309072242,552212650,2,2,1,65931834,In > Out
Feb 2020,127,197,1,64569,1983265,2047834,1,1,1,1918696,In > Out
Feb 2020,127,198,2,179708,29936262,30115970,1,1,2,29756554,In > Out
Feb 2020,127,199,1,115740,119448,235188,1,1,1,3708,In > Out
Feb 2020,127,200,10,126270010,261469845,387739855,9,10,7,135199835,In > Out
Feb 2020,127,201,3,743523,1307000,2050523,3,3,3,563477,In > Out
Feb 2020,127,203,2,312052440,415871657,727924097,2,2,2,103819217,In > Out
Feb 2020,127,204,13,14629992,53332193,67962185,13,13,13,38702201,In > Out
Feb 2020,127,205,1,21812,145673,167485,1,1,1,123861,In > Out
Feb 2020,127,206,14,3820936,15179162,19000098,11,7,14,11358226,In > Out
Feb 2020,127,207,2,926169,1277043,2203212,2,2,2,350874,In > Out
Feb 2020,127,210,26,733165129,110772158,843937287,19,23,6,622392971,Out > In
Feb 2020,127,211,1,163384,86945659,87109043,1,1,1,86782275,In > Out
Feb 2020,127,214,5,10144675,2897816,13042491,2,2,1,7246859,Out > In
Feb 2020,127,215,1,192989,840219,1033208,1,1,1,647230,In > Out
Feb 2020,127,217,4,560207,575590,1135797,3,1,4,15383,In > Out
Feb 2020,127,218,11,33943929,24799460,58743389,7,11,11,9144469,Out > In
Feb 2020,127,219,1,136894,117265,254159,1,1,1,19629,Out > In
Feb 2020,127,223,10,37482507,93566538,131049045,10,7,1,56084031,In > Out
Feb 2020,127,27,1,3289077,9698288,12987365,1,1,1,6409211,In > Out
Feb 2020,127,37,2,15913,496097,512010,2,2,1,480184,In > Out
Feb 2020,127,39,4,32449149,45622595,78071744,3,3,2,13173446,In > Out
Feb 2020,127,41,13,5482220,14654160,20136380,5,6,6,9171940,In > Out
Feb 2020,127,44,3,1593819852,2021294959,3615114811,1,1,2,427475107,In > Out
Feb 2020,127,45,1,17122686,124100241,141222927,1,1,1,106977555,In > Out
Feb 2020,127,5,2,2204617,1947203,4151820,2,2,2,257414,Out > In
Feb 2020,127,62,1,180448486,186030450,366478936,1,1,1,5581964,In > Out
Feb 2020,127,63,1,330506,525326,855832,1,1,1,194820,In > Out
Feb 2020,127,64,2,146410627,12347783,158758410,1,2,2,134062844,Out > In
Feb 2020,127,7,4,342690853,360581355,703272208,4,4,4,17890502,In > Out
Feb 2020,127,71,2,307272063,329689986,636962049,2,2,2,22417923,In > Out
Feb 2020,127,73,2,1550930064,626670142,2177600206,2,2,2,924259922,Out > In
Feb 2020,127,8,1,141785860,24411062,166196922,1,1,1,117374798,Out > In
Feb 2020,127,80,1,31168218,60243823,91412041,1,1,1,29075605,In > Out
Feb 2020,127,81,3,45854216,80012416,125866632,3,3,3,34158200,In > Out
Feb 2020,127,82,2,365412588,292626155,658038743,2,2,2,72786433,Out > In
Feb 2020,127,84,3,116870970,176536323,293407293,3,2,3,59665353,In > Out
Feb 2020,127,88,3,2216511,2219112,4435623,2,3,3,2601,In > Out
Feb 2020,127,89,1,5620251,3486782,9107033,1,1,1,2133469,Out > In
Feb 2020,127,90,6,10561776,29060647,39622423,3,3,6,18498871,In > Out
Feb 2020,127,93,1,15307,204415,219722,1,1,1,189108,In > Out
Feb 2020,127,94,6,26946989,644603987,671550976,3,2,6,617656998,In > Out
Feb 2020,127,99,6,627137295,37053490,664190785,5,6,6,590083805,Out > In
Feb 2020,128,102,1,131128,235972,367100,1,1,1,104844,In > Out
Feb 2020,128,103,3,4338130,13487566,17825696,2,2,2,9149436,In > Out
Feb 2020,128,105,341,203297651,523670338,726967989,129,199,7,320372687,In > Out
Feb 2020,128,107,1,178491,119823,298314,1,1,1,58668,Out > In
Feb 2020,128,110,3,209273,142804,352077,3,3,3,66469,Out > In
Feb 2020,128,112,1,35345843,49918633,85264476,1,1,1,14572790,In > Out
Feb 2020,128,12,1,310469,260804,571273,1,1,1,49665,Out > In
Feb 2020,128,120,12,109353,2852440,2961793,5,1,12,2743087,In > Out
Feb 2020,128,121,10,87612888,66682772,154295660,6,9,5,20930116,Out > In
Feb 2020,128,125,3,344505240,215853804,560359044,3,3,3,128651436,Out > In
Feb 2020,128,126,8,5723172,4837081,10560253,5,8,7,886091,Out > In
Feb 2020,128,127,3,46832,526772,573604,3,3,3,479940,In > Out
Feb 2020,128,129,3,15762,492332,508094,3,3,2,476570,In > Out
Feb 2020,128,130,1,1339693,484704,1824397,1,1,1,854989,Out > In
Feb 2020,128,132,12,206019545,311150186,517169731,5,4,12,105130641,In > Out
Feb 2020,128,138,1,488866,422624,911490,1,1,1,66242,Out > In
Feb 2020,128,139,2,159248,395696,554944,1,1,1,236448,In > Out
Feb 2020,128,14,1,281742,645205,926947,1,1,1,363463,In > Out
Feb 2020,128,141,3,7770353,10616330,18386683,2,3,3,2845977,In > Out
Feb 2020,128,146,1,758661,5034898,5793559,1,1,1,4276237,In > Out
Feb 2020,128,147,7,922369084,962273566,1884642650,5,7,5,39904482,In > Out
Feb 2020,128,153,2,8029310,150508111,158537421,1,1,2,142478801,In > Out
Feb 2020,128,155,2,360974,198731,559705,2,1,2,162243,Out > In
Feb 2020,128,156,3,2574730,87059371,89634101,3,3,2,84484641,In > Out
Feb 2020,128,159,5,744293,142208841,142953134,4,4,2,141464548,In > Out
Feb 2020,128,16,4,40459472,59966142,100425614,3,4,4,19506670,In > Out
Feb 2020,128,161,1,239182,132730,371912,1,1,1,106452,Out > In
Feb 2020,128,162,2,150732322,155672758,306405080,2,2,2,4940436,In > Out
Feb 2020,128,163,3,109974317,121439530,231413847,3,3,3,11465213,In > Out
Feb 2020,128,164,10,141849693,177632469,319482162,6,9,4,35782776,In > Out
Feb 2020,128,165,1,2960,110129,113089,1,1,1,107169,In > Out
Feb 2020,128,171,2,78535757,10421597,88957354,2,2,2,68114160,Out > In
Feb 2020,128,178,3,445740,28245713,28691453,2,2,3,27799973,In > Out
Feb 2020,128,18,2,124311296,240284632,364595928,2,2,2,115973336,In > Out
Feb 2020,128,182,5,218622165,259189607,477811772,4,5,4,40567442,In > Out
Feb 2020,128,186,11,40899251,695107,41594358,11,11,1,40204144,Out > In
Feb 2020,128,187,3,21229,536521,557750,2,1,3,515292,In > Out
Feb 2020,128,189,1,19137,996788,1015925,1,1,1,977651,In > Out
Feb 2020,128,19,5,64203817,150350889,214554706,3,5,5,86147072,In > Out
Feb 2020,128,192,1,93679,201938,295617,1,1,1,108259,In > Out
Feb 2020,128,194,4,1719190,1621683,3340873,1,4,4,97507,Out > In
Feb 2020,128,195,7,9721984,21545700,31267684,2,2,7,11823716,In > Out
Feb 2020,128,197,2,209663,252103,461766,2,1,2,42440,In > Out
Feb 2020,128,20,2,270645,89073,359718,2,2,2,181572,Out > In
Feb 2020,128,200,1,1302316,1719250,3021566,1,1,1,416934,In > Out
Feb 2020,128,202,2,8793213,5733027,14526240,2,1,2,3060186,Out > In
Feb 2020,128,204,1,272169,925750,1197919,1,1,1,653581,In > Out
Feb 2020,128,207,2,34844490,32543610,67388100,1,1,1,2300880,Out > In
Feb 2020,128,21,2,10161064,76027764,86188828,1,2,2,65866700,In > Out
Feb 2020,128,211,9,15893865,225475564,241369429,9,9,4,209581699,In > Out
Feb 2020,128,212,2,2198244,1483049,3681293,2,2,1,715195,Out > In
Feb 2020,128,215,19,1177652811,943845619,2121498430,13,16,14,233807192,Out > In
Feb 2020,128,219,1,66018,187864,253882,1,1,1,121846,In > Out
Feb 2020,128,223,4,184725896,255154650,439880546,3,3,2,70428754,In > Out
Feb 2020,128,23,2,3254134,9165561,12419695,2,2,2,5911427,In > Out
Feb 2020,128,25,3,2326906811,941433835,3268340646,3,3,3,1385472976,Out > In
Feb 2020,128,27,1,1040053,1282186,2322239,1,1,1,242133,In > Out
Feb 2020,128,29,27,108238068,338498027,446736095,4,4,27,230259959,In > Out
Feb 2020,128,31,5,358820874,233179361,592000235,2,2,1,125641513,Out > In
Feb 2020,128,36,2,190565364,195044640,385610004,2,2,2,4479276,In > Out
Feb 2020,128,37,1,21553318,24138033,45691351,1,1,1,2584715,In > Out
Feb 2020,128,4,28,236141090,3558824771,3794965861,10,12,24,3322683681,In > Out
Feb 2020,128,41,12,1410813,351170097,352580910,11,9,6,349759284,In > Out
Feb 2020,128,45,1,208103,209860,417963,1,1,1,1757,In > Out
Feb 2020,128,46,4,2222214,19932739,22154953,2,2,2,17710525,In > Out
Feb 2020,128,48,4,964807075,581359105,1546166180,2,4,4,383447970,Out > In
Feb 2020,128,50,142,90109783,78002843,168112626,140,133,3,12106940,Out > In
Feb 2020,128,54,1,4141910,2801104,6943014,1,1,1,1340806,Out > In
Feb 2020,128,60,1,100185,170509,270694,1,1,1,70324,In > Out
Feb 2020,128,62,13,112739156,154862388,267601544,13,7,6,42123232,In > Out
Feb 2020,128,65,1,1400110,590937,1991047,1,1,1,809173,Out > In
Feb 2020,128,69,6,320982979,459196753,780179732,6,4,4,138213774,In > Out
Feb 2020,128,71,1,42495,194147,236642,1,1,1,151652,In > Out
Feb 2020,128,77,3,2288518,2933045,5221563,2,3,3,644527,In > Out
Feb 2020,128,79,3,518048443,616694487,1134742930,3,3,2,98646044,In > Out
Feb 2020,128,8,3,7905802,7510485,15416287,3,3,3,395317,Out > In
Feb 2020,128,84,4,130794895,104423496,235218391,4,4,4,26371399,Out > In
Feb 2020,128,87,6,281526722,313228012,594754734,4,6,5,31701290,In > Out
Feb 2020,128,89,22,87068034,131466485,218534519,11,12,22,44398451,In > Out
Feb 2020,128,96,1,102353368,95705380,198058748,1,1,1,6647988,Out > In
Feb 2020,129,103,2,158760,100492,259252,1,1,1,58268,Out > In
Feb 2020,129,155,1,1472178,108322,1580500,1,1,1,1363856,Out > In
Feb 2020,129,158,1,8373314,164155,8537469,1,1,1,8209159,Out > In
Feb 2020,129,160,1412,324366925,57938769,382305694,531,1380,2,266428156,Out > In
Feb 2020,129,181,1,53700,189400,243100,1,1,1,135700,In > Out
Feb 2020,129,200,2,299847121,2712897817,3012744938,2,2,2,2413050696,In > Out
Feb 2020,129,209,1,5003922,129743,5133665,1,1,1,4874179,Out > In
Feb 2020,129,215,138,1021641866,385737140,1407379006,41,138,1,635904726,Out > In
Feb 2020,129,228,1,154110,4368,158478,1,1,1,149742,Out > In
Feb 2020,129,229,35,12128712,10505784,22634496,2,1,1,1622928,Out > In
Feb 2020,129,230,867,758044557,53066180,811110737,153,514,1,704978377,Out > In
Feb 2020,129,236,780,614929302,42508224,657437526,105,591,1,572421078,Out > In
Feb 2020,129,242,17,2190743,837606,3028349,2,17,1,1353137,Out > In
Feb 2020,129,252,10,38432774,236450692,274883466,1,2,2,198017918,In > Out
Feb 2020,129,31,30,18276041,530564,18806605,6,30,2,17745477,Out > In
Feb 2020,129,52,18,2050818,783734,2834552,2,18,1,1267084,Out > In
Feb 2020,129,63,1,376496,1029008,1405504,1,1,1,652512,In > Out
Feb 2020,129,79,34,11948194,25825417,37773611,4,5,27,13877223,In > Out
Feb 2020,129,89,10,2520128,71533,2591661,10,9,1,2448595,Out > In
Feb 2020,129,9,1,88596,23328,111924,1,1,1,65268,Out > In
Feb 2020,129,94,8,408295040,470515447,878810487,4,3,8,62220407,In > Out
Feb 2020,130,104,1,5463186,2876876,8340062,1,1,1,2586310,Out > In
Feb 2020,130,105,3,1239128,52600026,53839154,2,1,3,51360898,In > Out
Feb 2020,130,106,1,168874876,347481756,516356632,1,1,1,178606880,In > Out
Feb 2020,130,119,1,2200,159672,161872,1,1,1,157472,In > Out
Feb 2020,130,138,1,42057,110592,152649,1,1,1,68535,In > Out
Feb 2020,130,29,19,556341,4360574,4916915,12,1,19,3804233,In > Out
Feb 2020,130,62,1,57956340,8584427,66540767,1,1,1,49371913,Out > In
Feb 2020,130,67,1,23600,1241223,1264823,1,1,1,1217623,In > Out
Feb 2020,130,74,1,12069,207912,219981,1,1,1,195843,In > Out
Feb 2020,130,86,1,341259425,3610759,344870184,1,1,1,337648666,Out > In
Feb 2020,131,102,1,276452,6830,283282,1,1,1,269622,Out > In
Feb 2020,131,104,4,7798117,7842787,15640904,2,1,4,44670,In > Out
Feb 2020,131,105,2,116362922,60456658,176819580,2,2,2,55906264,Out > In
Feb 2020,131,108,2,1555444117,2784265426,4339709543,2,2,1,1228821309,In > Out
Feb 2020,131,111,4,2741140,6558185,9299325,4,4,4,3817045,In > Out
Feb 2020,131,112,2,2330348,2892443,5222791,1,2,2,562095,In > Out
Feb 2020,131,113,3,15803878,38471017,54274895,3,3,3,22667139,In > Out
Feb 2020,131,114,1,724529,516429,1240958,1,1,1,208100,Out > In
Feb 2020,131,115,4,100259,2842598,2942857,4,4,1,2742339,In > Out
Feb 2020,131,118,15,6135206,11272008,17407214,4,5,5,5136802,In > Out
Feb 2020,131,12,4,2828753,3651980,6480733,4,4,4,823227,In > Out
Feb 2020,131,122,1,31855377,98225404,130080781,1,1,1,66370027,In > Out
Feb 2020,131,127,5,45075594,75696021,120771615,4,5,3,30620427,In > Out
Feb 2020,131,128,10,195345283,609819630,805164913,6,10,10,414474347,In > Out
Feb 2020,131,129,2,405142355,377706974,782849329,2,2,2,27435381,Out > In
Feb 2020,131,130,10,328291,2152298,2480589,10,10,3,1824007,In > Out
Feb 2020,131,131,1,33520,90128,123648,1,1,1,56608,In > Out
Feb 2020,131,132,1,927182,20977,948159,1,1,1,906205,Out > In
Feb 2020,131,133,8,173808393,399027128,572835521,8,5,5,225218735,In > Out
Feb 2020,131,134,2,38699889,1369331,40069220,2,2,1,37330558,Out > In
Feb 2020,131,136,9,1693117,49226442,50919559,9,9,4,47533325,In > Out
Feb 2020,131,138,1,80575,75576,156151,1,1,1,4999,Out > In
Feb 2020,131,140,3,38194156,128839381,167033537,3,2,1,90645225,In > Out
Feb 2020,131,147,1,549553534,546141573,1095695107,1,1,1,3411961,Out > In
Feb 2020,131,150,4,50211858,82707926,132919784,4,4,4,32496068,In > Out
Feb 2020,131,151,10,6666067,10084930,16750997,4,4,10,3418863,In > Out
Feb 2020,131,154,4,483762049,74490462,558252511,3,4,3,409271587,Out > In
Feb 2020,131,162,2,987514917,674718981,1662233898,2,2,2,312795936,Out > In
Feb 2020,131,171,4,1296842163,1290541930,2587384093,4,3,1,6300233,Out > In
Feb 2020,131,172,2,91575298,83499002,175074300,2,2,1,8076296,Out > In
Feb 2020,131,175,3,42110235,47464886,89575121,2,3,3,5354651,In > Out
Feb 2020,131,176,15,320798591,314087849,634886440,9,12,10,6710742,Out > In
Feb 2020,131,177,1,204848,187884,392732,1,1,1,16964,Out > In
Feb 2020,131,179,1,269877,208840,478717,1,1,1,61037,Out > In
Feb 2020,131,18,107,63533830,94075735,157609565,100,44,13,30541905,In > Out
Feb 2020,131,180,2,22844066,61453902,84297968,2,2,1,38609836,In > Out
Feb 2020,131,185,2,222967410,40923731,263891141,1,1,1,182043679,Out > In
Feb 2020,131,186,16,1903785388,1490567216,3394352604,8,14,9,413218172,Out > In
Feb 2020,131,189,1,526727,308775,835502,1,1,1,217952,Out > In
Feb 2020,131,192,4,18281399,62961037,81242436,3,3,4,44679638,In > Out
Feb 2020,131,196,2,12586,290414,303000,1,1,2,277828,In > Out
Feb 2020,131,197,11,34856842,124407890,159264732,7,9,11,89551048,In > Out
Feb 2020,131,198,4,103429918,41726943,145156861,4,4,3,61702975,Out > In
Feb 2020,131,20,1,508313,423196,931509,1,1,1,85117,Out > In
Feb 2020,131,200,1,965814,152769,1118583,1,1,1,813045,Out > In
Feb 2020,131,201,2,795398,798619,1594017,2,2,2,3221,In > Out
Feb 2020,131,203,4,35739159,26864723,62603882,3,3,4,8874436,Out > In
Feb 2020,131,204,1,39039038,112253827,151292865,1,1,1,73214789,In > Out
Feb 2020,131,205,3,3111448,4016712,7128160,3,3,3,905264,In > Out
Feb 2020,131,207,2,1452946,2063256,3516202,2,2,2,610310,In > Out
Feb 2020,131,21,1,2429927,13403599,15833526,1,1,1,10973672,In > Out
Feb 2020,131,210,1,40483,70470,110953,1,1,1,29987,In > Out
Feb 2020,131,212,5,1065685,4447584,5513269,5,4,5,3381899,In > Out
Feb 2020,131,217,2,55589514,29434226,85023740,1,2,2,26155288,Out > In
Feb 2020,131,218,1,6605721,9435595,16041316,1,1,1,2829874,In > Out
Feb 2020,131,222,4,10176980,62708112,72885092,4,4,4,52531132,In > Out
Feb 2020,131,23,6,866925,3408776,4275701,5,3,6,2541851,In > Out
Feb 2020,131,24,1,8624,108238,116862,1,1,1,99614,In > Out
Feb 2020,131,27,1,2721708,8272886,10994594,1,1,1,5551178,In > Out
Feb 2020,131,28,1,306190454,132098982,438289436,1,1,1,174091472,Out > In
Feb 2020,131,34,1,134688,208184,342872,1,1,1,73496,In > Out
Feb 2020,131,36,4,1590757,2528696,4119453,4,4,3,937939,In > Out
Feb 2020,131,37,3,159778995,93657082,253436077,2,2,1,66121913,Out > In
Feb 2020,131,39,20,82441015,5293454727,5375895742,18,18,1,5211013712,In > Out
Feb 2020,131,41,9,19048114,39953150,59001264,6,7,7,20905036,In > Out
Feb 2020,131,42,1,175898,743017,918915,1,1,1,567119,In > Out
Feb 2020,131,48,1,167759,578486,746245,1,1,1,410727,In > Out
Feb 2020,131,52,12,16040410,92318157,108358567,11,11,12,76277747,In > Out
Feb 2020,131,56,4,6744840,3860032,10604872,3,2,4,2884808,Out > In
Feb 2020,131,57,2,850056,87656043,88506099,2,2,2,86805987,In > Out
Feb 2020,131,61,2,954640064,1523856397,2478496461,2,2,1,569216333,In > Out
Feb 2020,131,62,1,15145,96892,112037,1,1,1,81747,In > Out
Feb 2020,131,64,29,226344320,5166804,231511124,20,19,2,221177516,Out > In
Feb 2020,131,66,1,82971,78342,161313,1,1,1,4629,Out > In
Feb 2020,131,67,55,47022321,38950704,85973025,54,50,4,8071617,Out > In
Feb 2020,131,73,1,96825835,99913251,196739086,1,1,1,3087416,In > Out
Feb 2020,131,74,1,248790538,355790860,604581398,1,1,1,107000322,In > Out
Feb 2020,131,75,1,18530906,12065925,30596831,1,1,1,6464981,Out > In
Feb 2020,131,77,1,21977485,29782820,51760305,1,1,1,7805335,In > Out
Feb 2020,131,79,7,34418211,108985785,143403996,5,5,4,74567574,In > Out
Feb 2020,131,8,3,47589962,36889617,84479579,2,3,1,10700345,Out > In
Feb 2020,131,85,2631,1624950413,4594288735,6219239148,2556,1915,347,2969338322,In > Out
Feb 2020,131,86,1,25569,92604,118173,1,1,1,67035,In > Out
Feb 2020,131,90,1,33988,2396630,2430618,1,1,1,2362642,In > Out
Feb 2020,131,92,1,661079068,1033718646,1694797714,1,1,1,372639578,In > Out
Feb 2020,131,97,2,7516754,26638013,34154767,2,2,2,19121259,In > Out
Feb 2020,132,10,91,67571747,256252588,323824335,80,87,7,188680841,In > Out
Feb 2020,132,100,1,239330,345925,585255,1,1,1,106595,In > Out
Feb 2020,132,102,3,34770064,41046826,75816890,2,3,2,6276762,In > Out
Feb 2020,132,105,1,4252,110928,115180,1,1,1,106676,In > Out
Feb 2020,132,106,1,53841,107792059,107845900,1,1,1,107738218,In > Out
Feb 2020,132,108,1,4366,195751,200117,1,1,1,191385,In > Out
Feb 2020,132,11,1,10920754,21149391,32070145,1,1,1,10228637,In > Out
Feb 2020,132,110,1,128242813,98572548,226815361,1,1,1,29670265,Out > In
Feb 2020,132,111,1,4664,106696,111360,1,1,1,102032,In > Out
Feb 2020,132,112,4,19920,461292,481212,1,4,1,441372,In > Out
Feb 2020,132,114,1,6836,160534,167370,1,1,1,153698,In > Out
Feb 2020,132,115,5,45825277,13675409,59500686,3,3,5,32149868,Out > In
Feb 2020,132,118,32,4410348,56002976,60413324,31,32,28,51592628,In > Out
Feb 2020,132,12,1,3432682,39639072,43071754,1,1,1,36206390,In > Out
Feb 2020,132,120,2,49622068,39016751,88638819,2,2,2,10605317,Out > In
Feb 2020,132,121,1,118376079,130651463,249027542,1,1,1,12275384,In > Out
Feb 2020,132,122,1,786983,700767,1487750,1,1,1,86216,Out > In
Feb 2020,132,124,11,51404,1216529,1267933,1,11,1,1165125,In > Out
Feb 2020,132,127,1,1307529,1858151,3165680,1,1,1,550622,In > Out
Feb 2020,132,129,1,125243070,56945135,182188205,1,1,1,68297935,Out > In
Feb 2020,132,132,1,107452,277084,384536,1,1,1,169632,In > Out
Feb 2020,132,134,1,12513159,26079952,38593111,1,1,1,13566793,In > Out
Feb 2020,132,135,24,1379273,15895682,17274955,14,3,24,14516409,In > Out
Feb 2020,132,137,1,34910796,46192371,81103167,1,1,1,11281575,In > Out
Feb 2020,132,139,14,358331646,271289387,629621033,9,14,6,87042259,Out > In
Feb 2020,132,14,1,36466,622452,658918,1,1,1,585986,In > Out
Feb 2020,132,140,1,103967180,136925254,240892434,1,1,1,32958074,In > Out
Feb 2020,132,141,62,631129081,442262107,1073391188,8,8,61,188866974,Out > In
Feb 2020,132,142,1,26756,82315,109071,1,1,1,55559,In > Out
Feb 2020,132,143,3,38427397,39366501,77793898,2,2,1,939104,In > Out
Feb 2020,132,147,7,530723,37051731,37582454,2,2,7,36521008,In > Out
Feb 2020,132,150,3,2063388,3160327,5223715,3,3,2,1096939,In > Out
Feb 2020,132,152,4,1704927,3662629,5367556,4,4,4,1957702,In > Out
Feb 2020,132,153,1,164393,79939,244332,1,1,1,84454,Out > In
Feb 2020,132,154,6,123989032,46743640,170732672,4,5,5,77245392,Out > In
Feb 2020,132,155,11,570130,6199517,6769647,11,1,11,5629387,In > Out
Feb 2020,132,157,7,137866914,129053668,266920582,5,4,7,8813246,Out > In
Feb 2020,132,158,1,7636,181129,188765,1,1,1,173493,In > Out
Feb 2020,132,162,4,7769978,6617314,14387292,2,4,3,1152664,Out > In
Feb 2020,132,164,2,99958650,132291412,232250062,2,2,2,32332762,In > Out
Feb 2020,132,165,2,1038601,1091562,2130163,2,2,2,52961,In > Out
Feb 2020,132,166,1,676206317,143257338,819463655,1,1,1,532948979,Out > In
Feb 2020,132,169,6,268203981,226373116,494577097,5,6,2,41830865,Out > In
Feb 2020,132,17,12,173002,3779047,3952049,8,1,12,3606045,In > Out
Feb 2020,132,170,8,10308125,11775497,22083622,7,7,7,1467372,In > Out
Feb 2020,132,173,3,13785694,10945514,24731208,2,3,1,2840180,Out > In
Feb 2020,132,174,3,21188,491508,512696,1,3,1,470320,In > Out
Feb 2020,132,176,1,169212205,150390264,319602469,1,1,1,18821941,Out > In
Feb 2020,132,179,1,443500,464733,908233,1,1,1,21233,In > Out
Feb 2020,132,181,2,536896,2115024,2651920,1,1,1,1578128,In > Out
Feb 2020,132,182,1,14432019,14917252,29349271,1,1,1,485233,In > Out
Feb 2020,132,184,2,46699109,78118300,124817409,2,2,2,31419191,In > Out
Feb 2020,132,185,1,88508936,76541816,165050752,1,1,1,11967120,Out > In
Feb 2020,132,186,13,5264288,7243159,12507447,2,13,2,1978871,In > Out
Feb 2020,132,187,22,43836909,53449897,97286806,21,20,5,9612988,In > Out
Feb 2020,132,19,3,1335585602,2163574787,3499160389,3,2,2,827989185,In > Out
Feb 2020,132,190,2,12392,293352,305744,1,2,1,280960,In > Out
Feb 2020,132,194,3,90508,424978,515486,3,3,3,334470,In > Out
Feb 2020,132,197,2,2692508,9388604,12081112,1,2,2,6696096,In > Out
Feb 2020,132,200,14,413322880,556918948,970241828,9,10,13,143596068,In > Out
Feb 2020,132,201,1,36502755,31371629,67874384,1,1,1,5131126,Out > In
Feb 2020,132,202,1,129863556,167545877,297409433,1,1,1,37682321,In > Out
Feb 2020,132,204,96,217087008,208277001,425364009,94,43,3,8810007,Out > In
Feb 2020,132,21,7,103020241,325105012,428125253,4,7,6,222084771,In > Out
Feb 2020,132,213,5,28820,674132,702952,1,5,1,645312,In > Out
Feb 2020,132,217,1,3384,99411,102795,1,1,1,96027,In > Out
Feb 2020,132,219,2,31718675,33907972,65626647,2,2,2,2189297,In > Out
Feb 2020,132,22,2,218925919,236024355,454950274,2,2,2,17098436,In > Out
Feb 2020,132,220,21,174016357,262152260,436168617,15,19,15,88135903,In > Out
Feb 2020,132,221,1,9106124,39520226,48626350,1,1,1,30414102,In > Out
Feb 2020,132,222,2,439545,428611,868156,2,2,2,10934,Out > In
Feb 2020,132,223,6,985879701,1072450965,2058330666,6,6,6,86571264,In > Out
Feb 2020,132,23,4,41521881,42056495,83578376,3,4,2,534614,In > Out
Feb 2020,132,238,5,31636,768221,799857,1,5,1,736585,In > Out
Feb 2020,132,26,7,437742953,132435211,570178164,5,6,6,305307742,Out > In
Feb 2020,132,28,6,2424028002,2371062517,4795090519,5,5,6,52965485,Out > In
Feb 2020,132,29,22,1947425073,2422951730,4370376803,6,7,16,475526657,In > Out
Feb 2020,132,3,2,13592,323074,336666,1,2,1,309482,In > Out
Feb 2020,132,31,2,1084717,2496400,3581117,2,1,2,1411683,In > Out
Feb 2020,132,32,1,336,285138,285474,1,1,1,284802,In > Out
Feb 2020,132,33,1,234363,552292,786655,1,1,1,317929,In > Out
Feb 2020,132,34,1,89079882,2370240228,2459320110,1,1,1,2281160346,In > Out
Feb 2020,132,40,1,42157,142726,184883,1,1,1,100569,In > Out
Feb 2020,132,41,1,35745,137448,173193,1,1,1,101703,In > Out
Feb 2020,132,42,1,156675824,136274529,292950353,1,1,1,20401295,Out > In
Feb 2020,132,48,11,521188255,352211717,873399972,8,11,11,168976538,Out > In
Feb 2020,132,50,70,558238,17546407,18104645,70,63,6,16988169,In > Out
Feb 2020,132,56,4,22602558,25545682,48148240,4,4,4,2943124,In > Out
Feb 2020,132,58,1,10620418,23730799,34351217,1,1,1,13110381,In > Out
Feb 2020,132,59,4,1684634,1390040,3074674,3,4,3,294594,Out > In
Feb 2020,132,6,7,846003,4678703,5524706,2,7,2,3832700,In > Out
Feb 2020,132,60,2,17792,290748,308540,1,2,1,272956,In > Out
Feb 2020,132,63,9,8889162,13688808,22577970,8,8,5,4799646,In > Out
Feb 2020,132,65,1,4685140,106864,4792004,1,1,1,4578276,Out > In
Feb 2020,132,66,3,28398144,29125091,57523235,2,3,3,726947,In > Out
Feb 2020,132,67,1,387152,531269,918421,1,1,1,144117,In > Out
Feb 2020,132,7,7,5873477,6342638,12216115,7,7,7,469161,In > Out
Feb 2020,132,70,1,5228,139806,145034,1,1,1,134578,In > Out
Feb 2020,132,71,1,4516,103972,108488,1,1,1,99456,In > Out
Feb 2020,132,72,1,107164,51698,158862,1,1,1,55466,Out > In
Feb 2020,132,73,2,31973851,22683198,54657049,2,2,2,9290653,Out > In
Feb 2020,132,75,1,27556485,17140310,44696795,1,1,1,10416175,Out > In
Feb 2020,132,8,3,18416,435451,453867,1,3,1,417035,In > Out
Feb 2020,132,80,10,3262859103,3708950555,6971809658,3,4,3,446091452,In > Out
Feb 2020,132,82,1,8595362,24573330,33168692,1,1,1,15977968,In > Out
Feb 2020,132,89,3,1068840,1858688,2927528,3,2,3,789848,In > Out
Feb 2020,132,9,2,321298,24478,345776,1,1,1,296820,Out > In
Feb 2020,132,96,4,27810997,103291652,131102649,3,3,3,75480655,In > Out
Feb 2020,132,97,67,1216475141,364407545,1580882686,40,36,27,852067596,Out > In
Feb 2020,132,98,4,19744,458088,477832,1,4,1,438344,In > Out
Feb 2020,132,99,1,2101190759,2100733376,4201924135,1,1,1,457383,Out > In
Feb 2020,133,103,2,132704611,277359639,410064250,2,2,1,144655028,In > Out
Feb 2020,133,104,1,6320,283022,289342,1,1,1,276702,In > Out
Feb 2020,133,107,2,6018423,630456,6648879,1,1,1,5387967,Out > In
Feb 2020,133,11,6,364481582,358305617,722787199,6,5,6,6175965,Out > In
Feb 2020,133,114,9,534997252,474574414,1009571666,3,7,2,60422838,Out > In
Feb 2020,133,116,3,98401059,102097182,200498241,2,3,3,3696123,In > Out
Feb 2020,133,119,1,74269,107224,181493,1,1,1,32955,In > Out
Feb 2020,133,121,2,4981416,5665013,10646429,2,2,2,683597,In > Out
Feb 2020,133,126,14,166967220,165338729,332305949,4,14,6,1628491,Out > In
Feb 2020,133,129,7,1809215545,2946702501,4755918046,4,7,7,1137486956,In > Out
Feb 2020,133,130,3,3200867,8005117,11205984,3,3,2,4804250,In > Out
Feb 2020,133,131,1,25679,126608,152287,1,1,1,100929,In > Out
Feb 2020,133,132,58,2186133,241919975,244106108,56,49,2,239733842,In > Out
Feb 2020,133,135,2,525076972,513528216,1038605188,1,2,2,11548756,Out > In
Feb 2020,133,137,2,2952427,3517210,6469637,2,2,2,564783,In > Out
Feb 2020,133,141,6,206700,538874,745574,6,6,3,332174,In > Out
Feb 2020,133,142,13,487774987,449763367,937538354,7,13,9,38011620,Out > In
Feb 2020,133,147,2,5353562,11555814,16909376,2,2,2,6202252,In > Out
Feb 2020,133,149,1,4088948,2007435,6096383,1,1,1,2081513,Out > In
Feb 2020,133,15,8,42991670,282075055,325066725,6,5,8,239083385,In > Out
Feb 2020,133,150,3,27594810,16582171,44176981,3,3,3,11012639,Out > In
Feb 2020,133,152,9,239603399,129285221,368888620,3,9,6,110318178,Out > In
Feb 2020,133,155,1,577968,2836056,3414024,1,1,1,2258088,In > Out
Feb 2020,133,159,5,133793067,134890206,268683273,5,5,5,1097139,In > Out
Feb 2020,133,16,6,49606447,51380538,100986985,5,4,3,1774091,In > Out
Feb 2020,133,160,1,3971137,3833951,7805088,1,1,1,137186,Out > In
Feb 2020,133,165,2,374283204,4120697381,4494980585,2,2,2,3746414177,In > Out
Feb 2020,133,172,1,251604390,266157792,517762182,1,1,1,14553402,In > Out
Feb 2020,133,175,3,121007,358338,479345,2,2,3,237331,In > Out
Feb 2020,133,176,17,3172894616,2953531997,6126426613,9,12,8,219362619,Out > In
Feb 2020,133,177,4,34688,1473216,1507904,4,4,1,1438528,In > Out
Feb 2020,133,178,2,5895727,18687504,24583231,1,2,2,12791777,In > Out
Feb 2020,133,179,6,697570980,1658404889,2355975869,3,3,2,960833909,In > Out
Feb 2020,133,18,3,38304697,41631139,79935836,2,3,3,3326442,In > Out
Feb 2020,133,183,1,215688,121988,337676,1,1,1,93700,Out > In
Feb 2020,133,19,6,606021,517639,1123660,2,2,6,88382,Out > In
Feb 2020,133,191,1,108160,661256,769416,1,1,1,553096,In > Out
Feb 2020,133,192,1,31911,852469,884380,1,1,1,820558,In > Out
Feb 2020,133,193,1,1820574,140167,1960741,1,1,1,1680407,Out > In
Feb 2020,133,195,18,675791125,133081525,808872650,16,16,3,542709600,Out > In
Feb 2020,133,198,12,795750917,679775779,1475526696,6,11,4,115975138,Out > In
Feb 2020,133,199,2,212915377,251907345,464822722,1,2,2,38991968,In > Out
Feb 2020,133,201,2,74837432,67492286,142329718,2,2,2,7345146,Out > In
Feb 2020,133,203,4,187556421,341172323,528728744,4,4,4,153615902,In > Out
Feb 2020,133,204,1,617824868,714299845,1332124713,1,1,1,96474977,In > Out
Feb 2020,133,206,3,9947371,9123410,19070781,3,3,3,823961,Out > In
Feb 2020,133,208,2,2256696,2086228,4342924,2,2,2,170468,Out > In
Feb 2020,133,211,2,327431,707345,1034776,2,2,2,379914,In > Out
Feb 2020,133,213,2,1137420,1306335,2443755,2,2,2,168915,In > Out
Feb 2020,133,217,1,91923,177146,269069,1,1,1,85223,In > Out
Feb 2020,133,218,6,20857329,51297782,72155111,5,5,6,30440453,In > Out
Feb 2020,133,220,2,3438697,3820591,7259288,2,2,2,381894,In > Out
Feb 2020,133,221,17,75399,2230194,2305593,17,14,5,2154795,In > Out
Feb 2020,133,222,1,350286,672711,1022997,1,1,1,322425,In > Out
Feb 2020,133,26,2,836029,2005738,2841767,2,2,2,1169709,In > Out
Feb 2020,133,28,1,160430756,161350798,321781554,1,1,1,920042,In > Out
Feb 2020,133,30,1,620031,516960,1136991,1,1,1,103071,Out > In
Feb 2020,133,31,5,19960416,10931629,30892045,4,5,5,9028787,Out > In
Feb 2020,133,33,2,11889527,16470587,28360114,2,2,2,4581060,In > Out
Feb 2020,133,37,4,1847684842,1492881532,3340566374,2,3,3,354803310,Out > In
Feb 2020,133,4,3,285046124,428015836,713061960,3,3,2,142969712,In > Out
Feb 2020,133,40,1,83583166,89150146,172733312,1,1,1,5566980,In > Out
Feb 2020,133,44,60,2831331,21811568,24642899,60,54,8,18980237,In > Out
Feb 2020,133,45,2,116648092,51646233,168294325,2,2,1,65001859,Out > In
Feb 2020,133,47,1,3149657,6002736,9152393,1,1,1,2853079,In > Out
Feb 2020,133,48,21,1041525,14850244,15891769,16,1,21,13808719,In > Out
Feb 2020,133,5,1,14606330,67023970,81630300,1,1,1,52417640,In > Out
Feb 2020,133,57,15,7861534,11588264,19449798,14,5,6,3726730,In > Out
Feb 2020,133,59,18,36630527,48630803,85261330,18,17,18,12000276,In > Out
Feb 2020,133,60,1,95147960,105692856,200840816,1,1,1,10544896,In > Out
Feb 2020,133,63,3,805767671,1053621802,1859389473,3,3,2,247854131,In > Out
Feb 2020,133,64,2,19056689,22636187,41692876,2,2,2,3579498,In > Out
Feb 2020,133,65,9,156949,5492620,5649569,7,1,9,5335671,In > Out
Feb 2020,133,75,4,87669,2628163,2715832,1,1,4,2540494,In > Out
Feb 2020,133,77,1,321803,452036,773839,1,1,1,130233,In > Out
Feb 2020,133,84,1,1257719,2726029,3983748,1,1,1,1468310,In > Out
Feb 2020,133,86,19,66699360,67470458,134169818,13,18,9,771098,In > Out
Feb 2020,133,87,1,227598,664037,891635,1,1,1,436439,In > Out
Feb 2020,133,92,2,90984080,414679280,505663360,2,2,2,323695200,In > Out
Feb 2020,133,93,1,58932,124572,183504,1,1,1,65640,In > Out
Feb 2020,133,95,6,570606,4053696,4624302,5,2,6,3483090,In > Out
Feb 2020,134,102,2,16804165,1011265,17815430,2,2,2,15792900,Out > In
Feb 2020,134,103,1,49578,81581,131159,1,1,1,32003,In > Out
Feb 2020,134,109,1,4163667115,2024142359,6187809474,1,1,1,2139524756,Out > In
Feb 2020,134,113,1,108896,145717,254613,1,1,1,36821,In > Out
Feb 2020,134,114,14,669558,21092575,21762133,14,14,1,20423017,In > Out
Feb 2020,134,115,3,11837980,10005315,21843295,3,3,3,1832665,Out > In
Feb 2020,134,117,3,34938,816328,851266,2,1,3,781390,In > Out
Feb 2020,134,12,5,282737737,274096150,556833887,4,5,3,8641587,Out > In
Feb 2020,134,120,2,543459266,770634198,1314093464,2,2,2,227174932,In > Out
Feb 2020,134,122,1,20965,361286,382251,1,1,1,340321,In > Out
Feb 2020,134,123,1,205972,219505,425477,1,1,1,13533,In > Out
Feb 2020,134,124,1,111073,113970,225043,1,1,1,2897,In > Out
Feb 2020,134,126,1,139192,145032,284224,1,1,1,5840,In > Out
Feb 2020,134,127,8,11155387,16551404,27706791,8,8,7,5396017,In > Out
Feb 2020,134,128,3,22993529,44456139,67449668,3,3,2,21462610,In > Out
Feb 2020,134,13,3,256865,257986,514851,3,2,2,1121,In > Out
Feb 2020,134,131,12,169459609,206398322,375857931,10,12,5,36938713,In > Out
Feb 2020,134,133,2,136882,215926,352808,2,2,2,79044,In > Out
Feb 2020,134,134,1,15572479,402975679,418548158,1,1,1,387403200,In > Out
Feb 2020,134,140,1,505739346,159063969,664803315,1,1,1,346675377,Out > In
Feb 2020,134,141,1,862404,1001398,1863802,1,1,1,138994,In > Out
Feb 2020,134,142,4,3514368,1432337,4946705,1,2,2,2082031,Out > In
Feb 2020,134,143,1,60232,71720,131952,1,1,1,11488,In > Out
Feb 2020,134,144,4,73740599,74532711,148273310,2,4,4,792112,In > Out
Feb 2020,134,145,17,6615017,15363303,21978320,12,3,17,8748286,In > Out
Feb 2020,134,146,12,27780844,86242876,114023720,2,2,2,58462032,In > Out
Feb 2020,134,150,1,74957,29315,104272,1,1,1,45642,Out > In
Feb 2020,134,152,1,550248,212965,763213,1,1,1,337283,Out > In
Feb 2020,134,154,25,71882012,323092484,394974496,25,15,4,251210472,In > Out
Feb 2020,134,156,10,109024155,115874699,224898854,4,10,2,6850544,In > Out
Feb 2020,134,157,2,276711987,239858162,516570149,2,2,1,36853825,Out > In
Feb 2020,134,158,4,88031928,105498988,193530916,2,3,4,17467060,In > Out
Feb 2020,134,162,3,7130612,15337495,22468107,3,3,3,8206883,In > Out
Feb 2020,134,163,1,3603179,2786918,6390097,1,1,1,816261,Out > In
Feb 2020,134,167,1,2107040,2766660,4873700,1,1,1,659620,In > Out
Feb 2020,134,168,1,190439351,103889105,294328456,1,1,1,86550246,Out > In
Feb 2020,134,171,1,192294,150811,343105,1,1,1,41483,Out > In
Feb 2020,134,174,2,277472044,246553111,524025155,2,2,2,30918933,Out > In
Feb 2020,134,176,2,8679638,27119587,35799225,2,2,2,18439949,In > Out
Feb 2020,134,178,3,81214923,79836750,161051673,3,3,3,1378173,Out > In
Feb 2020,134,180,1,567336,680752,1248088,1,1,1,113416,In > Out
Feb 2020,134,181,1,292006,102697,394703,1,1,1,189309,Out > In
Feb 2020,134,182,1,483095,259066,742161,1,1,1,224029,Out > In
Feb 2020,134,185,159,550462004,90325915,640787919,149,146,17,460136089,Out > In
Feb 2020,134,190,2,328055844,320840927,648896771,2,2,2,7214917,Out > In
Feb 2020,134,196,2,246746348,299332613,546078961,2,2,2,52586265,In > Out
Feb 2020,134,198,1,3128931,3384587,6513518,1,1,1,255656,In > Out
Feb 2020,134,20,13,38718505,2571028,41289533,13,13,2,36147477,Out > In
Feb 2020,134,201,1,4250325,31442,4281767,1,1,1,4218883,Out > In
Feb 2020,134,204,3,7897619,10220904,18118523,3,3,3,2323285,In > Out
Feb 2020,134,205,2,2106674,1479315,3585989,2,2,2,627359,Out > In
Feb 2020,134,206,1,60975,71291,132266,1,1,1,10316,In > Out
Feb 2020,134,209,1,2084,1194623,1196707,1,1,1,1192539,In > Out
Feb 2020,134,213,5,705794630,644120878,1349915508,4,5,4,61673752,Out > In
Feb 2020,134,214,1,901562,1306572,2208134,1,1,1,405010,In > Out
Feb 2020,134,216,3,177383164,138120735,315503899,2,3,1,39262429,Out > In
Feb 2020,134,220,1,1372972,1619457,2992429,1,1,1,246485,In > Out
Feb 2020,134,222,15,36421292,142319033,178740325,14,14,15,105897741,In > Out
Feb 2020,134,223,187,1126455877,3247621758,4374077635,178,168,4,2121165881,In > Out
Feb 2020,134,23,5,2791318,24123848,26915166,2,5,5,21332530,In > Out
Feb 2020,134,29,2,4016774,26093938,30110712,2,2,2,22077164,In > Out
Feb 2020,134,30,2,315553,249863,565416,2,2,2,65690,Out > In
Feb 2020,134,32,4,498918590,575362191,1074280781,4,4,2,76443601,In > Out
Feb 2020,134,33,2,120375331,161408227,281783558,2,2,1,41032896,In > Out
Feb 2020,134,34,3,22572669,24112568,46685237,3,3,3,1539899,In > Out
Feb 2020,134,40,1,112352,199069,311421,1,1,1,86717,In > Out
Feb 2020,134,42,38,272417837,243794455,516212292,7,37,11,28623382,Out > In
Feb 2020,134,43,49,8315994,394311840,402627834,1,1,49,385995846,In > Out
Feb 2020,134,47,2,3388593,6824925,10213518,2,2,2,3436332,In > Out
Feb 2020,134,5,1,151076,237445,388521,1,1,1,86369,In > Out
Feb 2020,134,50,3,160389,1562318,1722707,3,2,3,1401929,In > Out
Feb 2020,134,52,3,4218202,11396673,15614875,3,3,3,7178471,In > Out
Feb 2020,134,53,1,465863,102951,568814,1,1,1,362912,Out > In
Feb 2020,134,54,2,286324298,303833690,590157988,1,2,2,17509392,In > Out
Feb 2020,134,55,1,1801133,1841309,3642442,1,1,1,40176,In > Out
Feb 2020,134,56,10,288320702,261438445,549759147,7,9,10,26882257,Out > In
Feb 2020,134,58,4,5810235,4099027,9909262,2,3,3,1711208,Out > In
Feb 2020,134,64,287,1641464566,3550676816,5192141382,105,285,3,1909212250,In > Out
Feb 2020,134,66,2,480678848,247121473,727800321,2,2,2,233557375,Out > In
Feb 2020,134,69,1,1351685,1329837,2681522,1,1,1,21848,Out > In
Feb 2020,134,71,2,464441,422111,886552,2,2,2,42330,Out > In
Feb 2020,134,72,2,1773447,1372082,3145529,1,2,2,401365,Out > In
Feb 2020,134,73,5,786513313,632401808,1418915121,3,5,1,154111505,Out > In
Feb 2020,134,74,1,908,117276,118184,1,1,1,116368,In > Out
Feb 2020,134,75,3,10286301,8640361,18926662,3,3,2,1645940,Out > In
Feb 2020,134,76,2,34276949,27449193,61726142,2,2,2,6827756,Out > In
Feb 2020,134,77,5,4629432,5232071,9861503,4,4,5,602639,In > Out
Feb 2020,134,78,1,3124612,49471860,52596472,1,1,1,46347248,In > Out
Feb 2020,134,81,5,6248487,6234646,12483133,5,5,3,13841,Out > In
Feb 2020,134,82,2,482168,2311078,2793246,2,2,2,1828910,In > Out
Feb 2020,134,91,1,186172,20785,206957,1,1,1,165387,Out > In
Feb 2020,134,95,1,391487,371210,762697,1,1,1,20277,Out > In
Feb 2020,134,99,1,843590046,550433345,1394023391,1,1,1,293156701,Out > In
Feb 2020,139,101,13,70428,1645370,1715798,1,13,1,1574942,In > Out
Feb 2020,139,104,1,3984,106619,110603,1,1,1,102635,In > Out
Feb 2020,139,128,3,22308,531690,553998,1,3,1,509382,In > Out
Feb 2020,139,142,4,24904,577233,602137,1,4,1,552329,In > Out
Feb 2020,139,143,2,10352,238062,248414,1,2,1,227710,In > Out
Feb 2020,139,154,1,4664,122083,126747,1,1,1,117419,In > Out
Feb 2020,139,158,1,6092,142148,148240,1,1,1,136056,In > Out
Feb 2020,139,164,3,13060,340767,353827,1,3,1,327707,In > Out
Feb 2020,139,195,3,13736,332608,346344,1,3,1,318872,In > Out
Feb 2020,139,196,5,28384,658185,686569,1,5,1,629801,In > Out
Feb 2020,139,20,1,6436,142244,148680,1,1,1,135808,In > Out
Feb 2020,139,218,1,4636,108061,112697,1,1,1,103425,In > Out
Feb 2020,139,219,2,9152,209145,218297,1,2,1,199993,In > Out
Feb 2020,139,227,2,9832,232944,242776,1,2,1,223112,In > Out
Feb 2020,139,232,1,6796,157598,164394,1,1,1,150802,In > Out
Feb 2020,139,235,1,5796,135375,141171,1,1,1,129579,In > Out
Feb 2020,139,236,1,4436,102335,106771,1,1,1,97899,In > Out
Feb 2020,139,237,1,5036,120756,125792,1,1,1,115720,In > Out
Feb 2020,139,247,4,19904,461877,481781,1,4,1,441973,In > Out
Feb 2020,139,252,2,12712,297768,310480,1,2,1,285056,In > Out
Feb 2020,139,38,2,14752,346792,361544,1,2,1,332040,In > Out
Feb 2020,139,4,6,30564,707016,737580,1,6,1,676452,In > Out
Feb 2020,139,60,1,4572,103803,108375,1,1,1,99231,In > Out
Feb 2020,139,63,1,4196,98940,103136,1,1,1,94744,In > Out
Feb 2020,139,64,2,7316,199168,206484,1,2,1,191852,In > Out
Feb 2020,139,7,1,6396,158295,164691,1,1,1,151899,In > Out
Feb 2020,139,73,4,26256,625561,651817,1,4,1,599305,In > Out
Feb 2020,139,8,1,7876,186157,194033,1,1,1,178281,In > Out
Feb 2020,139,90,1,4196,112276,116472,1,1,1,108080,In > Out
Feb 2020,139,91,5,31660,723637,755297,1,5,1,691977,In > Out
Feb 2020,14,12,4,728714,186160,914874,3,4,2,542554,Out > In
Feb 2020,14,16,17,524765889,176241040,701006929,1,17,1,348524849,Out > In
Feb 2020,14,21,4,156305,1956122,2112427,1,3,4,1799817,In > Out
Feb 2020,14,29,1,5236,123154,128390,1,1,1,117918,In > Out
Feb 2020,14,40,4,57352,2342263,2399615,3,4,3,2284911,In > Out
Feb 2020,14,42,8,257724,12006541,12264265,6,8,8,11748817,In > Out
Feb 2020,141,28,3,379623781,1240914022,1620537803,3,3,3,861290241,In > Out
Feb 2020,142,10,10,1994536,66227,2060763,3,10,1,1928309,Out > In
Feb 2020,142,11,34,7641241,1050475,8691716,9,34,2,6590766,Out > In
Feb 2020,142,16,24,289240327,2807992,292048319,9,24,1,286432335,Out > In
Feb 2020,142,17,20007,96452629,4075163563,4171616192,22,6306,2,3978710934,In > Out
Feb 2020,142,18,47,43242815,690564,43933379,22,47,2,42552251,Out > In
Feb 2020,142,19,2,801084,18630,819714,2,2,1,782454,Out > In
Feb 2020,142,22,409769,229956878177,10410846243,240367724420,3588,60308,2,219546031934,Out > In
Feb 2020,142,24,8,14279244,240347,14519591,5,8,2,14038897,Out > In
Feb 2020,142,27,1,84857,27075,111932,1,1,1,57782,Out > In
Feb 2020,142,35,185,167464172,2162292,169626464,31,185,1,165301880,Out > In
Feb 2020,142,36,1727,2800391765,54476463,2854868228,87,1698,379,2745915302,Out > In
Feb 2020,142,38,3,451702,18555,470257,2,3,1,433147,Out > In
Feb 2020,142,43,1991,308430291,7936921,316367212,826,1940,1,300493370,Out > In
Feb 2020,142,44,3,427316,13056,440372,3,3,1,414260,Out > In
Feb 2020,142,46,77,38420428,1119300,39539728,41,77,1,37301128,Out > In
Feb 2020,142,49,4,994324,8800,1003124,3,4,1,985524,Out > In
Feb 2020,142,50,3,254753,6684716,6939469,2,2,3,6429963,In > Out
Feb 2020,142,53,389,124097036,3085508,127182544,355,385,1,121011528,Out > In
Feb 2020,142,54,13903,7787245312,188591351,7975836663,1831,11689,947,7598653961,Out > In
Feb 2020,142,55,387,412857445,4062669,416920114,270,381,1,408794776,Out > In
Feb 2020,142,56,14389,21964578464,259039635,22223618099,584,9783,8954,21705538829,Out > In
Feb 2020,142,57,11805,4637879917,127181925,4765061842,69,8607,10363,4510697992,Out > In
Feb 2020,142,58,5845,4979158698,74704210,5053862908,63,4926,5133,4904454488,Out > In
Feb 2020,142,59,2088,15017741696,155472852,15173214548,45,2076,1,14862268844,Out > In
Feb 2020,142,60,1,3590726,96089186,99679912,1,1,1,92498460,In > Out
Feb 2020,142,61,2,219802,103332,323134,1,2,1,116470,Out > In
Feb 2020,142,63,3,1546786,91850,1638636,2,3,1,1454936,Out > In
Feb 2020,142,66,1487,565525610,11780760,577306370,164,1478,1,553744850,Out > In
Feb 2020,142,68,3,21860,622713,644573,1,1,3,600853,In > Out
Feb 2020,142,69,77,3344571,131389991,134734562,9,3,75,128045420,In > Out
Feb 2020,142,70,441,2292536,56956285,59248821,1,1,437,54663749,In > Out
Feb 2020,142,71,1876,16655140,494533124,511188264,7,7,1764,477877984,In > Out
Feb 2020,142,73,5984,2057860681,39137550,2096998231,62,5446,1,2018723131,Out > In
Feb 2020,142,74,38,27194313,481082,27675395,20,38,1,26713231,Out > In
Feb 2020,142,75,9,3412008,400287,3812295,4,9,1,3011721,Out > In
Feb 2020,142,79,216,2689405,97328711,100018116,12,2,213,94639306,In > Out
Feb 2020,142,86,4645,12129296,639257369,651386665,2,4411,1,627128073,In > Out
Feb 2020,142,87,45,10901555,961200,11862755,1,45,1,9940355,Out > In
Feb 2020,142,88,3,764884,105591,870475,3,3,1,659293,Out > In
Feb 2020,142,89,3,530811,251418,782229,2,3,1,279393,Out > In
Feb 2020,142,9,17,7238780,680625,7919405,10,17,2,6558155,Out > In
Feb 2020,142,91,4,548151,276975,825126,2,4,1,271176,Out > In
Feb 2020,142,93,16,2246725,207069,2453794,6,16,1,2039656,Out > In
Feb 2020,142,98,11,3412012,814154,4226166,3,11,1,2597858,Out > In
Feb 2020,143,103,1,6612,161950,168562,1,1,1,155338,In > Out
Feb 2020,143,104,3,13188,303750,316938,1,3,1,290562,In > Out
Feb 2020,143,128,142,6758917965,24374264001,31133181966,107,132,116,17615346036,In > Out
Feb 2020,143,132,80,326726191,739214294,1065940485,38,27,51,412488103,In > Out
Feb 2020,143,133,2,10392,239848,250240,1,2,1,229456,In > Out
Feb 2020,143,152,9,230947635,205866748,436814383,8,8,8,25080887,Out > In
Feb 2020,143,160,1,3692,100303,103995,1,1,1,96611,In > Out
Feb 2020,143,163,1,6504,140885,147389,1,1,1,134381,In > Out
Feb 2020,143,168,718,7328414494,383871448,7712285942,199,249,11,6944543046,Out > In
Feb 2020,143,170,1,4476,117095,121571,1,1,1,112619,In > Out
Feb 2020,143,181,1,4316,100947,105263,1,1,1,96631,In > Out
Feb 2020,143,187,3,15000876,24231868,39232744,3,3,3,9230992,In > Out
Feb 2020,143,194,2,10728,248989,259717,1,2,1,238261,In > Out
Feb 2020,143,196,2,8912,204824,213736,1,2,1,195912,In > Out
Feb 2020,143,198,1,4476,101190,105666,1,1,1,96714,In > Out
Feb 2020,143,20,1,4144,101840,105984,1,1,1,97696,In > Out
Feb 2020,143,205,2,59949,343686,403635,2,2,2,283737,In > Out
Feb 2020,143,206,4,18544,432682,451226,1,4,1,414138,In > Out
Feb 2020,143,225,1,6156,152833,158989,1,1,1,146677,In > Out
Feb 2020,143,23,2,13592,316119,329711,1,2,1,302527,In > Out
Feb 2020,143,232,1,4196,99024,103220,1,1,1,94828,In > Out
Feb 2020,143,242,1,4052,107601,111653,1,1,1,103549,In > Out
Feb 2020,143,248,5,22580,527548,550128,1,5,1,504968,In > Out
Feb 2020,143,28,59,142759495,851136999,993896494,34,47,22,708377504,In > Out
Feb 2020,143,34,1,4356,100923,105279,1,1,1,96567,In > Out
Feb 2020,143,37,1,3384,104290,107674,1,1,1,100906,In > Out
Feb 2020,143,38,3,17668,418089,435757,1,3,1,400421,In > Out
Feb 2020,143,44,1,4156,98598,102754,1,1,1,94442,In > Out
Feb 2020,143,51,2,14952,347119,362071,1,2,1,332167,In > Out
Feb 2020,143,52,1,5676,132555,138231,1,1,1,126879,In > Out
Feb 2020,143,53,3,14628,345688,360316,1,3,1,331060,In > Out
Feb 2020,143,54,1,5904,149797,155701,1,1,1,143893,In > Out
Feb 2020,143,71,3,15908,372784,388692,1,3,1,356876,In > Out
Feb 2020,143,74,2,9992,239033,249025,1,2,1,229041,In > Out
Feb 2020,144,10,1,3704,104138,107842,1,1,1,100434,In > Out
Feb 2020,144,100,1,3652,102845,106497,1,1,1,99193,In > Out
Feb 2020,144,108,3,21588,507765,529353,1,3,1,486177,In > Out
Feb 2020,144,11,5,25448,624023,649471,1,5,1,598575,In > Out
Feb 2020,144,112,1,4104,120476,124580,1,1,1,116372,In > Out
Feb 2020,144,124,1,3944,105106,109050,1,1,1,101162,In > Out
Feb 2020,144,13,2,9404,221453,230857,1,2,1,212049,In > Out
Feb 2020,144,14,1,5316,122857,128173,1,1,1,117541,In > Out
Feb 2020,144,170,1,4516,109946,114462,1,1,1,105430,In > Out
Feb 2020,144,176,1,4464,104044,108508,1,1,1,99580,In > Out
Feb 2020,144,177,1,5836,134712,140548,1,1,1,128876,In > Out
Feb 2020,144,204,3,19588,463847,483435,1,3,1,444259,In > Out
Feb 2020,144,209,2,10472,250625,261097,1,2,1,240153,In > Out
Feb 2020,144,210,3,17096,387987,405083,1,3,1,370891,In > Out
Feb 2020,144,229,2,13952,324012,337964,1,2,1,310060,In > Out
Feb 2020,144,240,2,8368,223381,231749,1,2,1,215013,In > Out
Feb 2020,144,242,1,5196,120237,125433,1,1,1,115041,In > Out
Feb 2020,144,246,3,17592,410571,428163,1,3,1,392979,In > Out
Feb 2020,144,248,1,4224,111845,116069,1,1,1,107621,In > Out
Feb 2020,144,30,1,5516,132550,138066,1,1,1,127034,In > Out
Feb 2020,144,46,3,15296,352944,368240,1,3,1,337648,In > Out
Feb 2020,144,5,4,23988,569312,593300,1,4,1,545324,In > Out
Feb 2020,144,58,3,13456,306765,320221,1,3,1,293309,In > Out
Feb 2020,144,68,2,15312,356070,371382,1,2,1,340758,In > Out
Feb 2020,144,81,1,4824,120843,125667,1,1,1,116019,In > Out
Feb 2020,145,10,2,9168,210683,219851,1,2,1,201515,In > Out
Feb 2020,145,11,5,24900,583449,608349,1,5,1,558549,In > Out
Feb 2020,145,114,2,10712,250131,260843,1,2,1,239419,In > Out
Feb 2020,145,122,1,6476,152787,159263,1,1,1,146311,In > Out
Feb 2020,145,124,1,4368,102558,106926,1,1,1,98190,In > Out
Feb 2020,145,129,9,44820,1051272,1096092,1,9,1,1006452,In > Out
Feb 2020,145,130,2,11392,264755,276147,1,2,1,253363,In > Out
Feb 2020,145,132,1,6704,159951,166655,1,1,1,153247,In > Out
Feb 2020,145,14,3,11048,309591,320639,1,3,1,298543,In > Out
Feb 2020,145,142,2,10672,269673,280345,1,2,1,259001,In > Out
Feb 2020,145,147,4,19824,462227,482051,1,4,1,442403,In > Out
Feb 2020,145,164,1,4144,103812,107956,1,1,1,99668,In > Out
Feb 2020,145,168,2,12912,300657,313569,1,2,1,287745,In > Out
Feb 2020,145,170,2,9712,221591,231303,1,2,1,211879,In > Out
Feb 2020,145,175,1,3332,104620,107952,1,1,1,101288,In > Out
Feb 2020,145,181,2,9020,204483,213503,1,2,1,195463,In > Out
Feb 2020,145,185,1,4756,111641,116397,1,1,1,106885,In > Out
Feb 2020,145,191,2,11792,271861,283653,1,2,1,260069,In > Out
Feb 2020,145,195,3,14508,336274,350782,1,3,1,321766,In > Out
Feb 2020,145,210,4,19984,465320,485304,1,4,1,445336,In > Out
Feb 2020,145,222,3,13108,305273,318381,1,3,1,292165,In > Out
Feb 2020,145,226,7,38576,915857,954433,1,7,1,877281,In > Out
Feb 2020,145,233,1,6516,154685,161201,1,1,1,148169,In > Out
Feb 2020,145,24,2,9792,227688,237480,1,2,1,217896,In > Out
Feb 2020,145,244,1,5116,123100,128216,1,1,1,117984,In > Out
Feb 2020,145,40,1,6556,154501,161057,1,1,1,147945,In > Out
Feb 2020,145,41,3,17268,396058,413326,1,3,1,378790,In > Out
Feb 2020,145,43,1,7756,184006,191762,1,1,1,176250,In > Out
Feb 2020,145,62,2,9672,225739,235411,1,2,1,216067,In > Out
Feb 2020,145,63,3,19108,443480,462588,1,3,1,424372,In > Out
Feb 2020,145,64,1,4396,99958,104354,1,1,1,95562,In > Out
Feb 2020,145,68,1,4476,102945,107421,1,1,1,98469,In > Out
Feb 2020,145,71,2,11072,257508,268580,1,2,1,246436,In > Out
Feb 2020,145,76,2,9288,213892,223180,1,2,1,204604,In > Out
Feb 2020,145,84,3,15472,370386,385858,1,3,1,354914,In > Out
Feb 2020,145,86,5,23436,539952,563388,1,5,1,516516,In > Out
Feb 2020,146,101,8269,4325560106,447434889,4772994995,1239,5940,2,3878125217,Out > In
Feb 2020,149,160,106,220248200,26430888,246679088,46,82,1,193817312,Out > In
Feb 2020,149,168,1,35070,393732,428802,1,1,1,358662,In > Out
Feb 2020,149,187,61,2158773,18657012,20815785,7,54,2,16498239,In > Out
Feb 2020,149,188,6,343314,3703858,4047172,6,1,6,3360544,In > Out
Feb 2020,149,45,2,270115,1063028,1333143,2,1,2,792913,In > Out
Feb 2020,150,15,8,138045800,1330657,139376457,1,8,6,136715143,Out > In
Feb 2020,150,182,178083,172917302520,6470872508,179388175028,4411,54085,4,166446430012,Out > In
Feb 2020,150,226,2,40283,232728,273011,1,1,2,192445,In > Out
Feb 2020,150,57,9,1304698462,688429008,1993127470,1,9,9,616269454,Out > In
Feb 2020,151,0,2,13592,320857,334449,1,2,1,307265,In > Out
Feb 2020,151,100,2,13704,321644,335348,1,2,1,307940,In > Out
Feb 2020,151,106,1,4396,98302,102698,1,1,1,93906,In > Out
Feb 2020,151,182,2,9312,209143,218455,1,2,1,199831,In > Out
Feb 2020,151,253,2,9436,218817,228253,1,2,1,209381,In > Out
Feb 2020,151,84,4,22584,523422,546006,1,4,1,500838,In > Out
Feb 2020,153,129,7,1336564,22011636,23348200,1,1,1,20675072,In > Out
Feb 2020,153,141,8,4434592,48200846,52635438,2,2,3,43766254,In > Out
Feb 2020,154,100,2,235342,12614,247956,2,2,1,222728,Out > In
Feb 2020,154,101,4,82282,494640,576922,1,4,4,412358,In > Out
Feb 2020,154,67,13,1795038046,1093062707,2888100753,1,13,12,701975339,Out > In
Feb 2020,155,103,1,237442,106729,344171,1,1,1,130713,Out > In
Feb 2020,155,106,1,173124,103378,276502,1,1,1,69746,Out > In
Feb 2020,155,135,1246,2160368625,42655855,2203024480,123,1224,410,2117712770,Out > In
Feb 2020,155,136,82,99737595,1927311,101664906,14,82,2,97810284,Out > In
Feb 2020,155,137,1799,4462902146,60947598,4523849744,172,1735,2,4401954548,Out > In
Feb 2020,155,142,9860,3220185758,62077879,3282263637,78,8541,4,3158107879,Out > In
Feb 2020,155,143,94,17505033,1985193,19490226,43,79,2,15519840,Out > In
Feb 2020,155,145,2,547967,49031,596998,1,2,1,498936,Out > In
Feb 2020,155,146,7,1728117,231164,1959281,6,7,2,1496953,Out > In
Feb 2020,155,149,306590,129453001316,2646653305,132099654621,10736,52155,4,126806348011,Out > In
Feb 2020,155,150,3147,2076134548,55025806,2131160354,912,2990,2,2021108742,Out > In
Feb 2020,155,151,509,18187374704,270787214,18458161918,135,505,13,17916587490,Out > In
Feb 2020,155,153,118,192909044,1376143,194285187,8,100,2,191532901,Out > In
Feb 2020,155,154,120,90893594,1438068,92331662,26,120,2,89455526,Out > In
Feb 2020,155,158,327,84115368,175415639,259531007,37,286,8,91300271,In > Out
Feb 2020,155,166,1,46406,56504,102910,1,1,1,10098,In > Out
Feb 2020,155,167,41107,57196887746,2212939521,59409827267,2608,13387,2,54983948225,Out > In
Feb 2020,155,169,144,267680719,55326266,323006985,62,113,2,212354453,Out > In
Feb 2020,155,170,268,331326004,52170402,383496406,155,161,1,279155602,Out > In
Feb 2020,155,198,57,19032772,429625,19462397,22,57,2,18603147,Out > In
Feb 2020,155,199,1,70284,63999,134283,1,1,1,6285,Out > In
Feb 2020,155,200,21,11383912,321895,11705807,3,21,2,11062017,Out > In
Feb 2020,155,201,24,43098222,770882,43869104,6,24,2,42327340,Out > In
Feb 2020,155,202,190,33175821,878875,34054696,22,190,2,32296946,Out > In
Feb 2020,155,205,208,43338257,120871203,164209460,53,207,32,77532946,In > Out
Feb 2020,155,72,2,441555,29404,470959,1,2,1,412151,Out > In
Feb 2020,155,75,3,504420,36213,540633,2,3,1,468207,Out > In
Feb 2020,156,235,9,165325,2089107,2254432,3,1,9,1923782,In > Out
Feb 2020,156,248,879,131683388,56012315,187695703,219,280,1,75671073,Out > In
Feb 2020,157,58,5,80441740,123736834,204178574,2,4,4,43295094,In > Out
Feb 2020,159,150,3,1186288,8488,1194776,1,3,3,1177800,Out > In
Feb 2020,16,10,2,113148,73441723,73554871,1,1,2,73328575,In > Out
Feb 2020,16,14,66,2907152346,569682416,3476834762,32,63,64,2337469930,Out > In
Feb 2020,16,16,41,418288298,1111271343,1529559641,37,38,41,692983045,In > Out
Feb 2020,16,20,69,2411999118,273032076,2685031194,22,26,37,2138967042,Out > In
Feb 2020,16,21,2,11632,273869,285501,1,2,1,262237,In > Out
Feb 2020,16,41,1,4716,104990,109706,1,1,1,100274,In > Out
Feb 2020,16,51,3,21868,507931,529799,1,3,1,486063,In > Out
Feb 2020,16,7,8,23216098,159509897,182725995,8,8,8,136293799,In > Out
Feb 2020,160,109,48,14375802,4999072,19374874,1,1,48,9376730,Out > In
Feb 2020,160,11,1,136136,26784,162920,1,1,1,109352,Out > In
Feb 2020,160,12,1,113408,22368,135776,1,1,1,91040,Out > In
Feb 2020,160,121,408,6355390600,5213612908,11569003508,285,275,288,1141777692,Out > In
Feb 2020,160,122,670,4155995111,9642563244,13798558355,457,516,543,5486568133,In > Out
Feb 2020,160,123,770,3761695538,4775526446,8537221984,660,681,561,1013830908,In > Out
Feb 2020,160,124,443,5823249187,5339044688,11162293875,83,90,418,484204499,Out > In
Feb 2020,160,125,225,3013873133,13008945275,16022818408,142,155,208,9995072142,In > Out
Feb 2020,160,126,380,3199044614,5913416210,9112460824,186,194,260,2714371596,In > Out
Feb 2020,160,127,1533,3523047506,6438642336,9961689842,1224,1369,1445,2915594830,In > Out
Feb 2020,160,128,43,2107862904,3780452455,5888315359,34,22,43,1672589551,In > Out
Feb 2020,160,13,1,99952,19008,118960,1,1,1,80944,Out > In
Feb 2020,160,130,2,16149037,1771779703,1787928740,2,2,2,1755630666,In > Out
Feb 2020,160,132,118,183948580,328887787,512836367,29,4,118,144939207,In > Out
Feb 2020,160,152,180,625521954,2177033858,2802555812,98,127,179,1551511904,In > Out
Feb 2020,160,153,175,587802365,2019693745,2607496110,100,117,174,1431891380,In > Out
Feb 2020,160,154,122,438551711,1463825129,1902376840,82,94,122,1025273418,In > Out
Feb 2020,160,155,123,441868019,1547838479,1989706498,78,98,121,1105970460,In > Out
Feb 2020,160,156,153,600098514,2021372812,2621471326,96,113,152,1421274298,In > Out
Feb 2020,160,157,181,619297250,2162879900,2782177150,100,111,180,1543582650,In > Out
Feb 2020,160,196,127,2194668424,2923876055,5118544479,108,108,118,729207631,In > Out
Feb 2020,160,197,111,826240544,1344134865,2170375409,39,45,106,517894321,In > Out
Feb 2020,160,198,27,830865420,1571005256,2401870676,23,23,27,740139836,In > Out
Feb 2020,160,199,170,493971327,1258950751,1752922078,62,70,167,764979424,In > Out
Feb 2020,160,200,23,268774687,327179608,595954295,11,10,22,58404921,In > Out
Feb 2020,160,201,35,22606466,68713238,91319704,15,8,33,46106772,In > Out
Feb 2020,160,202,13,4556945,18856205,23413150,10,8,13,14299260,In > Out
Feb 2020,160,203,15,87735728,201538167,289273895,12,9,14,113802439,In > Out
Feb 2020,160,238,12,21689892,993726879,1015416771,6,5,9,972036987,In > Out
Feb 2020,160,239,104,1043071401,3867372691,4910444092,65,59,65,2824301290,In > Out
Feb 2020,160,240,67,6438464208,4652892614,11091356822,41,40,51,1785571594,Out > In
Feb 2020,160,241,231,807287649,3033935220,3841222869,215,206,204,2226647571,In > Out
Feb 2020,160,242,424,2328404943,9023833410,11352238353,174,183,126,6695428467,In > Out
Feb 2020,160,243,139,365310736,1529165895,1894476631,94,84,131,1163855159,In > Out
Feb 2020,160,244,126,701380529,2378094732,3079475261,76,86,97,1676714203,In > Out
Feb 2020,160,245,123,726030696,1609235317,2335266013,88,61,37,883204621,In > Out
Feb 2020,160,246,93,400095662,541255377,941351039,42,37,64,141159715,In > Out
Feb 2020,160,247,235,487059463,1526009614,2013069077,185,95,64,1038950151,In > Out
Feb 2020,160,33,1,107545,9706,117251,1,1,1,97839,Out > In
Feb 2020,160,34,49,2172666,389644376,391817042,1,1,48,387471710,In > Out
Feb 2020,160,36,110,83547031,28205196,111752227,12,1,8,55341835,Out > In
Feb 2020,160,39,210,384254037,113911291,498165328,19,2,13,270342746,Out > In
Feb 2020,160,40,1,13855420,75776,13931196,1,1,1,13779644,Out > In
Feb 2020,160,57,2,403096,64435975,64839071,1,1,2,64032879,In > Out
Feb 2020,160,58,6,34315724,503061867,537377591,6,4,6,468746143,In > Out
Feb 2020,160,59,6,142307735,11254753,153562488,3,4,6,131052982,Out > In
Feb 2020,160,60,2518,82919357,7633250135,7716169492,3,916,2410,7550330778,In > Out
Feb 2020,160,61,1,16966401,200937933,217904334,1,1,1,183971532,In > Out
Feb 2020,160,62,3,367507118,122901582,490408700,2,2,3,244605536,Out > In
Feb 2020,160,63,6,32240962,5505320,37746282,3,5,6,26735642,Out > In
Feb 2020,160,65,101,4356961749,393468791,4750430540,43,81,93,3963492958,Out > In
Feb 2020,160,66,46,201586461,97016791,298603252,24,26,26,104569670,Out > In
Feb 2020,160,67,21,266188573,13466775,279655348,12,19,16,252721798,Out > In
Feb 2020,160,68,215,1220623389,3073732829,4294356218,99,113,127,1853109440,In > Out
Feb 2020,160,69,33,521553200,560912669,1082465869,24,19,23,39359469,In > Out
Feb 2020,160,70,65,4916673218,486837766,5403510984,15,49,62,4429835452,Out > In
Feb 2020,160,71,13,964621744,1153737156,2118358900,7,5,10,189115412,In > Out
Feb 2020,160,72,347,1104584591,1227592532,2332177123,57,114,243,123007941,In > Out
Feb 2020,160,77,1,128736,691528,820264,1,1,1,562792,In > Out
Feb 2020,160,78,1,158158,276712,434870,1,1,1,118554,In > Out
Feb 2020,160,79,29,20491678,303925150,324416828,23,23,28,283433472,In > Out
Feb 2020,160,80,4,10368999,197602185,207971184,2,2,4,187233186,In > Out
Feb 2020,160,9,1,85136,25632,110768,1,1,1,59504,Out > In
Feb 2020,161,100,218,27178125,273949023,301127148,97,130,10,246770898,In > Out
Feb 2020,161,107,5,1937576,2090949,4028525,4,5,5,153373,In > Out
Feb 2020,161,111,6,746974,1366844,2113818,2,1,6,619870,In > Out
Feb 2020,161,112,1,1107559204,1103174538,2210733742,1,1,1,4384666,Out > In
Feb 2020,161,113,3,1276478,4404745,5681223,2,3,3,3128267,In > Out
Feb 2020,161,115,1,154887464,136445239,291332703,1,1,1,18442225,Out > In
Feb 2020,161,117,3,2291938,2351574,4643512,3,3,3,59636,In > Out
Feb 2020,161,118,4,26350,561247,587597,1,1,4,534897,In > Out
Feb 2020,161,12,2,1517005,1723424,3240429,1,2,2,206419,In > Out
Feb 2020,161,124,8,332573825,499375816,831949641,7,8,7,166801991,In > Out
Feb 2020,161,127,4,94127935,152017690,246145625,3,2,3,57889755,In > Out
Feb 2020,161,129,1,346492,365701,712193,1,1,1,19209,In > Out
Feb 2020,161,132,1,636386034,449063926,1085449960,1,1,1,187322108,Out > In
Feb 2020,161,138,4,50630456,56520974,107151430,4,4,4,5890518,In > Out
Feb 2020,161,139,4,1242965833,771661878,2014627711,3,4,3,471303955,Out > In
Feb 2020,161,14,1,42286,394480,436766,1,1,1,352194,In > Out
Feb 2020,161,144,1,825771923,534140907,1359912830,1,1,1,291631016,Out > In
Feb 2020,161,145,1,59236,192005,251241,1,1,1,132769,In > Out
Feb 2020,161,147,5,26261311,18309279,44570590,4,4,4,7952032,Out > In
Feb 2020,161,153,1,70911772,69503167,140414939,1,1,1,1408605,Out > In
Feb 2020,161,16,8,7954213,6606273,14560486,4,8,4,1347940,Out > In
Feb 2020,161,160,9,99344,3340151,3439495,2,4,9,3240807,In > Out
Feb 2020,161,161,133,441978268,54680786,496659054,119,128,112,387297482,Out > In
Feb 2020,161,162,5,12396611,19224626,31621237,4,5,4,6828015,In > Out
Feb 2020,161,167,1,644807,396672,1041479,1,1,1,248135,Out > In
Feb 2020,161,169,16,8182560,121064,8303624,16,12,1,8061496,Out > In
Feb 2020,161,17,3,501405063,535475338,1036880401,3,3,2,34070275,In > Out
Feb 2020,161,173,7,10870830,35159775,46030605,5,6,5,24288945,In > Out
Feb 2020,161,174,2,550537,1210595,1761132,1,2,2,660058,In > Out
Feb 2020,161,18,3,2678297,11866764,14545061,3,3,2,9188467,In > Out
Feb 2020,161,180,1,61066,109358,170424,1,1,1,48292,In > Out
Feb 2020,161,182,148,487543966,698423688,1185967654,108,116,8,210879722,In > Out
Feb 2020,161,183,6,299819,2403881,2703700,6,3,3,2104062,In > Out
Feb 2020,161,186,2,5930909,6345657,12276566,2,2,2,414748,In > Out
Feb 2020,161,188,8,591887614,409025251,1000912865,4,8,7,182862363,Out > In
Feb 2020,161,189,2,5493527,188033047,193526574,2,2,2,182539520,In > Out
Feb 2020,161,191,2,1325250,1074326,2399576,1,2,1,250924,Out > In
Feb 2020,161,192,1,1032954,1197082,2230036,1,1,1,164128,In > Out
Feb 2020,161,195,2,78065794,128402684,206468478,1,2,2,50336890,In > Out
Feb 2020,161,20,1,4276549,3077488,7354037,1,1,1,1199061,Out > In
Feb 2020,161,201,2,416245951,410996022,827241973,2,2,2,5249929,Out > In
Feb 2020,161,209,4,19004734,19638493,38643227,1,4,4,633759,In > Out
Feb 2020,161,210,2,1899459,4928233,6827692,2,2,2,3028774,In > Out
Feb 2020,161,212,4,608615485,288121022,896736507,4,4,4,320494463,Out > In
Feb 2020,161,215,2,292647,975276,1267923,2,2,2,682629,In > Out
Feb 2020,161,216,2,24500,1675802,1700302,1,1,2,1651302,In > Out
Feb 2020,161,217,6,8205452,36122991,44328443,6,5,1,27917539,In > Out
Feb 2020,161,220,8,83199,2046684,2129883,4,1,8,1963485,In > Out
Feb 2020,161,221,2,315405,597404,912809,2,2,2,281999,In > Out
Feb 2020,161,25,2,451585,322802,774387,2,2,2,128783,Out > In
Feb 2020,161,26,1,27793118,612645825,640438943,1,1,1,584852707,In > Out
Feb 2020,161,28,3,253874,896578,1150452,3,2,3,642704,In > Out
Feb 2020,161,30,2,17462702,20963176,38425878,2,2,1,3500474,In > Out
Feb 2020,161,34,4,265935605,274182580,540118185,2,4,4,8246975,In > Out
Feb 2020,161,35,2,206984036,197885603,404869639,1,1,1,9098433,Out > In
Feb 2020,161,37,4,7443727,4278619,11722346,4,3,4,3165108,Out > In
Feb 2020,161,43,6,80031508,118444837,198476345,6,6,4,38413329,In > Out
Feb 2020,161,46,11,20757518,81299449,102056967,11,10,1,60541931,In > Out
Feb 2020,161,49,1,92915,16426,109341,1,1,1,76489,Out > In
Feb 2020,161,5,3,174251,1080449,1254700,2,3,3,906198,In > Out
Feb 2020,161,50,3,208288677,196130344,404419021,3,2,2,12158333,Out > In
Feb 2020,161,51,2,3970258,2773177,6743435,2,2,2,1197081,Out > In
Feb 2020,161,52,2,413112254,504834727,917946981,2,2,2,91722473,In > Out
Feb 2020,161,53,7,383197580,1799495202,2182692782,4,5,1,1416297622,In > Out
Feb 2020,161,54,4,174921754,51103441,226025195,3,4,3,123818313,Out > In
Feb 2020,161,57,79,30245178,290340468,320585646,79,79,4,260095290,In > Out
Feb 2020,161,6,3,145675517,285408845,431084362,3,3,2,139733328,In > Out
Feb 2020,161,62,3,1000181,1367782,2367963,3,3,3,367601,In > Out
Feb 2020,161,63,1,121170534,195025414,316195948,1,1,1,73854880,In > Out
Feb 2020,161,64,7,46944,1116640,1163584,7,7,1,1069696,In > Out
Feb 2020,161,65,1153,2806474673,1503511507,4309986180,875,426,12,1302963166,Out > In
Feb 2020,161,66,1,1670461,4124,1674585,1,1,1,1666337,Out > In
Feb 2020,161,67,1,10580,241362,251942,1,1,1,230782,In > Out
Feb 2020,161,69,1,112194,163973,276167,1,1,1,51779,In > Out
Feb 2020,161,70,99,694165008,44258355,738423363,87,87,3,649906653,Out > In
Feb 2020,161,72,1,41759,385240,426999,1,1,1,343481,In > Out
Feb 2020,161,74,4,355101585,145345754,500447339,1,1,1,209755831,Out > In
Feb 2020,161,75,184,1961091154,832368434,2793459588,176,182,179,1128722720,Out > In
Feb 2020,161,77,8,4794924,7374025,12168949,8,5,2,2579101,In > Out
Feb 2020,161,8,3,652673,3773977,4426650,2,1,3,3121304,In > Out
Feb 2020,161,80,2,441987127,340239617,782226744,1,2,2,101747510,Out > In
Feb 2020,161,84,2,93276904,83883708,177160612,1,2,2,9393196,Out > In
Feb 2020,161,87,1,91976,204228,296204,1,1,1,112252,In > Out
Feb 2020,161,88,1,222057,185036,407093,1,1,1,37021,Out > In
Feb 2020,161,90,3,71040948,71529521,142570469,3,3,3,488573,In > Out
Feb 2020,161,91,12,105765220,6129184452,6234949672,6,6,4,6023419232,In > Out
Feb 2020,161,94,3,265653087,78171081,343824168,3,3,3,187482006,Out > In
Feb 2020,161,96,1,19669430,17748201,37417631,1,1,1,1921229,Out > In
Feb 2020,161,97,2,244226398,238318437,482544835,1,2,2,5907961,Out > In
Feb 2020,161,99,246,1224382074,1482584357,2706966431,20,20,233,258202283,In > Out
Feb 2020,164,114,1,45592,76944,122536,1,1,1,31352,In > Out
Feb 2020,164,141,1,859630,41301,900931,1,1,1,818329,Out > In
Feb 2020,164,60,1,69672,2588314,2657986,1,1,1,2518642,In > Out
Feb 2020,164,81,1,69960,41218,111178,1,1,1,28742,Out > In
Feb 2020,164,82,1,147840,81622,229462,1,1,1,66218,Out > In
Feb 2020,164,83,310,237964850,39695639,277660489,49,206,3,198269211,Out > In
Feb 2020,165,202,2,1277633,1348270,2625903,2,2,2,70637,In > Out
Feb 2020,165,233,1539,2313167046,88618472,2401785518,162,1012,1,2224548574,Out > In
Feb 2020,165,251,89,14427167,10321375,24748542,3,89,3,4105792,Out > In
Feb 2020,165,89,18,2326770,835386,3162156,1,18,1,1491384,Out > In
Feb 2020,166,153,4,4857988,5619030,10477018,2,2,4,761042,In > Out
Feb 2020,166,198,2,10249382,43533428,53782810,1,1,2,33284046,In > Out
Feb 2020,166,206,3,50973874,105281290,156255164,2,2,3,54307416,In > Out
Feb 2020,167,143,14,4216725,4773018,8989743,14,14,13,556293,In > Out
Feb 2020,167,177,3,36766056,1467526,38233582,1,3,3,35298530,Out > In
Feb 2020,167,186,2,3461311,620213,4081524,2,2,2,2841098,Out > In
Feb 2020,168,112,5,1190193,1085610,2275803,4,4,5,104583,Out > In
Feb 2020,168,13,1,225530,214824,440354,1,1,1,10706,Out > In
Feb 2020,168,153,7,1014388209,237034304,1251422513,4,7,2,777353905,Out > In
Feb 2020,168,155,168141,174167510248,6378615937,180546126185,4340,53471,1,167788894311,Out > In
Feb 2020,168,186,61,81710618,2869426,84580044,3,54,2,78841192,Out > In
Feb 2020,168,201,1,35712,79145,114857,1,1,1,43433,In > Out
Feb 2020,168,57,338,140377025,45465356,185842381,55,226,2,94911669,Out > In
Feb 2020,168,58,6,6030288,219681,6249969,1,6,1,5810607,Out > In
Feb 2020,168,85,101,193716306,5419844,199136150,2,101,1,188296462,Out > In
Feb 2020,169,156,6,4634624,1851652,6486276,3,6,5,2782972,Out > In
Feb 2020,169,159,2,91450,206770,298220,2,2,1,115320,In > Out
Feb 2020,169,4,6,686553,345142,1031695,2,6,1,341411,Out > In
Feb 2020,169,6,107,40887601177,2532300936,43419902113,38,107,4,38355300241,Out > In
Feb 2020,169,8,183,3469205975,6036962380,9506168355,38,107,2,2567756405,In > Out
Feb 2020,169,82,31,14650051,671506,15321557,14,31,1,13978545,Out > In
Feb 2020,169,87,130,5017470,13558413,18575883,2,130,1,8540943,In > Out
Feb 2020,170,129,650,93026574,69849698,162876272,8,635,10,23176876,Out > In
Feb 2020,170,194,7,1271554,2249892,3521446,5,4,5,978338,In > Out
Feb 2020,170,207,2,51268,3457995,3509263,1,1,2,3406727,In > Out
Feb 2020,170,208,1,23272,382220,405492,1,1,1,358948,In > Out
Feb 2020,170,244,1,6040,908432,914472,1,1,1,902392,In > Out
Feb 2020,170,45,4,793292,374892,1168184,4,1,3,418400,Out > In
Feb 2020,171,10,22,135236087,238662174,373898261,13,12,16,103426087,In > Out
Feb 2020,171,101,2,3991726,1064313,5056039,2,2,2,2927413,Out > In
Feb 2020,171,103,3,16327139,23987994,40315133,3,2,3,7660855,In > Out
Feb 2020,171,104,1,54462,78685,133147,1,1,1,24223,In > Out
Feb 2020,171,105,2,1786542,5035550,6822092,2,1,2,3249008,In > Out
Feb 2020,171,107,1,2104004,18964,2122968,1,1,1,2085040,Out > In
Feb 2020,171,109,96,2625324,96290808,98916132,95,76,19,93665484,In > Out
Feb 2020,171,112,1,4354137,12875955,17230092,1,1,1,8521818,In > Out
Feb 2020,171,114,1,7794301,12022857,19817158,1,1,1,4228556,In > Out
Feb 2020,171,115,1,598555458,796152302,1394707760,1,1,1,197596844,In > Out
Feb 2020,171,119,1,92204,75181,167385,1,1,1,17023,Out > In
Feb 2020,171,120,20,20551017,68244980,88795997,11,6,20,47693963,In > Out
Feb 2020,171,123,1,26119,175331,201450,1,1,1,149212,In > Out
Feb 2020,171,125,1,11594927,99387424,110982351,1,1,1,87792497,In > Out
Feb 2020,171,127,2,266868353,388219169,655087522,2,2,2,121350816,In > Out
Feb 2020,171,128,24,26344181,67848941,94193122,24,21,12,41504760,In > Out
Feb 2020,171,129,7,5007802,31948059,36955861,6,6,3,26940257,In > Out
Feb 2020,171,13,1,193271736,201149674,394421410,1,1,1,7877938,In > Out
Feb 2020,171,130,4,15067418,19746134,34813552,3,4,1,4678716,In > Out
Feb 2020,171,132,5,551137066,612667519,1163804585,2,4,5,61530453,In > Out
Feb 2020,171,133,4,8773917,30810565,39584482,4,4,4,22036648,In > Out
Feb 2020,171,134,3,738993,23096574,23835567,3,3,3,22357581,In > Out
Feb 2020,171,136,1,18046310,21725213,39771523,1,1,1,3678903,In > Out
Feb 2020,171,140,4,19041194,20938002,39979196,3,2,3,1896808,In > Out
Feb 2020,171,141,3,606106,3286586,3892692,3,3,3,2680480,In > Out
Feb 2020,171,142,2,118162717,151680104,269842821,1,2,2,33517387,In > Out
Feb 2020,171,15,2,390024,562391,952415,2,1,2,172367,In > Out
Feb 2020,171,151,50,750213136,603970757,1354183893,50,15,5,146242379,Out > In
Feb 2020,171,16,8,165694,3726779,3892473,8,2,8,3561085,In > Out
Feb 2020,171,161,2,1672742,5711708,7384450,2,2,2,4038966,In > Out
Feb 2020,171,164,1,183504,328523,512027,1,1,1,145019,In > Out
Feb 2020,171,166,1,1750221,4256117,6006338,1,1,1,2505896,In > Out
Feb 2020,171,167,12,1376885,88967834,90344719,1,1,12,87590949,In > Out
Feb 2020,171,17,19,331221081,448707095,779928176,17,17,4,117486014,In > Out
Feb 2020,171,171,2,8206297,6683506,14889803,2,2,2,1522791,Out > In
Feb 2020,171,173,5,222717,3894474,4117191,5,5,2,3671757,In > Out
Feb 2020,171,175,1,62533977,266336430,328870407,1,1,1,203802453,In > Out
Feb 2020,171,184,2,188211108,158239055,346450163,2,2,1,29972053,Out > In
Feb 2020,171,185,12,222154902,237921548,460076450,10,12,12,15766646,In > Out
Feb 2020,171,187,16,252384,7822096,8074480,16,16,1,7569712,In > Out
Feb 2020,171,190,10,15848643,21555399,37404042,10,7,10,5706756,In > Out
Feb 2020,171,194,652,6622565627,1003753888,7626319515,552,623,3,5618811739,Out > In
Feb 2020,171,196,1,793127,997506,1790633,1,1,1,204379,In > Out
Feb 2020,171,203,1,513476,594099,1107575,1,1,1,80623,In > Out
Feb 2020,171,205,6,95620647,89512298,185132945,3,6,2,6108349,Out > In
Feb 2020,171,206,5,1226947,13225335,14452282,5,5,5,11998388,In > Out
Feb 2020,171,207,4,963715161,679800027,1643515188,2,4,4,283915134,Out > In
Feb 2020,171,210,1,132665,42512,175177,1,1,1,90153,Out > In
Feb 2020,171,212,1,146183,9786,155969,1,1,1,136397,Out > In
Feb 2020,171,213,2,34318679,35424351,69743030,2,2,2,1105672,In > Out
Feb 2020,171,215,36,499644360,442927921,942572281,25,22,3,56716439,Out > In
Feb 2020,171,221,4,995273,44608141,45603414,4,3,4,43612868,In > Out
Feb 2020,171,222,9,1426906797,1934126560,3361033357,2,2,2,507219763,In > Out
Feb 2020,171,223,3,198768365,213318670,412087035,3,3,3,14550305,In > Out
Feb 2020,171,23,4,2675069,3700426,6375495,4,2,4,1025357,In > Out
Feb 2020,171,27,1,74440,110480,184920,1,1,1,36040,In > Out
Feb 2020,171,35,1,207391,75104,282495,1,1,1,132287,Out > In
Feb 2020,171,37,3,13002502,38968589,51971091,3,3,2,25966087,In > Out
Feb 2020,171,40,1,173160275,162008788,335169063,1,1,1,11151487,Out > In
Feb 2020,171,41,6,259395638,175104371,434500009,5,5,6,84291267,Out > In
Feb 2020,171,44,1,49334,57368,106702,1,1,1,8034,In > Out
Feb 2020,171,46,1,17856743,416156968,434013711,1,1,1,398300225,In > Out
Feb 2020,171,47,10,13500911,128275670,141776581,2,2,2,114774759,In > Out
Feb 2020,171,48,11,66890547,157326809,224217356,9,9,11,90436262,In > Out
Feb 2020,171,57,2,241242095,551509647,792751742,2,2,2,310267552,In > Out
Feb 2020,171,59,13,36997254,40273991,77271245,8,10,13,3276737,In > Out
Feb 2020,171,6,2,32528005,113006636,145534641,2,2,2,80478631,In > Out
Feb 2020,171,65,1,3862094,21733224,25595318,1,1,1,17871130,In > Out
Feb 2020,171,67,5,445487973,635955609,1081443582,5,4,2,190467636,In > Out
Feb 2020,171,71,1,38302,101864,140166,1,1,1,63562,In > Out
Feb 2020,171,72,2,3973584,5848369,9821953,2,2,2,1874785,In > Out
Feb 2020,171,74,2,208571216,55362743,263933959,2,2,2,153208473,Out > In
Feb 2020,171,77,3,106764974,118610210,225375184,3,3,1,11845236,In > Out
Feb 2020,171,82,3,1168852869,1074551203,2243404072,2,2,3,94301666,Out > In
Feb 2020,171,85,3,384694,385516,770210,3,1,3,822,In > Out
Feb 2020,171,86,2,61657042,65208947,126865989,2,2,1,3551905,In > Out
Feb 2020,171,88,6,161544155,110603502,272147657,6,6,6,50940653,Out > In
Feb 2020,171,92,2,5029792,5811952,10841744,2,2,2,782160,In > Out
Feb 2020,171,96,3,1827947,9400907,11228854,3,3,3,7572960,In > Out
Feb 2020,171,98,9,2009002040,2045467953,4054469993,8,3,9,36465913,In > Out
Feb 2020,174,184,22,10267580,18998308,29265888,2,1,2,8730728,In > Out
Feb 2020,176,175,3,386409,183056,569465,1,3,1,203353,Out > In
Feb 2020,176,176,4,553427,248523,801950,3,4,1,304904,Out > In
Feb 2020,176,79,1,110884,3528,114412,1,1,1,107356,Out > In
Feb 2020,176,94,1,50459,163821,214280,1,1,1,113362,In > Out
Feb 2020,178,118,1,76831,51423,128254,1,1,1,25408,Out > In
Feb 2020,179,111,2,47401,246748,294149,2,1,2,199347,In > Out
Feb 2020,179,160,43494,64335580981,4849858569,69185439550,4411,13417,2,59485722412,Out > In
Feb 2020,179,162,1,808568,3067,811635,1,1,1,805501,Out > In
Feb 2020,179,184,9,1526181,190638,1716819,1,9,1,1335543,Out > In
Feb 2020,179,199,2,1003505,8555562,9559067,1,1,2,7552057,In > Out
Feb 2020,179,44,5,90033856,96436459,186470315,1,5,5,6402603,In > Out
Feb 2020,179,52,56,13540339,955440,14495779,17,56,2,12584899,Out > In
Feb 2020,180,189,128,123405294,36989798,160395092,92,110,3,86415496,Out > In
Feb 2020,180,205,1,6369,214950,221319,1,1,1,208581,In > Out
Feb 2020,181,116,4,28699781,775053,29474834,1,4,4,27924728,Out > In
Feb 2020,181,122,9,587925012,503639102,1091564114,7,9,9,84285910,Out > In
Feb 2020,181,126,1,8460,330385,338845,1,1,1,321925,In > Out
Feb 2020,181,162,6,219537502,566700272,786237774,4,5,6,347162770,In > Out
Feb 2020,181,164,1,131276983,390729497,522006480,1,1,1,259452514,In > Out
Feb 2020,181,168,239,14324332024,288948149,14613280173,19,229,4,14035383875,Out > In
Feb 2020,181,175,2,437135,233170,670305,2,2,1,203965,Out > In
Feb 2020,181,182,10,905109,616973,1522082,6,9,4,288136,Out > In
Feb 2020,181,205,172364,174965723260,6311580062,181277303322,4364,53767,1,168654143198,Out > In
Feb 2020,181,212,2,180399,29781,210180,2,2,2,150618,Out > In
Feb 2020,181,244,24,2770012,1468922,4238934,5,19,4,1301090,Out > In
Feb 2020,181,246,167232,169621705902,6000457077,175622162979,2483,53789,1,163621248825,Out > In
Feb 2020,181,248,11,19844073,72052241,91896314,4,11,11,52208168,In > Out
Feb 2020,181,64,109,15402943,9530144,24933087,26,31,2,5872799,Out > In
Feb 2020,183,119,144,209309135,4098925,213408060,54,143,2,205210210,Out > In
Feb 2020,183,17,513,223644881,11370438,235015319,37,510,1,212274443,Out > In
Feb 2020,183,86,52,17535844,65242396,82778240,1,1,2,47706552,In > Out
Feb 2020,183,89,11,1792568,9428312,11220880,1,1,1,7635744,In > Out
Feb 2020,183,94,3,403839,1996594,2400433,1,2,2,1592755,In > Out
Feb 2020,184,134,122,53083591,34489564,87573155,65,122,2,18594027,Out > In
Feb 2020,184,135,5,4811277,1758865,6570142,3,5,1,3052412,Out > In
Feb 2020,184,136,86,43845146,44760059,88605205,6,4,63,914913,In > Out
Feb 2020,184,181,1,228171,5705,233876,1,1,1,222466,Out > In
Feb 2020,184,203,13,6483502,84930444,91413946,5,3,13,78446942,In > Out
Feb 2020,184,216,1,3377674,167427,3545101,1,1,1,3210247,Out > In
Feb 2020,184,218,27,128675900,9956336,138632236,4,27,1,118719564,Out > In
Feb 2020,184,219,4,736546,1340046,2076592,2,2,3,603500,In > Out
Feb 2020,184,220,57,769590096,2498389250,3267979346,12,10,47,1728799154,In > Out
Feb 2020,184,246,1,562028,202531,764559,1,1,1,359497,Out > In
Feb 2020,19,106,1,59800,107769,167569,1,1,1,47969,In > Out
Feb 2020,19,108,1,356846,608047,964893,1,1,1,251201,In > Out
Feb 2020,19,12,1,41043,70815,111858,1,1,1,29772,In > Out
Feb 2020,19,121,2,487740,770093,1257833,2,2,1,282353,In > Out
Feb 2020,19,13,2,56682,613168,669850,2,2,1,556486,In > Out
Feb 2020,19,140,1,196336,313594,509930,1,1,1,117258,In > Out
Feb 2020,19,141,3359,17241967162,22337766229,39579733391,114,3106,2,5095799067,In > Out
Feb 2020,19,142,2,120065,228604,348669,2,2,1,108539,In > Out
Feb 2020,19,143,458,13862337,535867827,549730164,27,449,2,522005490,In > Out
Feb 2020,19,150,39468,16867906350,1172181367,18040087717,14268,21927,2,15695724983,Out > In
Feb 2020,19,152,3497,576741206,150989535,727730741,675,2942,2,425751671,Out > In
Feb 2020,19,155,5,253139,697387,950526,3,5,1,444248,In > Out
Feb 2020,19,160,159,82312073,3187453,85499526,122,159,2,79124620,Out > In
Feb 2020,19,165,70,22862852,1489188,24352040,58,70,2,21373664,Out > In
Feb 2020,19,167,4,596842,60565,657407,4,4,1,536277,Out > In
Feb 2020,19,27,2,1471482,2181754,3653236,2,2,1,710272,In > Out
Feb 2020,19,87,1,1319790,2252102,3571892,1,1,1,932312,In > Out
Feb 2020,190,125,3,3625478,291134,3916612,2,3,1,3334344,Out > In
Feb 2020,190,128,389,72779817,3164494,75944311,52,386,1,69615323,Out > In
Feb 2020,190,135,2,180631,87507,268138,1,2,1,93124,Out > In
Feb 2020,190,140,32,12957605,404678,13362283,9,32,1,12552927,Out > In
Feb 2020,190,158,2,205396,106422,311818,1,2,1,98974,Out > In
Feb 2020,190,164,2,373440,116167,489607,1,2,1,257273,Out > In
Feb 2020,190,165,3,298245,183365,481610,2,3,2,114880,Out > In
Feb 2020,190,173,1,111796,6551,118347,1,1,1,105245,Out > In
Feb 2020,190,188,1422,2296595554,118637089,2415232643,24,1396,1,2177958465,Out > In
Feb 2020,190,199,45994,26210031715,927437023,27137468738,13810,30694,2,25282594692,Out > In
Feb 2020,190,217,7,844446,34814,879260,1,7,1,809632,Out > In
Feb 2020,190,219,1,143322,4764,148086,1,1,1,138558,Out > In
Feb 2020,190,223,1,47211,184364,231575,1,1,1,137153,In > Out
Feb 2020,190,37,41,150219966,275345652,425565618,17,41,2,125125686,In > Out
Feb 2020,190,38,1,50207,156827,207034,1,1,1,106620,In > Out
Feb 2020,190,39,6,45384956,1072383,46457339,4,6,2,44312573,Out > In
Feb 2020,190,43,1536,411321793,11688584,423010377,1096,1499,1,399633209,Out > In
Feb 2020,190,44,8583,1643078337,52012424,1695090761,1570,7584,2,1591065913,Out > In
Feb 2020,190,46,9,556746070,12641971,569388041,4,9,1,544104099,Out > In
Feb 2020,190,48,7186,212670430,5281683658,5494354088,5,6024,5,5069013228,In > Out
Feb 2020,190,91,60,24398235,474804,24873039,48,60,2,23923431,Out > In
Feb 2020,191,10,5,121668305,3630372,125298677,1,5,5,118037933,Out > In
Feb 2020,191,12,19,10393389,18411165,28804554,10,1,19,8017776,In > Out
Feb 2020,191,51,1,90114,111567,201681,1,1,1,21453,In > Out
Feb 2020,191,59,1,254984,22896,277880,1,1,1,232088,Out > In
Feb 2020,192,40,2,91451,2248199,2339650,1,1,2,2156748,In > Out
Feb 2020,195,100,1,812934,1073123,1886057,1,1,1,260189,In > Out
Feb 2020,195,104,5,1102917176,1063206211,2166123387,3,5,5,39710965,Out > In
Feb 2020,195,105,1,53672,4362141,4415813,1,1,1,4308469,In > Out
Feb 2020,195,109,4,368685538,611835346,980520884,3,4,4,243149808,In > Out
Feb 2020,195,11,17,183519,4978736,5162255,17,15,2,4795217,In > Out
Feb 2020,195,110,1,179248,66842,246090,1,1,1,112406,Out > In
Feb 2020,195,115,1,195775870,204606332,400382202,1,1,1,8830462,In > Out
Feb 2020,195,116,2,63234834,74388080,137622914,2,2,2,11153246,In > Out
Feb 2020,195,117,1,59944,216559,276503,1,1,1,156615,In > Out
Feb 2020,195,12,4,98440380,101203439,199643819,3,4,4,2763059,In > Out
Feb 2020,195,120,2,6377992,3777786,10155778,1,2,2,2600206,Out > In
Feb 2020,195,128,5,164597,5295830,5460427,5,5,1,5131233,In > Out
Feb 2020,195,129,8,49940950,134163607,184104557,4,4,4,84222657,In > Out
Feb 2020,195,13,1,2401836,2792935,5194771,1,1,1,391099,In > Out
Feb 2020,195,134,2,212930426,269388380,482318806,2,2,2,56457954,In > Out
Feb 2020,195,135,1,72041164,31634672,103675836,1,1,1,40406492,Out > In
Feb 2020,195,139,4,8658558,26218852,34877410,3,4,4,17560294,In > Out
Feb 2020,195,140,5,18044428,64429312,82473740,5,5,5,46384884,In > Out
Feb 2020,195,141,7,121000,2083305,2204305,7,7,2,1962305,In > Out
Feb 2020,195,142,13,4300544,16104533,20405077,9,6,13,11803989,In > Out
Feb 2020,195,144,2,6817735,7949096,14766831,1,2,2,1131361,In > Out
Feb 2020,195,149,7,82256,8706692,8788948,7,7,1,8624436,In > Out
Feb 2020,195,15,2,35978908,39708068,75686976,2,2,2,3729160,In > Out
Feb 2020,195,150,1,130060,278539,408599,1,1,1,148479,In > Out
Feb 2020,195,152,2,1866179,2670602,4536781,2,2,2,804423,In > Out
Feb 2020,195,155,2,33278394,44953182,78231576,2,2,2,11674788,In > Out
Feb 2020,195,156,1,29340,200578,229918,1,1,1,171238,In > Out
Feb 2020,195,157,34,6102075,8930520,15032595,34,5,1,2828445,In > Out
Feb 2020,195,158,1,157531479,910807307,1068338786,1,1,1,753275828,In > Out
Feb 2020,195,163,1,91638216,86242378,177880594,1,1,1,5395838,Out > In
Feb 2020,195,164,2,809618,111042,920660,2,2,1,698576,Out > In
Feb 2020,195,166,180,7129036,136481358,143610394,85,88,1,129352322,In > Out
Feb 2020,195,167,3,109361018,98880499,208241517,2,3,3,10480519,Out > In
Feb 2020,195,168,5,218968520,199446022,418414542,4,5,4,19522498,Out > In
Feb 2020,195,17,3,2266260,2695245,4961505,1,3,1,428985,In > Out
Feb 2020,195,170,2,6307748,6590323,12898071,2,2,1,282575,In > Out
Feb 2020,195,173,55,147832163,227206526,375038689,30,55,2,79374363,In > Out
Feb 2020,195,175,7,58822,1482577,1541399,7,7,2,1423755,In > Out
Feb 2020,195,176,2,321464353,401314949,722779302,2,2,1,79850596,In > Out
Feb 2020,195,179,3,68579309,83494553,152073862,1,3,3,14915244,In > Out
Feb 2020,195,18,2,31893375,21228498,53121873,2,2,1,10664877,Out > In
Feb 2020,195,182,3,10270335,5130745,15401080,2,3,1,5139590,Out > In
Feb 2020,195,186,1,7230,170259,177489,1,1,1,163029,In > Out
Feb 2020,195,187,2,153745088,229591767,383336855,1,2,2,75846679,In > Out
Feb 2020,195,190,2,211067062,583924550,794991612,2,2,2,372857488,In > Out
Feb 2020,195,191,1,42053,121972,164025,1,1,1,79919,In > Out
Feb 2020,195,193,14,189391827,46293889,235685716,13,14,4,143097938,Out > In
Feb 2020,195,197,10,37935170,16944452,54879622,4,10,6,20990718,Out > In
Feb 2020,195,198,6,463305449,222789365,686094814,5,5,5,240516084,Out > In
Feb 2020,195,20,2,1867707,3272937,5140644,2,2,2,1405230,In > Out
Feb 2020,195,200,3,74651095,118179728,192830823,2,2,1,43528633,In > Out
Feb 2020,195,203,1,748699,390640,1139339,1,1,1,358059,Out > In
Feb 2020,195,204,1,23368,279452,302820,1,1,1,256084,In > Out
Feb 2020,195,205,2,3625846,3666063,7291909,1,2,2,40217,In > Out
Feb 2020,195,206,2,445856,6015652,6461508,2,2,1,5569796,In > Out
Feb 2020,195,207,2,544088067,532809077,1076897144,2,2,1,11278990,Out > In
Feb 2020,195,208,1,242570,597575,840145,1,1,1,355005,In > Out
Feb 2020,195,210,3,7230494,9408244,16638738,2,3,3,2177750,In > Out
Feb 2020,195,213,1,1348233316,1342223503,2690456819,1,1,1,6009813,Out > In
Feb 2020,195,214,3,1792882,2423900,4216782,2,3,3,631018,In > Out
Feb 2020,195,215,1,23084906,23537326,46622232,1,1,1,452420,In > Out
Feb 2020,195,216,2,20588832,117385725,137974557,2,2,2,96796893,In > Out
Feb 2020,195,218,16,219958333,47948455,267906788,8,12,13,172009878,Out > In
Feb 2020,195,219,8,5979415,4215616,10195031,8,8,3,1763799,Out > In
Feb 2020,195,221,1,15975,518035,534010,1,1,1,502060,In > Out
Feb 2020,195,23,3,10350132,9129969,19480101,2,3,3,1220163,Out > In
Feb 2020,195,24,1,58018868,98844799,156863667,1,1,1,40825931,In > Out
Feb 2020,195,25,1,40436,128560,168996,1,1,1,88124,In > Out
Feb 2020,195,29,4,14858953,13071966,27930919,3,4,4,1786987,Out > In
Feb 2020,195,31,1,138185149,105042134,243227283,1,1,1,33143015,Out > In
Feb 2020,195,32,1,4528362,3894963,8423325,1,1,1,633399,Out > In
Feb 2020,195,38,2,72597,315081,387678,2,2,2,242484,In > Out
Feb 2020,195,39,3,1173790,1114129,2287919,2,2,3,59661,Out > In
Feb 2020,195,41,11,236641,5310264,5546905,10,7,8,5073623,In > Out
Feb 2020,195,42,1,27007,1117243,1144250,1,1,1,1090236,In > Out
Feb 2020,195,43,10,1951705893,82920300,2034626193,9,9,5,1868785593,Out > In
Feb 2020,195,45,1,8732005,14388739,23120744,1,1,1,5656734,In > Out
Feb 2020,195,46,2,1540839,3121528,4662367,2,2,2,1580689,In > Out
Feb 2020,195,47,5,148586960,167321369,315908329,4,5,2,18734409,In > Out
Feb 2020,195,49,1,127351,400983,528334,1,1,1,273632,In > Out
Feb 2020,195,52,14,351145,9262210,9613355,14,14,1,8911065,In > Out
Feb 2020,195,56,2,474410,35287130,35761540,1,1,2,34812720,In > Out
Feb 2020,195,60,1,9789664,126090252,135879916,1,1,1,116300588,In > Out
Feb 2020,195,63,1,18738378,29218323,47956701,1,1,1,10479945,In > Out
Feb 2020,195,64,2,107473,498902,606375,1,1,1,391429,In > Out
Feb 2020,195,69,2,1193080,80453843,81646923,1,1,2,79260763,In > Out
Feb 2020,195,7,2,1840,649538,651378,1,1,2,647698,In > Out
Feb 2020,195,70,1,32262879,10822648,43085527,1,1,1,21440231,Out > In
Feb 2020,195,72,2,225672,760390,986062,2,2,2,534718,In > Out
Feb 2020,195,73,1,280710,138449,419159,1,1,1,142261,Out > In
Feb 2020,195,74,2,739880,415873,1155753,2,2,2,324007,Out > In
Feb 2020,195,76,1,3019401,10300855,13320256,1,1,1,7281454,In > Out
Feb 2020,195,78,7,5180895,4636098,9816993,3,7,3,544797,Out > In
Feb 2020,195,79,2,4445792,3015480,7461272,2,2,2,1430312,Out > In
Feb 2020,195,83,1,5495840,21702231,27198071,1,1,1,16206391,In > Out
Feb 2020,195,87,3,3541179714,1343346462,4884526176,3,3,3,2197833252,Out > In
Feb 2020,195,88,56,35479369,51890747,87370116,54,15,7,16411378,In > Out
Feb 2020,195,89,4,40809239,94232901,135042140,4,4,4,53423662,In > Out
Feb 2020,195,9,2,1012659,10055283,11067942,2,2,2,9042624,In > Out
Feb 2020,195,90,5,15730191,179068123,194798314,4,5,5,163337932,In > Out
Feb 2020,195,92,9,17495406,1550673717,1568169123,1,1,3,1533178311,In > Out
Feb 2020,195,93,1,1003040,1228900,2231940,1,1,1,225860,In > Out
Feb 2020,195,96,2,75274813,84885411,160160224,2,1,2,9610598,In > Out
Feb 2020,195,99,8,13016975,12147520,25164495,2,7,4,869455,Out > In
Feb 2020,196,110,1,52006,72325,124331,1,1,1,20319,In > Out
Feb 2020,196,113,1,100897,7201,108098,1,1,1,93696,Out > In
Feb 2020,196,124,1,89637,121013,210650,1,1,1,31376,In > Out
Feb 2020,196,126,1,81643,102292,183935,1,1,1,20649,In > Out
Feb 2020,196,141,1,4664,109470,114134,1,1,1,104806,In > Out
Feb 2020,196,144,2,10072,238527,248599,1,2,1,228455,In > Out
Feb 2020,196,150,3,14028,325899,339927,1,3,1,311871,In > Out
Feb 2020,196,159,5,24940,584871,609811,1,5,1,559931,In > Out
Feb 2020,196,169,5,31104,741552,772656,1,5,1,710448,In > Out
Feb 2020,196,171,2,148046,87185,235231,2,2,2,60861,Out > In
Feb 2020,196,181,3,14348,335479,349827,1,3,1,321131,In > Out
Feb 2020,196,182,1,4236,98748,102984,1,1,1,94512,In > Out
Feb 2020,196,184,1,5652,125860,131512,1,1,1,120208,In > Out
Feb 2020,196,186,2,117015,187135,304150,2,2,1,70120,In > Out
Feb 2020,196,194,1,5104,114088,119192,1,1,1,108984,In > Out
Feb 2020,196,203,2,153777,200149,353926,2,2,1,46372,In > Out
Feb 2020,196,217,1,7916,188295,196211,1,1,1,180379,In > Out
Feb 2020,196,226,3,13948,331474,345422,1,3,1,317526,In > Out
Feb 2020,196,228,3,13748,321103,334851,1,3,1,307355,In > Out
Feb 2020,196,23,1,43953,71081,115034,1,1,1,27128,In > Out
Feb 2020,196,24,4,27007508,9514472,36521980,2,4,1,17493036,Out > In
Feb 2020,196,240,2,13632,317759,331391,1,2,1,304127,In > Out
Feb 2020,196,249,3,18776,445385,464161,1,3,1,426609,In > Out
Feb 2020,196,25,2,152815,212518,365333,2,2,1,59703,In > Out
Feb 2020,196,28,1,49093,69375,118468,1,1,1,20282,In > Out
Feb 2020,196,48,1,110214,7496,117710,1,1,1,102718,Out > In
Feb 2020,196,55,4,18720,448534,467254,1,4,1,429814,In > Out
Feb 2020,196,56,1,4356,101727,106083,1,1,1,97371,In > Out
Feb 2020,196,63,1,74372,102270,176642,1,1,1,27898,In > Out
Feb 2020,196,76,1,4916,115939,120855,1,1,1,111023,In > Out
Feb 2020,196,78,2,126234,204257,330491,2,2,1,78023,In > Out
Feb 2020,196,85,2,212269,11661,223930,2,2,1,200608,Out > In
Feb 2020,196,92,3,22108,527606,549714,1,3,1,505498,In > Out
Feb 2020,196,94,1,52332,111540,163872,1,1,1,59208,In > Out
Feb 2020,196,95,3,325835,23689,349524,2,3,1,302146,Out > In
Feb 2020,196,99,2,10752,258261,269013,1,2,1,247509,In > Out
Feb 2020,197,101,1,2448,2030362,2032810,1,1,1,2027914,In > Out
Feb 2020,197,102,2,416773,1247695,1664468,1,1,1,830922,In > Out
Feb 2020,197,108,1,27435,176745,204180,1,1,1,149310,In > Out
Feb 2020,197,110,1,1481491,6112839,7594330,1,1,1,4631348,In > Out
Feb 2020,197,115,20,6644498,51421092,58065590,1,1,2,44776594,In > Out
Feb 2020,197,118,1,849701,888332,1738033,1,1,1,38631,In > Out
Feb 2020,197,12,1,20891,270847,291738,1,1,1,249956,In > Out
Feb 2020,197,122,1,239068,1277408,1516476,1,1,1,1038340,In > Out
Feb 2020,197,124,3,26081657,25842773,51924430,2,3,3,238884,Out > In
Feb 2020,197,126,2,260855330,143328577,404183907,2,2,2,117526753,Out > In
Feb 2020,197,131,1,8312300,66246855,74559155,1,1,1,57934555,In > Out
Feb 2020,197,138,2,538105,5769275,6307380,2,2,2,5231170,In > Out
Feb 2020,197,139,1,230820,200797,431617,1,1,1,30023,Out > In
Feb 2020,197,142,1,425961,918803,1344764,1,1,1,492842,In > Out
Feb 2020,197,143,1,42237349,46370832,88608181,1,1,1,4133483,In > Out
Feb 2020,197,151,1,32836,241560,274396,1,1,1,208724,In > Out
Feb 2020,197,154,5,1507382331,1650878575,3158260906,4,5,4,143496244,In > Out
Feb 2020,197,156,1,30576,84516,115092,1,1,1,53940,In > Out
Feb 2020,197,165,1,45643282,75648799,121292081,1,1,1,30005517,In > Out
Feb 2020,197,17,2,9309791,8762195,18071986,2,1,2,547596,Out > In
Feb 2020,197,170,1,81240,539398,620638,1,1,1,458158,In > Out
Feb 2020,197,171,6,46521267,47755882,94277149,6,6,4,1234615,In > Out
Feb 2020,197,172,2,69984,16569560,16639544,2,2,1,16499576,In > Out
Feb 2020,197,174,3,2672847,27805249,30478096,3,3,1,25132402,In > Out
Feb 2020,197,177,3,2035330,3110678,5146008,3,3,2,1075348,In > Out
Feb 2020,197,178,1,437292691,395634056,832926747,1,1,1,41658635,Out > In
Feb 2020,197,181,1,2210279,3168523,5378802,1,1,1,958244,In > Out
Feb 2020,197,182,1,116713916,61973637,178687553,1,1,1,54740279,Out > In
Feb 2020,197,183,1,16693168,339311932,356005100,1,1,1,322618764,In > Out
Feb 2020,197,184,1,7065304,11355426,18420730,1,1,1,4290122,In > Out
Feb 2020,197,185,1,5213234,9660930,14874164,1,1,1,4447696,In > Out
Feb 2020,197,188,3,23571121,19955419,43526540,3,3,3,3615702,Out > In
Feb 2020,197,191,1,6960,451932,458892,1,1,1,444972,In > Out
Feb 2020,197,194,2,42303445,78297311,120600756,1,2,2,35993866,In > Out
Feb 2020,197,195,11,2637204,6129716,8766920,4,8,11,3492512,In > Out
Feb 2020,197,202,2,1112325355,1303152107,2415477462,2,1,1,190826752,In > Out
Feb 2020,197,203,4,579829,228056,807885,2,4,2,351773,Out > In
Feb 2020,197,206,2,2480521,2550727,5031248,1,2,2,70206,In > Out
Feb 2020,197,207,3,29508543,38010888,67519431,2,3,3,8502345,In > Out
Feb 2020,197,210,1,28768,83120,111888,1,1,1,54352,In > Out
Feb 2020,197,211,1,110109,70560,180669,1,1,1,39549,Out > In
Feb 2020,197,215,1,23003,191322,214325,1,1,1,168319,In > Out
Feb 2020,197,218,1,90212,2619241,2709453,1,1,1,2529029,In > Out
Feb 2020,197,22,2,5533501,1489509,7023010,1,1,2,4043992,Out > In
Feb 2020,197,221,2,3667192,47382486,51049678,2,2,2,43715294,In > Out
Feb 2020,197,222,1,40315,6250708,6291023,1,1,1,6210393,In > Out
Feb 2020,197,25,1,183299,242373,425672,1,1,1,59074,In > Out
Feb 2020,197,32,3,39860314,75653511,115513825,2,2,1,35793197,In > Out
Feb 2020,197,39,3,2422532,1848071,4270603,2,3,1,574461,Out > In
Feb 2020,197,40,3,22024559,40249081,62273640,2,2,3,18224522,In > Out
Feb 2020,197,45,1,28598,403390,431988,1,1,1,374792,In > Out
Feb 2020,197,5,1,42715094,62030660,104745754,1,1,1,19315566,In > Out
Feb 2020,197,51,2,265877,1050841,1316718,2,2,2,784964,In > Out
Feb 2020,197,54,1,302680,47868,350548,1,1,1,254812,Out > In
Feb 2020,197,58,1,10213988,71522048,81736036,1,1,1,61308060,In > Out
Feb 2020,197,61,3,1120336553,1173672441,2294008994,3,3,3,53335888,In > Out
Feb 2020,197,64,4,194138892,205381968,399520860,4,4,3,11243076,In > Out
Feb 2020,197,68,1,38539697,47559727,86099424,1,1,1,9020030,In > Out
Feb 2020,197,74,1,886591,895099,1781690,1,1,1,8508,In > Out
Feb 2020,197,75,2,33278466,148874373,182152839,2,2,2,115595907,In > Out
Feb 2020,197,78,28,1550604,84085583,85636187,22,12,1,82534979,In > Out
Feb 2020,197,81,1,106446,3364070,3470516,1,1,1,3257624,In > Out
Feb 2020,197,85,1,64001,11747183,11811184,1,1,1,11683182,In > Out
Feb 2020,197,95,12,49841877,24468589,74310466,2,12,3,25373288,Out > In
Feb 2020,197,99,1,6282828,4466160,10748988,1,1,1,1816668,Out > In
Feb 2020,198,22,495,2222345900,133589351,2355935251,139,184,9,2088756549,Out > In
Feb 2020,2,1,10,713084,807625,1520709,5,6,2,94541,In > Out
Feb 2020,2,100,3,3735917,5657295,9393212,3,3,1,1921378,In > Out
Feb 2020,2,11,1,4556,104085,108641,1,1,1,99529,In > Out
Feb 2020,2,12,3787,4644748731,559764775,5204513506,42,3600,3,4084983956,Out > In
Feb 2020,2,14,13,4601749,716522,5318271,6,13,2,3885227,Out > In
Feb 2020,2,15,58,13865018,15545403,29410421,2,58,58,1680385,In > Out
Feb 2020,2,17,21594,35284450323,535282795,35819733118,5263,17153,2,34749167528,Out > In
Feb 2020,2,19,33461,259480067576,2514983260,261995050836,7724,22289,2,256965084316,Out > In
Feb 2020,2,20,2,11272,263076,274348,1,2,1,251804,In > Out
Feb 2020,2,21,23237,27890001302,551214283,28441215585,4620,18464,6,27338787019,Out > In
Feb 2020,2,22,2,284244,17430,301674,2,2,1,266814,Out > In
Feb 2020,2,23,5,540109,101963,642072,2,5,2,438146,Out > In
Feb 2020,2,24,24,32112934,642291,32755225,10,24,2,31470643,Out > In
Feb 2020,2,244,1371,380487672,246792331,627280003,12,1351,1,133695341,Out > In
Feb 2020,2,25,9,1240880,190368,1431248,4,9,3,1050512,Out > In
Feb 2020,2,26,8,1064205,56723,1120928,3,8,1,1007482,Out > In
Feb 2020,2,27,9,1152156,241287,1393443,4,9,2,910869,Out > In
Feb 2020,2,29,20,3510598,383219,3893817,14,20,2,3127379,Out > In
Feb 2020,2,30,4973,7834889199,148092942,7982982141,1561,4684,3,7686796257,Out > In
Feb 2020,2,31,1,67292,50617,117909,1,1,1,16675,Out > In
Feb 2020,2,32,6,812652,30458,843110,2,6,1,782194,Out > In
Feb 2020,2,33,13,805793,986398,1792191,4,13,3,180605,In > Out
Feb 2020,2,35,12,867295,866422,1733717,3,12,3,873,Out > In
Feb 2020,2,36,5,111897,523292,635189,2,5,2,411395,In > Out
Feb 2020,2,37,6,747034,44906,791940,3,6,2,702128,Out > In
Feb 2020,2,38,117,72266781,1281420,73548201,33,117,3,70985361,Out > In
Feb 2020,2,39,2,257061,9645,266706,1,2,1,247416,Out > In
Feb 2020,2,4,17,1496972,1451372,2948344,1,1,1,45600,Out > In
Feb 2020,2,83,3,18068,428900,446968,1,3,1,410832,In > Out
Feb 2020,2,85,240,159531744,8056366,167588110,89,240,1,151475378,Out > In
Feb 2020,2,91,4550,11362046960,16354547907,27716594867,195,3569,38,4992500947,In > Out
Feb 2020,200,199,27845,68133421647,1485534328,69618955975,8492,20261,2,66647887319,Out > In
Feb 2020,200,20,4,879712,290056,1169768,2,4,1,589656,Out > In
Feb 2020,200,200,10,1576730,298381,1875111,8,10,2,1278349,Out > In
Feb 2020,200,202,19,11989306,769053,12758359,12,19,1,11220253,Out > In
Feb 2020,200,204,388,107062423,4257382,111319805,36,387,2,102805041,Out > In
Feb 2020,200,205,527,395479293,11215063,406694356,38,525,2,384264230,Out > In
Feb 2020,200,206,2,184846,50134,234980,2,2,2,134712,Out > In
Feb 2020,200,21,20,23326528,576179,23902707,12,20,2,22750349,Out > In
Feb 2020,200,210,35435,15979706217,676839700,16656545917,8265,19297,2,15302866517,Out > In
Feb 2020,200,211,29,6031570,485074,6516644,13,29,1,5546496,Out > In
Feb 2020,200,22,4,602209,244163,846372,2,4,1,358046,Out > In
Feb 2020,200,24,58,229566556,3171788,232738344,16,58,2,226394768,Out > In
Feb 2020,200,26,2240,19011528452,221421219,19232949671,388,2167,2,18790107233,Out > In
Feb 2020,200,27,2416,788440350,27287675,815728025,779,2347,2,761152675,Out > In
Feb 2020,200,28,47,21942687,895156,22837843,35,46,2,21047531,Out > In
Feb 2020,200,29,180,181713802,4066320,185780122,76,180,2,177647482,Out > In
Feb 2020,200,30,1225,1316105846,32971914,1349077760,317,1206,2,1283133932,Out > In
Feb 2020,200,33,61,11765338,1211209,12976547,49,61,2,10554129,Out > In
Feb 2020,200,34,64,15576537,797088,16373625,43,63,1,14779449,Out > In
Feb 2020,200,35,117,3107771980,48759836,3156531816,19,117,2,3059012144,Out > In
Feb 2020,200,36,30,5013001,425522,5438523,21,30,2,4587479,Out > In
Feb 2020,200,38,370,60327288,2330582,62657870,24,368,2,57996706,Out > In
Feb 2020,200,40,1,102991,62863,165854,1,1,1,40128,Out > In
Feb 2020,200,45,1479,2020038839,50380896,2070419735,111,1450,2,1969657943,Out > In
Feb 2020,200,46,489,348611813,35230971,383842784,31,484,1,313380842,Out > In
Feb 2020,200,48,18,2498839,912857,3411696,2,18,1,1585982,Out > In
Feb 2020,200,53,2152,3634208713,82576592,3716785305,829,2085,2,3551632121,Out > In
Feb 2020,200,55,86,21555661,1403342,22959003,39,86,2,20152319,Out > In
Feb 2020,200,60,23,10228251,325510,10553761,16,23,1,9902741,Out > In
Feb 2020,200,61,16,6379380,342535,6721915,9,16,1,6036845,Out > In
Feb 2020,200,65,132,31716033,7401419,39117452,39,132,2,24314614,Out > In
Feb 2020,200,90,2,432746,170368,603114,1,2,1,262378,Out > In
Feb 2020,202,114,3,507893,8582,516475,2,3,1,499311,Out > In
Feb 2020,202,251,1,74261,120522,194783,1,1,1,46261,In > Out
Feb 2020,202,254,3,489633,207054,696687,2,3,1,282579,Out > In
Feb 2020,203,82,3,63413,919840,983253,1,1,3,856427,In > Out
Feb 2020,204,105,79,257630573,816531072,1074161645,74,33,16,558900499,In > Out
Feb 2020,204,14,2,9032,210824,219856,1,2,1,201792,In > Out
Feb 2020,204,16,2,11712,261798,273510,1,2,1,250086,In > Out
Feb 2020,204,173,125,22132290,13682494,35814784,13,13,1,8449796,Out > In
Feb 2020,204,181,1,151470,106560,258030,1,1,1,44910,Out > In
Feb 2020,204,205,14,11138763,20677144,31815907,13,13,11,9538381,In > Out
Feb 2020,204,21,3,16428,378760,395188,1,3,1,362332,In > Out
Feb 2020,204,216,2,41083,211624,252707,2,2,2,170541,In > Out
Feb 2020,204,29,3,14108,327018,341126,1,3,1,312910,In > Out
Feb 2020,204,46,4,24584,572467,597051,1,4,1,547883,In > Out
Feb 2020,204,68,4,21984,502875,524859,1,4,1,480891,In > Out
Feb 2020,204,71,1,118608,298294,416902,1,1,1,179686,In > Out
Feb 2020,204,79,3,11552,330841,342393,1,3,1,319289,In > Out
Feb 2020,204,80,2,10832,245267,256099,1,2,1,234435,In > Out
Feb 2020,204,83,1,153120,104784,257904,1,1,1,48336,Out > In
Feb 2020,204,86,6,33496,774433,807929,1,6,1,740937,In > Out
Feb 2020,204,92,1,4132,113425,117557,1,1,1,109293,In > Out
Feb 2020,206,122,1,650964,500,651464,1,1,1,650464,Out > In
Feb 2020,206,200,37,3740880,1474341,5215221,15,37,1,2266539,Out > In
Feb 2020,206,33,127,29607630,54193392,83801022,92,71,1,24585762,In > Out
Feb 2020,206,7,453,369347908,55917201,425265109,159,393,3,313430707,Out > In
Feb 2020,207,127,1204,488525138,86196153,574721291,137,1032,1,402328985,Out > In
Feb 2020,208,113,39984,33284055483,581290336,33865345819,11002,27521,2,32702765147,Out > In
Feb 2020,208,114,1920,13018675698,95017230,13113692928,733,1893,1,12923658468,Out > In
Feb 2020,208,115,45221,22255295711,1556934345,23812230056,309,19201,2,20698361366,Out > In
Feb 2020,208,116,2,236968,126648,363616,1,2,1,110320,Out > In
Feb 2020,208,117,1,103229,19863,123092,1,1,1,83366,Out > In
Feb 2020,208,119,10,537942,2387380,2925322,1,10,1,1849438,In > Out
Feb 2020,208,125,42002,51853864675,1123550975,52977415650,10969,26398,2,50730313700,Out > In
Feb 2020,208,126,16,5131205,276797,5408002,11,16,2,4854408,Out > In
Feb 2020,208,127,388,146094318,4515373,150609691,157,386,2,141578945,Out > In
Feb 2020,208,128,33060,15863437784,326828021,16190265805,8262,23542,1,15536609763,Out > In
Feb 2020,208,195,1820,297438800,8304720,305743520,125,1331,2,289134080,Out > In
Feb 2020,208,29,1,263379,11041,274420,1,1,1,252338,Out > In
Feb 2020,208,39,130,29358032,780728,30138760,58,130,1,28577304,Out > In
Feb 2020,208,40,1,140207,4284,144491,1,1,1,135923,Out > In
Feb 2020,208,44,8403,72987645518,847144492,73834790010,469,6824,2,72140501026,Out > In
Feb 2020,208,45,29724,29376195972,446807091,29823003063,2217,17347,2,28929388881,Out > In
Feb 2020,208,47,5,640071,91566,731637,5,5,1,548505,Out > In
Feb 2020,208,49,106,63489842,2734170,66224012,31,106,1,60755672,Out > In
Feb 2020,208,50,441,146034706,13723194,159757900,230,434,2,132311512,Out > In
Feb 2020,208,52,2513,798110249,27805267,825915516,322,2420,3,770304982,Out > In
Feb 2020,208,53,421,74177139,2123672,76300811,54,418,2,72053467,Out > In
Feb 2020,208,56,24,5966843,142670,6109513,19,24,1,5824173,Out > In
Feb 2020,208,59,152,46542230,8410083,54952313,24,151,1,38132147,Out > In
Feb 2020,208,81,14,7701381,85459,7786840,7,14,2,7615922,Out > In
Feb 2020,208,83,3413,753371291,155285737,908657028,490,3263,1,598085554,Out > In
Feb 2020,208,85,4,80425500,10139132,90564632,1,4,1,70286368,Out > In
Feb 2020,208,86,4,780475,26077,806552,1,4,1,754398,Out > In
Feb 2020,208,87,1842,376059829,13531931,389591760,646,1797,2,362527898,Out > In
Feb 2020,208,88,9,1634481,46022,1680503,7,9,1,1588459,Out > In
Feb 2020,208,90,5,10646909,331757,10978666,1,5,1,10315152,Out > In
Feb 2020,208,92,75,37374269,1273026,38647295,23,75,2,36101243,Out > In
Feb 2020,208,93,29,16200046,660170,16860216,15,29,2,15539876,Out > In
Feb 2020,208,96,22846,31806966385,569034598,32376000983,11483,17251,1,31237931787,Out > In
Feb 2020,209,100,8,215558782,4080241,219639023,4,8,1,211478541,Out > In
Feb 2020,209,19,1,165344,103228,268572,1,1,1,62116,Out > In
Feb 2020,209,202,3,279595,167684,447279,2,3,1,111911,Out > In
Feb 2020,209,203,3,343799,146358,490157,2,3,1,197441,Out > In
Feb 2020,209,204,2,320493,190387,510880,1,2,1,130106,Out > In
Feb 2020,209,214,5,172474,578005,750479,1,5,1,405531,In > Out
Feb 2020,212,21,42,13648831,986143,14634974,18,42,1,12662688,Out > In
Feb 2020,212,24,1,38276,67011,105287,1,1,1,28735,In > Out
Feb 2020,212,25,1046,804925886,31425429,836351315,106,1003,1,773500457,Out > In
Feb 2020,212,26,3196,8999387832,133753438,9133141270,1300,3063,1,8865634394,Out > In
Feb 2020,212,27,524,555750624,8709626,564460250,250,521,1,547040998,Out > In
Feb 2020,212,31,3487,25210377998,2090538779,27300916777,587,3190,3,23119839219,Out > In
Feb 2020,213,1,239,3846696283,4268405317,8115101600,181,143,158,421709034,In > Out
Feb 2020,213,10,374,3540389773,4222038102,7762427875,313,265,258,681648329,In > Out
Feb 2020,213,100,314,3038961575,3898870760,6937832335,272,108,138,859909185,In > Out
Feb 2020,213,101,511,7844998432,6764659534,14609657966,418,316,304,1080338898,Out > In
Feb 2020,213,102,456,6807570767,8469782220,15277352987,369,345,369,1662211453,In > Out
Feb 2020,213,103,204,1648295638,2520673584,4168969222,168,136,142,872377946,In > Out
Feb 2020,213,104,934,7217278531,10341476245,17558754776,829,794,512,3124197714,In > Out
Feb 2020,213,105,240,5679445246,8734003745,14413448991,170,154,162,3054558499,In > Out
Feb 2020,213,106,403,5090755517,5332576203,10423331720,355,152,172,241820686,In > Out
Feb 2020,213,107,837,7292856754,12726630194,20019486948,694,710,494,5433773440,In > Out
Feb 2020,213,108,978,7036759499,10155632912,17192392411,722,723,581,3118873413,In > Out
Feb 2020,213,109,388,4515012560,4515295584,9030308144,191,166,264,283024,In > Out
Feb 2020,213,11,560,5873610843,7242848831,13116459674,168,138,389,1369237988,In > Out
Feb 2020,213,110,211,2992476352,3953829276,6946305628,158,126,169,961352924,In > Out
Feb 2020,213,111,426,6880154837,9171265472,16051420309,307,274,254,2291110635,In > Out
Feb 2020,213,112,288,9106229896,10892061207,19998291103,241,191,155,1785831311,In > Out
Feb 2020,213,113,328,5079137059,4729210313,9808347372,221,166,226,349926746,Out > In
Feb 2020,213,114,368,2631592114,7635897891,10267490005,261,222,218,5004305777,In > Out
Feb 2020,213,115,449,6929840027,6301077238,13230917265,382,363,423,628762789,Out > In
Feb 2020,213,116,451,6624583854,6323305020,12947888874,380,369,406,301278834,Out > In
Feb 2020,213,117,649,6934469709,8721840412,15656310121,317,407,459,1787370703,In > Out
Feb 2020,213,118,373,5149234309,6011701019,11160935328,271,170,232,862466710,In > Out
Feb 2020,213,119,271,1970850426,7554864865,9525715291,185,145,238,5584014439,In > Out
Feb 2020,213,12,245,4393353193,3680001197,8073354390,202,170,158,713351996,Out > In
Feb 2020,213,120,168,4702505215,5830218198,10532723413,142,88,142,1127712983,In > Out
Feb 2020,213,121,284,4270641570,8483086016,12753727586,240,170,218,4212444446,In > Out
Feb 2020,213,122,476,5173858060,8198369286,13372227346,378,338,349,3024511226,In > Out
Feb 2020,213,123,248,2514547070,15532553189,18047100259,202,131,187,13018006119,In > Out
Feb 2020,213,124,298,4943770880,6075329190,11019100070,180,132,185,1131558310,In > Out
Feb 2020,213,125,711,11243691302,17995004773,29238696075,573,425,367,6751313471,In > Out
Feb 2020,213,126,282,6226338612,6580777671,12807116283,210,134,203,354439059,In > Out
Feb 2020,213,127,448,5552759378,6574894185,12127653563,267,204,223,1022134807,In > Out
Feb 2020,213,128,588,11065238475,22542206873,33607445348,452,416,340,11476968398,In > Out
Feb 2020,213,129,361,6063912766,7231599141,13295511907,284,197,214,1167686375,In > Out
Feb 2020,213,13,236,3553904017,7091499443,10645403460,178,164,118,3537595426,In > Out
Feb 2020,213,130,588,5223924005,5816947255,11040871260,397,321,379,593023250,In > Out
Feb 2020,213,131,424,2653151258,5955752514,8608903772,271,210,294,3302601256,In > Out
Feb 2020,213,132,854,8774135156,16440139313,25214274469,661,576,488,7666004157,In > Out
Feb 2020,213,133,360,2507558197,3918135093,6425693290,310,236,234,1410576896,In > Out
Feb 2020,213,134,616,4822806049,5670519129,10493325178,552,154,159,847713080,In > Out
Feb 2020,213,135,300,3568609210,6201777282,9770386492,220,176,257,2633168072,In > Out
Feb 2020,213,136,302,9050416252,9682062107,18732478359,190,150,196,631645855,In > Out
Feb 2020,213,137,754,5971487066,10924823569,16896310635,618,649,169,4953336503,In > Out
Feb 2020,213,138,511,6544816461,7863901191,14408717652,435,419,405,1319084730,In > Out
Feb 2020,213,139,477,3478884831,4977256518,8456141349,386,334,286,1498371687,In > Out
Feb 2020,213,14,572,2422790670,6151686127,8574476797,177,283,465,3728895457,In > Out
Feb 2020,213,140,335,4325652940,4264291655,8589944595,270,225,264,61361285,Out > In
Feb 2020,213,141,392,3452407091,2989945050,6442352141,216,202,217,462462041,Out > In
Feb 2020,213,142,367,2856687585,3408811397,6265498982,293,220,276,552123812,In > Out
Feb 2020,213,143,371,7153702333,8513953801,15667656134,316,250,266,1360251468,In > Out
Feb 2020,213,144,203,2128695983,3683967427,5812663410,150,107,145,1555271444,In > Out
Feb 2020,213,145,267,4521031482,6786127720,11307159202,206,137,223,2265096238,In > Out
Feb 2020,213,146,205,2965585521,2726902101,5692487622,136,113,163,238683420,Out > In
Feb 2020,213,147,471,6880392547,8702691720,15583084267,416,372,321,1822299173,In > Out
Feb 2020,213,148,252,1510792205,1850173705,3360965910,216,195,204,339381500,In > Out
Feb 2020,213,149,208,2958878528,3828505490,6787384018,173,131,179,869626962,In > Out
Feb 2020,213,15,491,3952514709,5828499558,9781014267,431,408,448,1875984849,In > Out
Feb 2020,213,150,399,2587300653,3117022434,5704323087,302,269,296,529721781,In > Out
Feb 2020,213,151,184,3736970589,3769737116,7506707705,124,90,113,32766527,In > Out
Feb 2020,213,152,744,10051434367,7146745254,17198179621,533,611,672,2904689113,Out > In
Feb 2020,213,153,542,3536082223,4417727845,7953810068,434,401,461,881645622,In > Out
Feb 2020,213,154,2486,6385270781,6835388685,13220659466,1330,1404,1111,450117904,In > Out
Feb 2020,213,155,394,12896032605,15350707712,28246740317,322,297,327,2454675107,In > Out
Feb 2020,213,156,255,3260246624,9652080230,12912326854,195,167,224,6391833606,In > Out
Feb 2020,213,157,755,3431363357,5012830951,8444194308,622,604,248,1581467594,In > Out
Feb 2020,213,158,301,6084095704,6899596356,12983692060,221,183,274,815500652,In > Out
Feb 2020,213,159,249,7263589636,8721855222,15985444858,165,153,217,1458265586,In > Out
Feb 2020,213,16,504,5621990476,4570958061,10192948537,444,204,200,1051032415,Out > In
Feb 2020,213,160,443,2167896399,7326746416,9494642815,264,220,321,5158850017,In > Out
Feb 2020,213,161,244,3090823419,4527575652,7618399071,188,142,211,1436752233,In > Out
Feb 2020,213,162,1945,6719891145,6212672571,12932563716,1649,1797,1802,507218574,Out > In
Feb 2020,213,163,461,2624054330,7502088993,10126143323,366,383,420,4878034663,In > Out
Feb 2020,213,164,238,5146370016,7857846829,13004216845,193,118,125,2711476813,In > Out
Feb 2020,213,165,901,9256677234,9048714083,18305391317,576,512,204,207963151,Out > In
Feb 2020,213,166,452,10269846010,7366067571,17635913581,338,371,415,2903778439,Out > In
Feb 2020,213,167,163,5311818735,5202852776,10514671511,143,99,112,108965959,Out > In
Feb 2020,213,168,424,6486988747,7794410629,14281399376,341,296,297,1307421882,In > Out
Feb 2020,213,169,419,1522272422,1851892155,3374164577,348,133,114,329619733,In > Out
Feb 2020,213,17,1532,6347722980,20619693135,26967416115,439,475,336,14271970155,In > Out
Feb 2020,213,170,408,4013506318,3853648772,7867155090,303,247,294,159857546,Out > In
Feb 2020,213,171,406,4164875840,6127255897,10292131737,219,177,166,1962380057,In > Out
Feb 2020,213,172,365,4341259538,6146869610,10488129148,199,165,175,1805610072,In > Out
Feb 2020,213,173,439,3474601133,4696768486,8171369619,216,197,204,1222167353,In > Out
Feb 2020,213,174,912,4384373001,6357711791,10742084792,665,807,840,1973338790,In > Out
Feb 2020,213,175,545,3295252108,4236059419,7531311527,431,450,173,940807311,In > Out
Feb 2020,213,176,262,1386038254,1849367753,3235406007,187,134,185,463329499,In > Out
Feb 2020,213,177,196,2699402096,8875594329,11574996425,98,70,115,6176192233,In > Out
Feb 2020,213,178,229,4390373741,6395284854,10785658595,192,173,212,2004911113,In > Out
Feb 2020,213,179,210,4504401367,7039342935,11543744302,178,148,143,2534941568,In > Out
Feb 2020,213,18,277,3005021545,6024695140,9029716685,222,181,238,3019673595,In > Out
Feb 2020,213,180,260,5349746045,10867314863,16217060908,173,119,214,5517568818,In > Out
Feb 2020,213,181,611,2225516840,3059516323,5285033163,465,440,350,833999483,In > Out
Feb 2020,213,182,394,8861122914,6328838264,15189961178,285,134,139,2532284650,Out > In
Feb 2020,213,183,333,3104667670,7547858638,10652526308,255,241,226,4443190968,In > Out
Feb 2020,213,184,392,4237347896,4522638850,8759986746,266,225,206,285290954,In > Out
Feb 2020,213,185,1060,4513366098,7476959802,11990325900,410,419,179,2963593704,In > Out
Feb 2020,213,186,419,1002086032,1777064445,2779150477,358,274,189,774978413,In > Out
Feb 2020,213,187,341,3208016582,5425525098,8633541680,271,211,253,2217508516,In > Out
Feb 2020,213,188,644,941430616,3277281265,4218711881,555,533,524,2335850649,In > Out
Feb 2020,213,189,293,2393718633,1962209442,4355928075,263,177,115,431509191,Out > In
Feb 2020,213,19,406,3646168673,4252893034,7899061707,195,200,333,606724361,In > Out
Feb 2020,213,190,479,1972457099,2796039583,4768496682,403,297,146,823582484,In > Out
Feb 2020,213,191,150,614335038,1865308518,2479643556,116,80,130,1250973480,In > Out
Feb 2020,213,192,324,4058622508,4105556344,8164178852,228,120,205,46933836,In > Out
Feb 2020,213,193,711,5671404197,3224941745,8896345942,124,92,685,2446462452,Out > In
Feb 2020,213,194,188,3465520008,3462873991,6928393999,142,120,110,2646017,Out > In
Feb 2020,213,195,401,4547604714,4420056824,8967661538,347,323,321,127547890,Out > In
Feb 2020,213,196,3698,4945667113,20243347376,25189014489,750,1069,193,15297680263,In > Out
Feb 2020,213,197,252,2148605446,2429035218,4577640664,196,176,124,280429772,In > Out
Feb 2020,213,198,256,3245113297,2578777120,5823890417,205,172,167,666336177,Out > In
Feb 2020,213,199,138,3391944322,3717397214,7109341536,98,81,114,325452892,In > Out
Feb 2020,213,2,389,4267434576,5870264267,10137698843,325,97,152,1602829691,In > Out
Feb 2020,213,20,400,4426817573,5131410908,9558228481,344,257,281,704593335,In > Out
Feb 2020,213,200,1535,5728363445,10405435596,16133799041,1095,1072,129,4677072151,In > Out
Feb 2020,213,201,110,1888030338,3077641075,4965671413,98,64,87,1189610737,In > Out
Feb 2020,213,202,234,4551231341,16273831008,20825062349,150,102,132,11722599667,In > Out
Feb 2020,213,203,422,2122773233,4537112489,6659885722,316,309,202,2414339256,In > Out
Feb 2020,213,204,141,5461620348,6928414835,12390035183,101,84,104,1466794487,In > Out
Feb 2020,213,205,278,2774365628,3096593264,5870958892,246,165,133,322227636,In > Out
Feb 2020,213,206,394,2440836867,2347974181,4788811048,312,271,349,92862686,Out > In
Feb 2020,213,207,268,3450881351,3180259343,6631140694,232,194,194,270622008,Out > In
Feb 2020,213,208,187,4847795072,6363298914,11211093986,150,90,128,1515503842,In > Out
Feb 2020,213,209,92,930351677,1639189402,2569541079,75,60,82,708837725,In > Out
Feb 2020,213,21,332,5218661910,5552220475,10770882385,171,151,241,333558565,In > Out
Feb 2020,213,210,270,1114219420,5668549917,6782769337,232,205,181,4554330497,In > Out
Feb 2020,213,211,367,1622702754,2332394474,3955097228,299,310,331,709691720,In > Out
Feb 2020,213,212,165,3203434182,4915191592,8118625774,103,101,94,1711757410,In > Out
Feb 2020,213,213,263,3155118020,6851788107,10006906127,180,159,120,3696670087,In > Out
Feb 2020,213,214,297,637669537,1429987600,2067657137,211,231,240,792318063,In > Out
Feb 2020,213,215,286,2176589642,4172895005,6349484647,243,234,175,1996305363,In > Out
Feb 2020,213,216,268,2859881638,3842440216,6702321854,207,207,214,982558578,In > Out
Feb 2020,213,217,192,3133508819,3713272816,6846781635,168,92,106,579763997,In > Out
Feb 2020,213,218,442,4374002131,5536463047,9910465178,358,266,283,1162460916,In > Out
Feb 2020,213,219,123,2843798962,4733862744,7577661706,93,66,116,1890063782,In > Out
Feb 2020,213,22,439,3181954536,4188200012,7370154548,354,269,261,1006245476,In > Out
Feb 2020,213,220,195,2989523628,2887158139,5876681767,150,137,176,102365489,Out > In
Feb 2020,213,221,187,1864777962,7497644472,9362422434,113,94,160,5632866510,In > Out
Feb 2020,213,222,333,2514192084,3185109585,5699301669,169,127,222,670917501,In > Out
Feb 2020,213,223,372,2166868299,3240570960,5407439259,210,219,206,1073702661,In > Out
Feb 2020,213,224,222,637014904,2207340749,2844355653,153,115,101,1570325845,In > Out
Feb 2020,213,225,241,2576280266,2540532009,5116812275,188,139,181,35748257,Out > In
Feb 2020,213,226,282,2024236339,2416620574,4440856913,227,205,189,392384235,In > Out
Feb 2020,213,227,350,2370364572,5331806074,7702170646,283,249,277,2961441502,In > Out
Feb 2020,213,228,1041,3622488474,7034051894,10656540368,903,656,197,3411563420,In > Out
Feb 2020,213,229,217,770560152,2028163408,2798723560,133,97,102,1257603256,In > Out
Feb 2020,213,23,318,3044869697,4416310791,7461180488,262,205,226,1371441094,In > Out
Feb 2020,213,230,277,1928775497,2040525030,3969300527,230,173,186,111749533,In > Out
Feb 2020,213,231,109,3279387022,4586114819,7865501841,94,63,89,1306727797,In > Out
Feb 2020,213,232,263,2946160770,6796927382,9743088152,85,76,243,3850766612,In > Out
Feb 2020,213,233,223,1705910052,2449711133,4155621185,183,166,131,743801081,In > Out
Feb 2020,213,234,212,3425900305,2362073403,5787973708,169,131,142,1063826902,Out > In
Feb 2020,213,235,357,2423718642,2908714354,5332432996,298,307,308,484995712,In > Out
Feb 2020,213,236,179,2653394014,3832181743,6485575757,134,112,141,1178787729,In > Out
Feb 2020,213,237,152,3095496997,3793352994,6888849991,114,87,128,697855997,In > Out
Feb 2020,213,238,235,1922724767,2663294873,4586019640,200,173,214,740570106,In > Out
Feb 2020,213,239,330,2019789272,3496968332,5516757604,259,213,243,1477179060,In > Out
Feb 2020,213,24,263,3552181641,8389568675,11941750316,199,179,233,4837387034,In > Out
Feb 2020,213,240,162,3799096621,4257106016,8056202637,143,116,125,458009395,In > Out
Feb 2020,213,241,386,3609950715,6982211183,10592161898,331,321,332,3372260468,In > Out
Feb 2020,213,242,119,1911862313,3331410379,5243272692,94,73,101,1419548066,In > Out
Feb 2020,213,243,353,1823448089,5106833227,6930281316,278,235,249,3283385138,In > Out
Feb 2020,213,244,235,4456744460,5291149985,9747894445,143,115,142,834405525,In > Out
Feb 2020,213,245,153,3383092317,4221552623,7604644940,128,87,119,838460306,In > Out
Feb 2020,213,246,164,3158232791,3487339093,6645571884,110,98,121,329106302,In > Out
Feb 2020,213,247,260,9100388010,28230148995,37330537005,193,150,160,19129760985,In > Out
Feb 2020,213,248,440,4433424583,6222883136,10656307719,368,248,217,1789458553,In > Out
Feb 2020,213,249,233,5470955838,5478158168,10949114006,187,164,182,7202330,In > Out
Feb 2020,213,25,306,4281858163,6501106203,10782964366,265,228,259,2219248040,In > Out
Feb 2020,213,250,279,4468488673,4417345970,8885834643,214,183,234,51142703,Out > In
Feb 2020,213,251,358,6592203897,8664401017,15256604914,301,210,190,2072197120,In > Out
Feb 2020,213,252,208,3890348989,2303028397,6193377386,176,160,153,1587320592,Out > In
Feb 2020,213,253,397,3427797881,20696419944,24124217825,324,247,276,17268622063,In > Out
Feb 2020,213,254,310,7643242064,8613274850,16256516914,229,176,191,970032786,In > Out
Feb 2020,213,26,317,2354733000,2874744828,5229477828,226,224,271,520011828,In > Out
Feb 2020,213,27,700,2409737974,4423793090,6833531064,584,536,383,2014055116,In > Out
Feb 2020,213,28,267,5114982431,4395748446,9510730877,226,200,200,719233985,Out > In
Feb 2020,213,29,431,6823815565,5314560688,12138376253,332,257,244,1509254877,Out > In
Feb 2020,213,3,155,3434198793,4627605301,8061804094,130,94,112,1193406508,In > Out
Feb 2020,213,30,742,3457983681,5017034866,8475018547,680,182,171,1559051185,In > Out
Feb 2020,213,31,428,4129223926,6983766615,11112990541,374,285,205,2854542689,In > Out
Feb 2020,213,32,404,2589307674,7731568582,10320876256,346,334,195,5142260908,In > Out
Feb 2020,213,33,200,4712441320,5983525099,10695966419,159,138,143,1271083779,In > Out
Feb 2020,213,34,597,4159111971,12783640940,16942752911,460,295,303,8624528969,In > Out
Feb 2020,213,35,465,18702149638,19862582941,38564732579,381,231,201,1160433303,In > Out
Feb 2020,213,36,620,4545204960,14315374399,18860579359,498,451,457,9770169439,In > Out
Feb 2020,213,37,646,5353412772,5233506608,10586919380,545,496,505,119906164,Out > In
Feb 2020,213,38,432,7403758400,10600775367,18004533767,355,291,245,3197016967,In > Out
Feb 2020,213,39,499,5965338644,5283823149,11249161793,322,321,421,681515495,Out > In
Feb 2020,213,4,205,2695461200,2835014977,5530476177,172,134,178,139553777,In > Out
Feb 2020,213,40,456,9003411762,11543731007,20547142769,397,352,333,2540319245,In > Out
Feb 2020,213,41,468,3116428401,4371590774,7488019175,302,253,183,1255162373,In > Out
Feb 2020,213,42,435,6919416332,10614961102,17534377434,355,255,250,3695544770,In > Out
Feb 2020,213,43,767,4539833294,6393255563,10933088857,417,406,711,1853422269,In > Out
Feb 2020,213,44,209,9415120737,9031954596,18447075333,152,98,157,383166141,Out > In
Feb 2020,213,45,280,6210859242,16179810732,22390669974,229,165,156,9968951490,In > Out
Feb 2020,213,46,296,1344901593,2416770292,3761671885,241,183,173,1071868699,In > Out
Feb 2020,213,47,343,7612798853,9284093864,16896892717,256,183,212,1671295011,In > Out
Feb 2020,213,48,281,5883660133,6912136600,12795796733,235,200,247,1028476467,In > Out
Feb 2020,213,49,166,2299543932,2329269106,4628813038,152,115,131,29725174,In > Out
Feb 2020,213,5,237,2590618894,7539954250,10130573144,161,125,171,4949335356,In > Out
Feb 2020,213,50,608,5293476563,5891678750,11185155313,361,414,492,598202187,In > Out
Feb 2020,213,51,242,4927835734,6068351445,10996187179,187,157,147,1140515711,In > Out
Feb 2020,213,52,389,6287260027,8232254524,14519514551,335,289,279,1944994497,In > Out
Feb 2020,213,53,565,12868045646,28208265973,41076311619,401,359,378,15340220327,In > Out
Feb 2020,213,54,198,2365151875,3037191691,5402343566,146,107,166,672039816,In > Out
Feb 2020,213,55,205,1751481527,2913749818,4665231345,169,133,161,1162268291,In > Out
Feb 2020,213,56,713,9447642233,9174569710,18622211943,301,299,234,273072523,Out > In
Feb 2020,213,57,1117,5837197326,8117606460,13954803786,744,745,661,2280409134,In > Out
Feb 2020,213,58,1773,3548555188,6265018587,9813573775,1154,1233,244,2716463399,In > Out
Feb 2020,213,59,627,4946041551,11891614560,16837656111,245,288,207,6945573009,In > Out
Feb 2020,213,6,794,7405771832,9786292439,17192064271,685,250,219,2380520607,In > Out
Feb 2020,213,60,799,3871574257,3894212173,7765786430,272,161,163,22637916,In > Out
Feb 2020,213,61,719,6466060379,7188627529,13654687908,261,265,265,722567150,In > Out
Feb 2020,213,62,568,9431198245,8830753896,18261952141,509,472,521,600444349,Out > In
Feb 2020,213,63,296,4773762081,5935311218,10709073299,203,159,210,1161549137,In > Out
Feb 2020,213,64,629,5166576663,5680667293,10847243956,204,218,276,514090630,In > Out
Feb 2020,213,65,420,5226379383,5625412301,10851791684,298,256,271,399032918,In > Out
Feb 2020,213,66,293,4542074592,5366231331,9908305923,182,145,212,824156739,In > Out
Feb 2020,213,67,375,5636489869,6677783713,12314273582,292,261,174,1041293844,In > Out
Feb 2020,213,68,321,8489905105,11174617761,19664522866,222,171,225,2684712656,In > Out
Feb 2020,213,69,480,4139541922,7053778646,11193320568,336,288,406,2914236724,In > Out
Feb 2020,213,7,532,8951309237,7078846050,16030155287,274,217,379,1872463187,Out > In
Feb 2020,213,70,740,11559028883,10438479439,21997508322,348,317,209,1120549444,Out > In
Feb 2020,213,71,206,3817186441,5831436530,9648622971,151,143,181,2014250089,In > Out
Feb 2020,213,72,581,7129202776,13087069889,20216272665,430,446,538,5957867113,In > Out
Feb 2020,213,73,194,2596100036,4784483673,7380583709,166,122,144,2188383637,In > Out
Feb 2020,213,74,680,4498285042,9782901095,14281186137,585,588,409,5284616053,In > Out
Feb 2020,213,75,467,7996039271,7237803439,15233842710,383,162,202,758235832,Out > In
Feb 2020,213,76,885,2725016674,4553880466,7278897140,714,713,555,1828863792,In > Out
Feb 2020,213,77,317,3473516742,3243621877,6717138619,234,190,226,229894865,Out > In
Feb 2020,213,78,288,1227926420,3508946660,4736873080,216,188,212,2281020240,In > Out
Feb 2020,213,79,246,2199557714,3295222007,5494779721,211,135,161,1095664293,In > Out
Feb 2020,213,8,430,8028501709,11906221703,19934723412,347,202,163,3877719994,In > Out
Feb 2020,213,80,342,7792005556,7188474005,14980479561,247,132,181,603531551,Out > In
Feb 2020,213,81,410,6946185476,7227167211,14173352687,368,359,385,280981735,In > Out
Feb 2020,213,82,408,5110553616,6083803636,11194357252,349,291,283,973250020,In > Out
Feb 2020,213,83,1081,4554159214,10064062218,14618221432,959,976,876,5509903004,In > Out
Feb 2020,213,84,279,5473850905,6420763841,11894614746,193,159,191,946912936,In > Out
Feb 2020,213,85,338,1744327940,9677490207,11421818147,280,255,302,7933162267,In > Out
Feb 2020,213,86,469,4883804478,10874625989,15758430467,395,310,230,5990821511,In > Out
Feb 2020,213,87,498,5490235929,8679126169,14169362098,403,349,288,3188890240,In > Out
Feb 2020,213,88,161,2476014037,2636308234,5112322271,121,95,123,160294197,In > Out
Feb 2020,213,89,330,1815304446,2206980483,4022284929,225,160,229,391676037,In > Out
Feb 2020,213,9,264,7596856822,8935337851,16532194673,207,153,167,1338481029,In > Out
Feb 2020,213,90,573,4631284543,10058333615,14689618158,278,396,422,5427049072,In > Out
Feb 2020,213,91,425,3822736248,6320454006,10143190254,371,269,190,2497717758,In > Out
Feb 2020,213,92,296,3320813728,6359901508,9680715236,210,198,155,3039087780,In > Out
Feb 2020,213,93,238,4226704482,24415357273,28642061755,165,104,200,20188652791,In > Out
Feb 2020,213,94,577,3511235138,8382485473,11893720611,357,357,449,4871250335,In > Out
Feb 2020,213,95,924,8078560016,9412176901,17490736917,568,560,321,1333616885,In > Out
Feb 2020,213,96,415,5155272979,17803971955,22959244934,376,331,364,12648698976,In > Out
Feb 2020,213,97,250,6691620218,16420039122,23111659340,197,160,207,9728418904,In > Out
Feb 2020,213,98,421,3289255051,4349219986,7638475037,358,335,378,1059964935,In > Out
Feb 2020,213,99,463,5499119127,6108430488,11607549615,383,349,403,609311361,In > Out
Feb 2020,214,181,1,175826,87125,262951,1,1,1,88701,Out > In
Feb 2020,215,113,175542,183542833752,6518766646,190061600398,4473,53757,1,177024067106,Out > In
Feb 2020,215,124,2,35538,996797,1032335,1,1,2,961259,In > Out
Feb 2020,215,178,5,198014929,131532365,329547294,4,4,5,66482564,Out > In
Feb 2020,215,213,13,2175598,10561342,12736940,7,1,13,8385744,In > Out
Feb 2020,215,215,1,6351132,6393528,12744660,1,1,1,42396,In > Out
Feb 2020,215,40,1,9195619,30337598,39533217,1,1,1,21141979,In > Out
Feb 2020,215,55,1,310050,79183,389233,1,1,1,230867,Out > In
Feb 2020,215,92,6,169300,1632394,1801694,6,1,6,1463094,In > Out
Feb 2020,221,144,1,49008,1848960,1897968,1,1,1,1799952,In > Out
Feb 2020,221,148,1,1371582,29488,1401070,1,1,1,1342094,Out > In
Feb 2020,221,15,61,19100564,3671947,22772511,43,23,2,15428617,Out > In
Feb 2020,221,150,1,137264629,1160807,138425436,1,1,1,136103822,Out > In
Feb 2020,221,153,168745,175889041270,6302656300,182191697570,4375,53470,1,169586384970,Out > In
Feb 2020,221,195,2,384290,135724,520014,1,2,1,248566,Out > In
Feb 2020,221,198,6599,3646745786,383838844,4030584630,969,5215,1,3262906942,Out > In
Feb 2020,221,206,1,2901,139990,142891,1,1,1,137089,In > Out
Feb 2020,221,32,1,1763691,8164,1771855,1,1,1,1755527,Out > In
Feb 2020,221,38,26,7080330,2239823,9320153,2,20,2,4840507,Out > In
Feb 2020,221,62,52,14016032,3375036,17391068,36,16,1,10640996,Out > In
Feb 2020,221,66,1,1898,142203,144101,1,1,1,140305,In > Out
Feb 2020,222,130,6,612338,335866,948204,3,6,1,276472,Out > In
Feb 2020,222,196,71,8774388,8896980,17671368,2,1,1,122592,In > Out
Feb 2020,224,221,1,32556186,68375153,100931339,1,1,1,35818967,In > Out
Feb 2020,225,111,3,16689132,20110815,36799947,3,1,3,3421683,In > Out
Feb 2020,225,120,1757,1253353591,137285632,1390639223,185,1479,2,1116067959,Out > In
Feb 2020,225,129,2,331976,39933512,40265488,1,1,2,39601536,In > Out
Feb 2020,225,134,6,26666035,251111724,277777759,3,1,6,224445689,In > Out
Feb 2020,225,149,1,1275672,829922,2105594,1,1,1,445750,Out > In
Feb 2020,225,163,2,50381,298129,348510,1,1,2,247748,In > Out
Feb 2020,225,210,4,92459520,5297505,97757025,1,4,4,87162015,Out > In
Feb 2020,225,218,104,228456854,4729244,233186098,76,104,2,223727610,Out > In
Feb 2020,225,223,171855,176601975940,6277732578,182879708518,4396,53987,1,170324243362,Out > In
Feb 2020,225,75,1,2484,10852432,10854916,1,1,1,10849948,In > Out
Feb 2020,225,8,8,145708742,32232042,177940784,4,8,5,113476700,Out > In
Feb 2020,225,85,1,8600,611808,620408,1,1,1,603208,In > Out
Feb 2020,228,100,2,22835010,21922769,44757779,2,2,2,912241,Out > In
Feb 2020,228,103,1,152858631,156624485,309483116,1,1,1,3765854,In > Out
Feb 2020,228,104,1,734065,771235,1505300,1,1,1,37170,In > Out
Feb 2020,228,105,2,71248,1548927,1620175,2,2,1,1477679,In > Out
Feb 2020,228,107,1,244911,266840,511751,1,1,1,21929,In > Out
Feb 2020,228,11,2,14396663,13758515,28155178,2,2,2,638148,Out > In
Feb 2020,228,110,1,143609431,132414467,276023898,1,1,1,11194964,Out > In
Feb 2020,228,113,4,86913863,139416526,226330389,2,3,4,52502663,In > Out
Feb 2020,228,114,1,7512,226548,234060,1,1,1,219036,In > Out
Feb 2020,228,116,5,4855828,96122406,100978234,5,5,5,91266578,In > Out
Feb 2020,228,12,1,1434263,801400,2235663,1,1,1,632863,Out > In
Feb 2020,228,123,14,183030204,311931805,494962009,13,13,5,128901601,In > Out
Feb 2020,228,131,1,2522189,9716947,12239136,1,1,1,7194758,In > Out
Feb 2020,228,132,3,6659421,8249478,14908899,3,3,3,1590057,In > Out
Feb 2020,228,134,4,32660945,31666998,64327943,3,4,4,993947,Out > In
Feb 2020,228,138,2,203563,338501,542064,2,2,2,134938,In > Out
Feb 2020,228,14,2,5379855,7746550,13126405,2,2,2,2366695,In > Out
Feb 2020,228,140,3,289456,364538,653994,1,1,1,75082,In > Out
Feb 2020,228,141,1,5720855,6451482,12172337,1,1,1,730627,In > Out
Feb 2020,228,142,1,231806897,238645097,470451994,1,1,1,6838200,In > Out
Feb 2020,228,145,4,23409891,24496155,47906046,4,4,4,1086264,In > Out
Feb 2020,228,150,1,45984,67188,113172,1,1,1,21204,In > Out
Feb 2020,228,151,6,331269649,329729582,660999231,2,6,5,1540067,Out > In
Feb 2020,228,154,1,147605245,223450208,371055453,1,1,1,75844963,In > Out
Feb 2020,228,155,2,116482149,115824201,232306350,1,2,2,657948,Out > In
Feb 2020,228,160,4,330427,729707,1060134,2,2,2,399280,In > Out
Feb 2020,228,161,1,2721567,211801358,214522925,1,1,1,209079791,In > Out
Feb 2020,228,168,16,23915049,13755911,37670960,13,14,3,10159138,Out > In
Feb 2020,228,169,7,301160451,52809758,353970209,7,7,6,248350693,Out > In
Feb 2020,228,171,3,5587807,5744560,11332367,3,3,3,156753,In > Out
Feb 2020,228,178,2,6427885,9539371,15967256,2,2,2,3111486,In > Out
Feb 2020,228,180,1,72855332,86456401,159311733,1,1,1,13601069,In > Out
Feb 2020,228,184,4,105222947,84425943,189648890,4,4,2,20797004,Out > In
Feb 2020,228,198,1,4030112,4755639,8785751,1,1,1,725527,In > Out
Feb 2020,228,199,6,215559,11892931,12108490,6,6,1,11677372,In > Out
Feb 2020,228,200,2,251637,240375,492012,1,2,1,11262,Out > In
Feb 2020,228,201,10,383542540,468732891,852275431,10,8,4,85190351,In > Out
Feb 2020,228,203,1,17285423,25184938,42470361,1,1,1,7899515,In > Out
Feb 2020,228,209,16,752958921,267882524,1020841445,15,12,5,485076397,Out > In
Feb 2020,228,21,5,12127917,26395910,38523827,5,4,5,14267993,In > Out
Feb 2020,228,210,2,68544,6889040,6957584,1,1,2,6820496,In > Out
Feb 2020,228,212,1,188618,4556250,4744868,1,1,1,4367632,In > Out
Feb 2020,228,214,22,2487403135,1593327054,4080730189,15,21,1,894076081,Out > In
Feb 2020,228,215,2,538272,3450312,3988584,2,2,2,2912040,In > Out
Feb 2020,228,216,1,400618,658329,1058947,1,1,1,257711,In > Out
Feb 2020,228,217,4,391709987,578468781,970178768,2,3,4,186758794,In > Out
Feb 2020,228,218,3,1548786,2244107,3792893,2,3,1,695321,In > Out
Feb 2020,228,24,1,35861,2381971,2417832,1,1,1,2346110,In > Out
Feb 2020,228,27,6,3796931,2640871,6437802,5,5,5,1156060,Out > In
Feb 2020,228,31,1,364589098,173038154,537627252,1,1,1,191550944,Out > In
Feb 2020,228,32,3,4917969,4546343,9464312,3,3,1,371626,Out > In
Feb 2020,228,33,1,6374916,10430269,16805185,1,1,1,4055353,In > Out
Feb 2020,228,36,1,897926,555009,1452935,1,1,1,342917,Out > In
Feb 2020,228,38,39,101543125,409613456,511156581,35,17,8,308070331,In > Out
Feb 2020,228,39,103,917559,25122849,26040408,1,1,103,24205290,In > Out
Feb 2020,228,4,10,35068124,41738868,76806992,5,5,10,6670744,In > Out
Feb 2020,228,41,1,676091959,699195327,1375287286,1,1,1,23103368,In > Out
Feb 2020,228,42,1,24383854,24219713,48603567,1,1,1,164141,Out > In
Feb 2020,228,43,9,285187,3070076,3355263,7,1,9,2784889,In > Out
Feb 2020,228,44,4,163247590,175236583,338484173,4,4,3,11988993,In > Out
Feb 2020,228,48,1,64959,1696993,1761952,1,1,1,1632034,In > Out
Feb 2020,228,49,6,2030127,11123902,13154029,6,6,6,9093775,In > Out
Feb 2020,228,5,2,11535943,12846865,24382808,2,2,2,1310922,In > Out
Feb 2020,228,51,10,39314086,47498593,86812679,7,7,8,8184507,In > Out
Feb 2020,228,57,3,1095646,644969,1740615,3,2,3,450677,Out > In
Feb 2020,228,61,7,38572666,17133159,55705825,6,4,4,21439507,Out > In
Feb 2020,228,62,3,13966257,1289274,15255531,1,3,3,12676983,Out > In
Feb 2020,228,65,13,125083595,258659599,383743194,11,13,2,133576004,In > Out
Feb 2020,228,67,10,44780785,110930709,155711494,7,7,9,66149924,In > Out
Feb 2020,228,68,1,457365,269592,726957,1,1,1,187773,Out > In
Feb 2020,228,72,1,66153,38368,104521,1,1,1,27785,Out > In
Feb 2020,228,79,3,24875651,56398009,81273660,3,3,3,31522358,In > Out
Feb 2020,228,8,11,475076368,489216393,964292761,7,10,9,14140025,In > Out
Feb 2020,228,81,1,72688,351098,423786,1,1,1,278410,In > Out
Feb 2020,228,85,3,881936,1298368,2180304,3,3,3,416432,In > Out
Feb 2020,228,9,2,39203656,78376627,117580283,2,2,2,39172971,In > Out
Feb 2020,228,92,7,31159671,57488422,88648093,7,7,2,26328751,In > Out
Feb 2020,228,94,1,2460218566,3339930334,5800148900,1,1,1,879711768,In > Out
Feb 2020,228,95,4,247773,720231,968004,4,4,4,472458,In > Out
Feb 2020,228,97,11,1294550216,1945331924,3239882140,5,10,11,650781708,In > Out
Feb 2020,228,98,3,4334529,4399103,8733632,3,3,3,64574,In > Out
Feb 2020,229,104,3,13248467,13457614,26706081,2,3,3,209147,In > Out
Feb 2020,229,107,2,733726,595058,1328784,1,1,2,138668,Out > In
Feb 2020,229,108,3,66481222,109649243,176130465,3,3,2,43168021,In > Out
Feb 2020,229,11,5,68139,3145560,3213699,1,1,5,3077421,In > Out
Feb 2020,229,115,283,41284794,284046961,325331755,149,149,2,242762167,In > Out
Feb 2020,229,118,1,5767552,3912143,9679695,1,1,1,1855409,Out > In
Feb 2020,229,120,3,855121,429793,1284914,3,3,3,425328,Out > In
Feb 2020,229,122,6,44356396,39697194,84053590,5,5,6,4659202,Out > In
Feb 2020,229,123,22,998362581,1106388382,2104750963,22,19,7,108025801,In > Out
Feb 2020,229,124,3,11288717,9226708,20515425,3,3,3,2062009,Out > In
Feb 2020,229,125,3,2353742004,1114291482,3468033486,3,2,2,1239450522,Out > In
Feb 2020,229,128,6,4782356,5325418,10107774,6,6,3,543062,In > Out
Feb 2020,229,130,1,193587,148453,342040,1,1,1,45134,Out > In
Feb 2020,229,132,1,11164563,249158967,260323530,1,1,1,237994404,In > Out
Feb 2020,229,134,66,101674446,270802349,372476795,45,46,3,169127903,In > Out
Feb 2020,229,135,11,155715111,185744347,341459458,11,11,2,30029236,In > Out
Feb 2020,229,137,4,159901434,166594939,326496373,2,1,2,6693505,In > Out
Feb 2020,229,138,9,169364981,150985391,320350372,4,9,2,18379590,Out > In
Feb 2020,229,139,3,266443070,246276663,512719733,2,3,3,20166407,Out > In
Feb 2020,229,14,2,10751169,8453675,19204844,2,2,2,2297494,Out > In
Feb 2020,229,145,33,51615480,246647808,298263288,2,2,2,195032328,In > Out
Feb 2020,229,150,4,68562780,53901808,122464588,4,4,3,14660972,Out > In
Feb 2020,229,151,1,3254028,5753680,9007708,1,1,1,2499652,In > Out
Feb 2020,229,153,6,3368654,3627095,6995749,3,6,2,258441,In > Out
Feb 2020,229,157,2,271413,402905,674318,2,2,2,131492,In > Out
Feb 2020,229,158,5,35458323,69104992,104563315,2,3,5,33646669,In > Out
Feb 2020,229,159,1,10594454,9495113,20089567,1,1,1,1099341,Out > In
Feb 2020,229,160,1,133302887,154606981,287909868,1,1,1,21304094,In > Out
Feb 2020,229,170,13,47284770,78731626,126016396,8,13,12,31446856,In > Out
Feb 2020,229,174,3,407395,2215085,2622480,2,3,3,1807690,In > Out
Feb 2020,229,175,1,1177920,3279399,4457319,1,1,1,2101479,In > Out
Feb 2020,229,177,10,1496279083,1306573192,2802852275,8,10,9,189705891,Out > In
Feb 2020,229,178,13,149089410,292385342,441474752,11,12,9,143295932,In > Out
Feb 2020,229,180,5,267136,1391849,1658985,2,2,5,1124713,In > Out
Feb 2020,229,181,8,9228037,23764540,32992577,5,6,8,14536503,In > Out
Feb 2020,229,182,4,1125830,5222431,6348261,2,4,4,4096601,In > Out
Feb 2020,229,189,1,49796135,46159826,95955961,1,1,1,3636309,Out > In
Feb 2020,229,190,1,1054668,946220,2000888,1,1,1,108448,Out > In
Feb 2020,229,191,2,495374,1388199,1883573,1,2,2,892825,In > Out
Feb 2020,229,194,6,54585853,39211143,93796996,5,6,6,15374710,Out > In
Feb 2020,229,195,1,16176373,4440611,20616984,1,1,1,11735762,Out > In
Feb 2020,229,199,3,19381977,26468632,45850609,3,3,1,7086655,In > Out
Feb 2020,229,20,11,50958045,24934152,75892197,11,11,4,26023893,Out > In
Feb 2020,229,203,1,22464,90042,112506,1,1,1,67578,In > Out
Feb 2020,229,210,3,741852452,803585044,1545437496,3,3,3,61732592,In > Out
Feb 2020,229,211,5,1107369118,1235269564,2342638682,5,5,2,127900446,In > Out
Feb 2020,229,212,1,703097,546341,1249438,1,1,1,156756,Out > In
Feb 2020,229,213,31,66807350,52022555,118829905,28,12,6,14784795,Out > In
Feb 2020,229,215,3,12839952,2363951042,2376790994,1,1,3,2351111090,In > Out
Feb 2020,229,216,3,142678479,314009781,456688260,3,3,3,171331302,In > Out
Feb 2020,229,217,58,602145790,497674522,1099820312,48,52,7,104471268,Out > In
Feb 2020,229,218,1,948374,1573113,2521487,1,1,1,624739,In > Out
Feb 2020,229,219,5,167625391,155811647,323437038,3,4,5,11813744,Out > In
Feb 2020,229,221,4,121270686,41312941,162583627,3,4,4,79957745,Out > In
Feb 2020,229,222,2,70101,864713,934814,2,2,2,794612,In > Out
Feb 2020,229,223,1,101916281,126177723,228094004,1,1,1,24261442,In > Out
Feb 2020,229,23,1,49382,75146,124528,1,1,1,25764,In > Out
Feb 2020,229,27,6,164696951,163920665,328617616,4,6,5,776286,Out > In
Feb 2020,229,30,4,121144230,167914647,289058877,4,4,4,46770417,In > Out
Feb 2020,229,32,18,9317309,39042025,48359334,18,18,4,29724716,In > Out
Feb 2020,229,35,2,31472642,33966075,65438717,2,2,2,2493433,In > Out
Feb 2020,229,38,2,53901260,204764517,258665777,2,2,1,150863257,In > Out
Feb 2020,229,42,1,2296404110,788179569,3084583679,1,1,1,1508224541,Out > In
Feb 2020,229,43,1,66277358,71443887,137721245,1,1,1,5166529,In > Out
Feb 2020,229,45,8,16069716,13454483,29524199,2,8,8,2615233,Out > In
Feb 2020,229,52,6,2159889272,2151872574,4311761846,3,4,4,8016698,Out > In
Feb 2020,229,55,5,11865063,28510944,40376007,4,5,5,16645881,In > Out
Feb 2020,229,58,5,1608337,1070990,2679327,4,4,3,537347,Out > In
Feb 2020,229,6,1,55266,93170,148436,1,1,1,37904,In > Out
Feb 2020,229,67,2,207696159,191709055,399405214,2,2,2,15987104,Out > In
Feb 2020,229,69,2,103445502,67532341,170977843,1,2,2,35913161,Out > In
Feb 2020,229,7,1,58004,369329,427333,1,1,1,311325,In > Out
Feb 2020,229,71,10,738563,23443140,24181703,3,2,10,22704577,In > Out
Feb 2020,229,72,2,6590091,12428667,19018758,2,2,2,5838576,In > Out
Feb 2020,229,73,1,17333623,18958528,36292151,1,1,1,1624905,In > Out
Feb 2020,229,76,9,296780770,341190433,637971203,5,5,9,44409663,In > Out
Feb 2020,229,77,1,155368,116364,271732,1,1,1,39004,Out > In
Feb 2020,229,79,3,19229160,29041221,48270381,3,3,2,9812061,In > Out
Feb 2020,229,80,4,2653799,2110753,4764552,3,4,3,543046,Out > In
Feb 2020,229,83,3,11646227,18792580,30438807,2,3,3,7146353,In > Out
Feb 2020,229,89,1,41282698,37469140,78751838,1,1,1,3813558,Out > In
Feb 2020,229,96,4,14902450,23751770,38654220,3,4,2,8849320,In > Out
Feb 2020,229,99,2,9045428,28715673,37761101,2,2,2,19670245,In > Out
Feb 2020,230,171,4,590229,25157,615386,3,4,1,565072,Out > In
Feb 2020,234,113,1,186578,228737,415315,1,1,1,42159,In > Out
Feb 2020,234,116,101,150098262,30001682,180099944,71,47,3,120096580,Out > In
Feb 2020,234,200,4,22620438,1130134058,1152754496,2,4,3,1107513620,In > Out
Feb 2020,234,201,2,260814,127417,388231,1,2,1,133397,Out > In
Feb 2020,234,228,2,4826035,285109755,289935790,2,2,1,280283720,In > Out
Feb 2020,234,237,2,66282255,1471609,67753864,1,2,2,64810646,Out > In
Feb 2020,234,29,5,40715357,4196039,44911396,1,5,5,36519318,Out > In
Feb 2020,234,44,2,269958,100220,370178,2,2,2,169738,Out > In
Feb 2020,234,76,1,12267,156555,168822,1,1,1,144288,In > Out
Feb 2020,235,212,25,9485100,211651,9696751,3,25,1,9273449,Out > In
Feb 2020,235,223,319002,171053594758,4755185665,175808780423,11878,43044,2,166298409093,Out > In
Feb 2020,236,253,46,304604606,932488696,1237093302,28,28,41,627884090,In > Out
Feb 2020,239,191,2,93233296,48427592,141660888,2,2,2,44805704,Out > In
Feb 2020,241,182,2,68410,242834,311244,1,2,1,174424,In > Out
Feb 2020,241,196,1,98256,67356,165612,1,1,1,30900,Out > In
Feb 2020,241,223,1,12260225987,73107379,12333333366,1,1,1,12187118608,Out > In
Feb 2020,241,235,1,18841882,20702246,39544128,1,1,1,1860364,In > Out
Feb 2020,242,104,1,41439,119663,161102,1,1,1,78224,In > Out
Feb 2020,242,110,24,1551671,1089499,2641170,24,24,1,462172,Out > In
Feb 2020,242,114,2,1476707,38318,1515025,1,2,1,1438389,Out > In
Feb 2020,242,122,1,76578328,23536576,100114904,1,1,1,53041752,Out > In
Feb 2020,242,169,1,28347,79585,107932,1,1,1,51238,In > Out
Feb 2020,242,174,3,259943759,169184441,429128200,2,3,3,90759318,Out > In
Feb 2020,242,230,6,607791843,254529905,862321748,2,4,4,353261938,Out > In
Feb 2020,242,39,1,210275,4085,214360,1,1,1,206190,Out > In
Feb 2020,242,40,6,21302395,68837417,90139812,2,6,6,47535022,In > Out
Feb 2020,242,41,12,515494,1364167,1879661,1,12,1,848673,In > Out
Feb 2020,246,160,1,203120,7093153,7296273,1,1,1,6890033,In > Out
Feb 2020,246,180,1,504247,582361,1086608,1,1,1,78114,In > Out
Feb 2020,25,22,21,7033789,327374,7361163,10,21,1,6706415,Out > In
Feb 2020,250,15,73,66626084,62196196,128822280,47,1,1,4429888,Out > In
Feb 2020,250,193,1,4372641,4735213,9107854,1,1,1,362572,In > Out
Feb 2020,250,201,335,71743119,49413924,121157043,12,15,201,22329195,Out > In
Feb 2020,250,204,1,56520,57408,113928,1,1,1,888,In > Out
Feb 2020,250,3,13,25080210,45080025,70160235,5,13,5,19999815,In > Out
Feb 2020,250,39,12,3498604,253776,3752380,5,12,2,3244828,Out > In
Feb 2020,250,41,19,31773201,272461112,304234313,7,19,2,240687911,In > Out
Feb 2020,250,51,6,950280,919500,1869780,1,6,6,30780,Out > In
Feb 2020,256,101,6,786292,400329,1186621,3,6,1,385963,Out > In
Feb 2020,256,102,2,323814,151399,475213,1,2,1,172415,Out > In
Feb 2020,256,103,1,73898,34549,108447,1,1,1,39349,Out > In
Feb 2020,256,104,42,35251491,1338445,36589936,15,42,1,33913046,Out > In
Feb 2020,256,105,4,910774,301689,1212463,2,4,1,609085,Out > In
Feb 2020,256,107,2,374674,164714,539388,1,2,1,209960,Out > In
Feb 2020,256,11,392,289692432,50480379,340172811,51,391,6,239212053,Out > In
Feb 2020,256,12,171,57560598,8399230,65959828,46,171,2,49161368,Out > In
Feb 2020,256,15,326,17715097,153650345,171365442,249,326,2,135935248,In > Out
Feb 2020,256,248,1160,8732525215,10505139917,19237665132,823,669,716,1772614702,In > Out
Feb 2020,256,249,1657,11081077920,12874026275,23955104195,1351,792,746,1792948355,In > Out
Feb 2020,256,250,1077,9663080437,10863752043,20526832480,818,457,548,1200671606,In > Out
Feb 2020,256,251,1232,9734068665,13641371421,23375440086,827,558,690,3907302756,In > Out
Feb 2020,256,252,1076,7625808591,10974835994,18600644585,826,496,582,3349027403,In > Out
Feb 2020,256,253,1072,7349983448,12593208609,19943192057,807,520,660,5243225161,In > Out
Feb 2020,256,254,791,6830810626,9040402153,15871212779,603,483,579,2209591527,In > Out
Feb 2020,29,216,1,37245,117934,155179,1,1,1,80689,In > Out
Feb 2020,29,52,164,328653319,521921490,850574809,25,65,39,193268171,In > Out
Feb 2020,3,195,16,119082635,6800756,125883391,2,2,2,112281879,Out > In
Feb 2020,3,30,2,12672,295431,308103,1,2,1,282759,In > Out
Feb 2020,34,201,11,2092605,2060182,4152787,3,11,1,32423,Out > In
Feb 2020,35,111,6,2747688,118440,2866128,1,6,1,2629248,Out > In
Feb 2020,35,112,5,2578184,88645,2666829,4,5,1,2489539,Out > In
Feb 2020,35,116,135,31360448,1449784,32810232,68,135,2,29910664,Out > In
Feb 2020,35,118,300,107199834,21115208,128315042,66,292,1,86084626,Out > In
Feb 2020,35,16,9,1016882,293904,1310786,1,5,1,722978,Out > In
Feb 2020,35,164,2,330763,6517,337280,2,2,2,324246,Out > In
Feb 2020,35,182,904,650038681,10486981,660525662,64,879,2,639551700,Out > In
Feb 2020,35,191,118,38838024,2633066,41471090,67,118,2,36204958,Out > In
Feb 2020,35,192,155,63580797,5837203,69418000,53,150,1,57743594,Out > In
Feb 2020,35,193,64,103815209,2889174,106704383,21,64,1,100926035,Out > In
Feb 2020,35,195,41117,23976089802,2118843210,26094933012,5662,25995,2,21857246592,Out > In
Feb 2020,35,202,82,12548028,563469,13111497,21,82,2,11984559,Out > In
Feb 2020,35,212,993,963721301,1614711284,2578432585,138,981,2,650989983,In > Out
Feb 2020,35,251,6,1891621,453677,2345298,2,6,1,1437944,Out > In
Feb 2020,35,254,385,609137198,216951104,826088302,52,376,1,392186094,Out > In
Feb 2020,35,35,1,268559,3571,272130,1,1,1,264988,Out > In
Feb 2020,35,98,7,2306014,713384,3019398,2,7,1,1592630,Out > In
Feb 2020,37,76,15583,81409066995,3681931504,85090998499,4374,12408,2,77727135491,Out > In
Feb 2020,38,17,1,41794,70329,112123,1,1,1,28535,In > Out
Feb 2020,38,18,5,1583102,2219686,3802788,4,5,2,636584,In > Out
Feb 2020,38,20,1,58437,100024,158461,1,1,1,41587,In > Out
Feb 2020,38,21,1,1641636,2338822,3980458,1,1,1,697186,In > Out
Feb 2020,38,24,1,73189,150595,223784,1,1,1,77406,In > Out
Feb 2020,38,26,1,138630,276564,415194,1,1,1,137934,In > Out
Feb 2020,38,27,1,282273,472030,754303,1,1,1,189757,In > Out
Feb 2020,38,28,1,32908,74829,107737,1,1,1,41921,In > Out
Feb 2020,38,40,11,221008,2454784,2675792,11,11,2,2233776,In > Out
Feb 2020,38,41,220461,80693971166,27595537097,108289508263,33310,47165,1,53098434069,Out > In
Feb 2020,38,42,3056,1091075807,953299524,2044375331,573,2860,2,137776283,Out > In
Feb 2020,38,43,9702,2730771316,718671250,3449442566,2450,7872,1,2012100066,Out > In
Feb 2020,38,44,66448,24738176011,6015703488,30753879499,15416,28590,1,18722472523,Out > In
Feb 2020,38,45,3806,2457693321,434779754,2892473075,781,3490,2,2022913567,Out > In
Feb 2020,38,46,1,258686,477188,735874,1,1,1,218502,In > Out
Feb 2020,38,47,8,965312,4775383,5740695,3,8,2,3810071,In > Out
Feb 2020,38,48,1,52082,78689,130771,1,1,1,26607,In > Out
Feb 2020,38,49,11521,2304012486,339720038,2643732524,2,8124,2,1964292448,Out > In
Feb 2020,38,53,1,563571,1063882,1627453,1,1,1,500311,In > Out
Feb 2020,38,54,2,1270248,1927518,3197766,2,2,1,657270,In > Out
Feb 2020,38,55,4,4388589,6120070,10508659,4,4,2,1731481,In > Out
Feb 2020,38,56,4,535085,51894,586979,4,4,1,483191,Out > In
Feb 2020,4,106,35,3641474428,55735767,3697210195,3,25,34,3585738661,Out > In
Feb 2020,4,14,4,1478936,10438150,11917086,2,3,3,8959214,In > Out
Feb 2020,4,17,4,12244192,98603622,110847814,4,1,4,86359430,In > Out
Feb 2020,4,20,2,62090,192620,254710,2,2,2,130530,In > Out
Feb 2020,4,26,1,5436,132717,138153,1,1,1,127281,In > Out
Feb 2020,4,35,1,7996,187953,195949,1,1,1,179957,In > Out
Feb 2020,43,4,13,12608084,240747,12848831,1,13,1,12367337,Out > In
Feb 2020,44,102,1,4292,113095,117387,1,1,1,108803,In > Out
Feb 2020,44,107,1,6156,147783,153939,1,1,1,141627,In > Out
Feb 2020,44,115,1,4836,115154,119990,1,1,1,110318,In > Out
Feb 2020,44,117,4,22880,530217,553097,1,4,1,507337,In > Out
Feb 2020,44,12,4,19496,441086,460582,1,4,1,421590,In > Out
Feb 2020,44,123,1,4756,111662,116418,1,1,1,106906,In > Out
Feb 2020,44,131,1,4436,115584,120020,1,1,1,111148,In > Out
Feb 2020,44,132,2,10152,236298,246450,1,2,1,226146,In > Out
Feb 2020,44,135,1,6156,155025,161181,1,1,1,148869,In > Out
Feb 2020,44,140,5,29780,704816,734596,1,5,1,675036,In > Out
Feb 2020,44,142,2,7728,213186,220914,1,2,1,205458,In > Out
Feb 2020,44,149,4,22920,539802,562722,1,4,1,516882,In > Out
Feb 2020,44,157,3,20828,499893,520721,1,3,1,479065,In > Out
Feb 2020,44,160,2,12008,282161,294169,1,2,1,270153,In > Out
Feb 2020,44,174,1,4412,120961,125373,1,1,1,116549,In > Out
Feb 2020,44,176,1,4996,117119,122115,1,1,1,112123,In > Out
Feb 2020,44,178,4,19104,447355,466459,1,4,1,428251,In > Out
Feb 2020,44,180,1,6196,142941,149137,1,1,1,136745,In > Out
Feb 2020,44,186,2,7568,205589,213157,1,2,1,198021,In > Out
Feb 2020,44,195,6,32096,758870,790966,1,6,1,726774,In > Out
Feb 2020,44,199,2,8928,217116,226044,1,2,1,208188,In > Out
Feb 2020,44,213,2,9272,214684,223956,1,2,1,205412,In > Out
Feb 2020,44,215,2,9712,226741,236453,1,2,1,217029,In > Out
Feb 2020,44,216,3,12780,316823,329603,1,3,1,304043,In > Out
Feb 2020,44,221,3,13536,317826,331362,1,3,1,304290,In > Out
Feb 2020,44,232,1,4236,99336,103572,1,1,1,95100,In > Out
Feb 2020,44,238,4,17440,407600,425040,1,4,1,390160,In > Out
Feb 2020,44,25,1,3752,104495,108247,1,1,1,100743,In > Out
Feb 2020,44,26,49,187424106,476754452,664178558,45,44,23,289330346,In > Out
Feb 2020,44,28,55,263735587,853882097,1117617684,37,47,30,590146510,In > Out
Feb 2020,44,35,3,14708,335056,349764,1,3,1,320348,In > Out
Feb 2020,44,36,1,5316,125270,130586,1,1,1,119954,In > Out
Feb 2020,44,38,1,4876,134605,139481,1,1,1,129729,In > Out
Feb 2020,44,39,6,29244,701957,731201,1,6,1,672713,In > Out
Feb 2020,44,44,2,9248,231521,240769,1,2,1,222273,In > Out
Feb 2020,44,58,5,30992,734949,765941,1,5,1,703957,In > Out
Feb 2020,44,6,4,23104,552086,575190,1,4,1,528982,In > Out
Feb 2020,44,66,1,5236,128433,133669,1,1,1,123197,In > Out
Feb 2020,44,81,2,9180,209084,218264,1,2,1,199904,In > Out
Feb 2020,44,85,2,12660,306259,318919,1,2,1,293599,In > Out
Feb 2020,44,92,3,16564,387274,403838,1,3,1,370710,In > Out
Feb 2020,45,106,4,18984,433471,452455,1,4,1,414487,In > Out
Feb 2020,45,11,5,27304,648556,675860,1,5,1,621252,In > Out
Feb 2020,45,130,1,5716,129650,135366,1,1,1,123934,In > Out
Feb 2020,45,138,2,8592,202722,211314,1,2,1,194130,In > Out
Feb 2020,45,139,2,10836,270395,281231,1,2,1,259559,In > Out
Feb 2020,45,151,3,13348,315652,329000,1,3,1,302304,In > Out
Feb 2020,45,16,2,8300,210807,219107,1,2,1,202507,In > Out
Feb 2020,45,161,16,258422423,1089315501,1347737924,11,14,10,830893078,In > Out
Feb 2020,45,163,2,8672,205368,214040,1,2,1,196696,In > Out
Feb 2020,45,169,5,26980,633589,660569,1,5,1,606609,In > Out
Feb 2020,45,178,2,12552,305530,318082,1,2,1,292978,In > Out
Feb 2020,45,185,2,9988,235336,245324,1,2,1,225348,In > Out
Feb 2020,45,187,34,247279783,715456393,962736176,32,28,28,468176610,In > Out
Feb 2020,45,190,3,15188,355285,370473,1,3,1,340097,In > Out
Feb 2020,45,191,1,6124,147228,153352,1,1,1,141104,In > Out
Feb 2020,45,192,2,12152,285167,297319,1,2,1,273015,In > Out
Feb 2020,45,204,2,11632,273663,285295,1,2,1,262031,In > Out
Feb 2020,45,209,1,5744,130716,136460,1,1,1,124972,In > Out
Feb 2020,45,215,2,7768,208519,216287,1,2,1,200751,In > Out
Feb 2020,45,216,4,24544,574913,599457,1,4,1,550369,In > Out
Feb 2020,45,231,3,14788,330492,345280,1,3,1,315704,In > Out
Feb 2020,45,24,1,6876,160827,167703,1,1,1,153951,In > Out
Feb 2020,45,240,2,12232,286240,298472,1,2,1,274008,In > Out
Feb 2020,45,248,1,5316,125748,131064,1,1,1,120432,In > Out
Feb 2020,45,39,1,4784,100492,105276,1,1,1,95708,In > Out
Feb 2020,45,41,1,4996,124402,129398,1,1,1,119406,In > Out
Feb 2020,45,43,1,3972,115553,119525,1,1,1,111581,In > Out
Feb 2020,45,5,1,6144,152210,158354,1,1,1,146066,In > Out
Feb 2020,45,61,2,9368,231367,240735,1,2,1,221999,In > Out
Feb 2020,45,64,6,32576,761620,794196,1,6,1,729044,In > Out
Feb 2020,45,66,3,15244,360019,375263,1,3,1,344775,In > Out
Feb 2020,45,73,3,13988,328087,342075,1,3,1,314099,In > Out
Feb 2020,45,74,5,25348,582902,608250,1,5,1,557554,In > Out
Feb 2020,45,75,2,10672,253568,264240,1,2,1,242896,In > Out
Feb 2020,45,99,4,19224,443521,462745,1,4,1,424297,In > Out
Feb 2020,46,115,3,13692,318457,332149,1,3,1,304765,In > Out
Feb 2020,46,116,8,1970284,1937508,3907792,4,8,4,32776,Out > In
Feb 2020,46,125,1,4316,101637,105953,1,1,1,97321,In > Out
Feb 2020,46,127,7,27533332,107645192,135178524,7,7,7,80111860,In > Out
Feb 2020,46,137,1,3664,108000,111664,1,1,1,104336,In > Out
Feb 2020,46,139,1,5156,129588,134744,1,1,1,124432,In > Out
Feb 2020,46,149,1,4012,101996,106008,1,1,1,97984,In > Out
Feb 2020,46,152,33,6732202,6871095,13603297,2,1,33,138893,In > Out
Feb 2020,46,154,1,4224,98758,102982,1,1,1,94534,In > Out
Feb 2020,46,166,6,36896,879556,916452,1,6,1,842660,In > Out
Feb 2020,46,171,2,9192,215671,224863,1,2,1,206479,In > Out
Feb 2020,46,173,1,4876,113324,118200,1,1,1,108448,In > Out
Feb 2020,46,18,2,72846,367473,440319,2,2,2,294627,In > Out
Feb 2020,46,183,73,249698353,194121734,443820087,65,73,73,55576619,Out > In
Feb 2020,46,186,1,4596,107706,112302,1,1,1,103110,In > Out
Feb 2020,46,196,2,13192,313139,326331,1,2,1,299947,In > Out
Feb 2020,46,197,5,27976,655144,683120,1,5,1,627168,In > Out
Feb 2020,46,208,2,7516,217405,224921,1,2,1,209889,In > Out
Feb 2020,46,210,23,83544856,77335113,160879969,22,19,7,6209743,Out > In
Feb 2020,46,212,3,15072,392630,407702,1,3,1,377558,In > Out
Feb 2020,46,215,49,67034808,150496684,217531492,45,45,17,83461876,In > Out
Feb 2020,46,221,2,11734128,15442200,27176328,2,1,1,3708072,In > Out
Feb 2020,46,246,1,4584,117052,121636,1,1,1,112468,In > Out
Feb 2020,46,28,186,305976287,337658832,643635119,175,69,6,31682545,In > Out
Feb 2020,46,29,88,319887191,779937015,1099824206,69,32,20,460049824,In > Out
Feb 2020,46,33,6,28408,680525,708933,1,6,1,652117,In > Out
Feb 2020,46,45,3,15496,363448,378944,1,3,1,347952,In > Out
Feb 2020,46,46,1,4236,100044,104280,1,1,1,95808,In > Out
Feb 2020,46,48,1,120120,83620,203740,1,1,1,36500,Out > In
Feb 2020,46,52,1,6732,162487,169219,1,1,1,155755,In > Out
Feb 2020,46,55,1,154330,107004,261334,1,1,1,47326,Out > In
Feb 2020,46,57,1,24232334,19571923,43804257,1,1,1,4660411,Out > In
Feb 2020,46,61,2,11620,279571,291191,1,2,1,267951,In > Out
Feb 2020,46,64,2,9352,211856,221208,1,2,1,202504,In > Out
Feb 2020,46,7,1,5236,122336,127572,1,1,1,117100,In > Out
Feb 2020,46,76,78,200043414,393925188,593968602,65,52,54,193881774,In > Out
Feb 2020,46,8,1,5104,136328,141432,1,1,1,131224,In > Out
Feb 2020,46,9,2,11072,268081,279153,1,2,1,257009,In > Out
Feb 2020,46,91,1,5276,122787,128063,1,1,1,117511,In > Out
Feb 2020,47,105,1,6116,144337,150453,1,1,1,138221,In > Out
Feb 2020,47,12,1,6076,135440,141516,1,1,1,129364,In > Out
Feb 2020,47,125,2,9232,218574,227806,1,2,1,209342,In > Out
Feb 2020,47,128,1,5556,127686,133242,1,1,1,122130,In > Out
Feb 2020,47,131,1,5104,112340,117444,1,1,1,107236,In > Out
Feb 2020,47,132,1,4756,114592,119348,1,1,1,109836,In > Out
Feb 2020,47,146,1,6356,147383,153739,1,1,1,141027,In > Out
Feb 2020,47,152,1,4984,125812,130796,1,1,1,120828,In > Out
Feb 2020,47,168,2,10020,261814,271834,1,2,1,251794,In > Out
Feb 2020,47,173,3,12444,305041,317485,1,3,1,292597,In > Out
Feb 2020,47,179,1,4356,105834,110190,1,1,1,101478,In > Out
Feb 2020,47,186,10,45828,1077644,1123472,1,10,1,1031816,In > Out
Feb 2020,47,191,3,18028,423253,441281,1,3,1,405225,In > Out
Feb 2020,47,194,10,58216,1356911,1415127,1,10,1,1298695,In > Out
Feb 2020,47,195,1,7716,178835,186551,1,1,1,171119,In > Out
Feb 2020,47,212,1,6796,162222,169018,1,1,1,155426,In > Out
Feb 2020,47,218,1,8256,188608,196864,1,1,1,180352,In > Out
Feb 2020,47,230,2,9392,232715,242107,1,2,1,223323,In > Out
Feb 2020,47,240,1,4236,102878,107114,1,1,1,98642,In > Out
Feb 2020,47,243,2,9556,228502,238058,1,2,1,218946,In > Out
Feb 2020,47,245,1,4944,117518,122462,1,1,1,112574,In > Out
Feb 2020,47,250,1,5704,136134,141838,1,1,1,130430,In > Out
Feb 2020,47,251,1,5236,137627,142863,1,1,1,132391,In > Out
Feb 2020,47,26,1,4836,113071,117907,1,1,1,108235,In > Out
Feb 2020,47,27,8,41052,960867,1001919,1,8,1,919815,In > Out
Feb 2020,47,30,1,5196,120760,125956,1,1,1,115564,In > Out
Feb 2020,47,39,2,10620,259386,270006,1,2,1,248766,In > Out
Feb 2020,47,40,3,15188,364095,379283,1,3,1,348907,In > Out
Feb 2020,47,51,7,32600,794785,827385,1,7,1,762185,In > Out
Feb 2020,47,58,1,4064,103383,107447,1,1,1,99319,In > Out
Feb 2020,47,63,4,18960,464534,483494,1,4,1,445574,In > Out
Feb 2020,47,81,1,3544,102732,106276,1,1,1,99188,In > Out
Feb 2020,47,91,1,3944,109672,113616,1,1,1,105728,In > Out
Feb 2020,47,97,6,32656,768801,801457,1,6,1,736145,In > Out
Feb 2020,48,112,1,6532,152140,158672,1,1,1,145608,In > Out
Feb 2020,48,114,3,13644,348736,362380,1,3,1,335092,In > Out
Feb 2020,48,122,2,14832,351687,366519,1,2,1,336855,In > Out
Feb 2020,48,125,1,6596,162462,169058,1,1,1,155866,In > Out
Feb 2020,48,128,1,4396,105459,109855,1,1,1,101063,In > Out
Feb 2020,48,151,1,7396,170296,177692,1,1,1,162900,In > Out
Feb 2020,48,158,3,12952,362199,375151,1,3,1,349247,In > Out
Feb 2020,48,16,2,9072,210896,219968,1,2,1,201824,In > Out
Feb 2020,48,194,2,12712,297650,310362,1,2,1,284938,In > Out
Feb 2020,48,197,1,5076,116238,121314,1,1,1,111162,In > Out
Feb 2020,48,198,2,7648,216843,224491,1,2,1,209195,In > Out
Feb 2020,48,199,2,12712,299558,312270,1,2,1,286846,In > Out
Feb 2020,48,209,12,62512,1470565,1533077,1,12,1,1408053,In > Out
Feb 2020,48,215,2,13728,322893,336621,1,2,1,309165,In > Out
Feb 2020,48,216,4,16164,429128,445292,1,4,1,412964,In > Out
Feb 2020,48,233,3,14948,352145,367093,1,3,1,337197,In > Out
Feb 2020,48,239,1,3624,104789,108413,1,1,1,101165,In > Out
Feb 2020,48,240,1,3932,102352,106284,1,1,1,98420,In > Out
Feb 2020,48,247,2,10872,255015,265887,1,2,1,244143,In > Out
Feb 2020,48,30,2,7784,228249,236033,1,2,1,220465,In > Out
Feb 2020,48,36,2,7716,200342,208058,1,2,1,192626,In > Out
Feb 2020,48,40,1,3984,103463,107447,1,1,1,99479,In > Out
Feb 2020,48,44,1,5276,125794,131070,1,1,1,120518,In > Out
Feb 2020,48,45,4,18720,465018,483738,1,4,1,446298,In > Out
Feb 2020,48,50,2,3340854,3607885,6948739,1,1,1,267031,In > Out
Feb 2020,48,54,1,5196,118376,123572,1,1,1,113180,In > Out
Feb 2020,48,61,1,5556,124713,130269,1,1,1,119157,In > Out
Feb 2020,48,62,1,3944,104098,108042,1,1,1,100154,In > Out
Feb 2020,48,73,1,3624,101616,105240,1,1,1,97992,In > Out
Feb 2020,48,85,1,6116,144081,150197,1,1,1,137965,In > Out
Feb 2020,48,9,2,9112,212772,221884,1,2,1,203660,In > Out
Feb 2020,48,92,44,620344269,1850088956,2470433225,40,42,41,1229744687,In > Out
Feb 2020,48,93,1,6596,163627,170223,1,1,1,157031,In > Out
Feb 2020,49,113,60,233982786,502423633,736406419,6,5,58,268440847,In > Out
Feb 2020,49,114,99,487152399,430843917,917996316,40,40,90,56308482,Out > In
Feb 2020,49,115,220,36609925,169995606,206605531,6,87,214,133385681,In > Out
Feb 2020,49,116,48,152550231,275845436,428395667,6,5,46,123295205,In > Out
Feb 2020,49,117,71,118561282,304489867,423051149,7,9,71,185928585,In > Out
Feb 2020,49,118,29,13028109,220435785,233463894,7,5,28,207407676,In > Out
Feb 2020,49,119,40,171880042,163541297,335421339,7,5,37,8338745,Out > In
Feb 2020,49,120,350,553715585,428125400,981840985,10,10,345,125590185,Out > In
Feb 2020,49,121,74,132627952,245368276,377996228,6,4,72,112740324,In > Out
Feb 2020,49,122,32,17315374,106628626,123944000,3,2,31,89313252,In > Out
Feb 2020,49,123,54,630210827,958000572,1588211399,9,12,51,327789745,In > Out
Feb 2020,49,124,36,341827473,202141269,543968742,9,7,35,139686204,Out > In
Feb 2020,49,125,107,88737480,3162662266,3251399746,35,84,106,3073924786,In > Out
Feb 2020,49,126,87,364125611,3078771449,3442897060,34,68,87,2714645838,In > Out
Feb 2020,49,196,1277,148368878478,55467634060,203836512538,566,1240,1,92901244418,Out > In
Feb 2020,49,212,319,41173612075,7777722283,48951334358,189,317,1,33395889792,Out > In
Feb 2020,49,244,39,5365272,6048332,11413604,5,1,1,683060,In > Out
Feb 2020,5,13,1,4476,104123,108599,1,1,1,99647,In > Out
Feb 2020,5,16,288,1231914118,4543112118,5775026236,102,287,1,3311198000,In > Out
Feb 2020,5,19,126,82407799,56261794,138669593,59,126,2,26146005,Out > In
Feb 2020,5,22,26,9362810,11447885,20810695,5,25,3,2085075,In > Out
Feb 2020,5,24,1,7756,181955,189711,1,1,1,174199,In > Out
Feb 2020,5,25,94,270679497,205976101,476655598,18,94,16,64703396,Out > In
Feb 2020,5,27,58,66533174,501767,67034941,2,58,16,66031407,Out > In
Feb 2020,5,7,2,13912,328300,342212,1,2,1,314388,In > Out
Feb 2020,5,75,4,17840,414788,432628,1,4,1,396948,In > Out
Feb 2020,5,9,1,5716,134775,140491,1,1,1,129059,In > Out
Feb 2020,51,10,17,3499694,7463141,10962835,6,17,1,3963447,In > Out
Feb 2020,51,154,41,7557992,1028495901,1036053893,1,41,41,1020937909,In > Out
Feb 2020,51,156,1,1016723,12847501,13864224,1,1,1,11830778,In > Out
Feb 2020,51,162,2,127960992,30303820,158264812,2,1,2,97657172,Out > In
Feb 2020,51,165,4,777649,3750890,4528539,3,1,4,2973241,In > Out
Feb 2020,51,182,2230,19931728882,752803707,20684532589,134,1863,400,19178925175,Out > In
Feb 2020,51,183,3,202095,191970,394065,1,1,1,10125,Out > In
Feb 2020,51,232,1,15333262,61064,15394326,1,1,1,15272198,Out > In
Feb 2020,51,30,7,1990500449,17701767,2008202216,2,7,7,1972798682,Out > In
Feb 2020,52,10,609,1630380005,162901817,1793281822,98,599,5,1467478188,Out > In
Feb 2020,52,113,5,7306421,1181188,8487609,1,5,2,6125233,Out > In
Feb 2020,52,118,5,1474689,181551,1656240,2,5,1,1293138,Out > In
Feb 2020,52,119,4,6498712,2600661,9099373,2,4,4,3898051,Out > In
Feb 2020,52,12,334,2353444168,52192544,2405636712,12,332,2,2301251624,Out > In
Feb 2020,52,120,6,63772852,727531278,791304130,5,6,4,663758426,In > Out
Feb 2020,52,149,25,1914856,4325440,6240296,1,1,1,2410584,In > Out
Feb 2020,52,15,18,2002747,911862,2914609,4,18,3,1090885,Out > In
Feb 2020,52,16,49,8756603,3464976,12221579,4,40,1,5291627,Out > In
Feb 2020,52,163,1,149495,76960,226455,1,1,1,72535,Out > In
Feb 2020,52,172,19,2405776,842416,3248192,2,19,1,1563360,Out > In
Feb 2020,52,24,1,101551,3503,105054,1,1,1,98048,Out > In
Feb 2020,52,251,2,5653084,1158160,6811244,2,2,2,4494924,Out > In
Feb 2020,52,252,1,132255,3863,136118,1,1,1,128392,Out > In
Feb 2020,52,29,2125,134583627885,861008937,135444636822,286,2076,2,133722618948,Out > In
Feb 2020,52,4,4,626265,241311,867576,2,4,1,384954,Out > In
Feb 2020,52,95,2,9118066,47960295,57078361,2,2,2,38842229,In > Out
Feb 2020,53,169,7,34884591,17858979,52743570,6,7,7,17025612,Out > In
Feb 2020,53,184,4,391247455,32243236,423490691,1,4,4,359004219,Out > In
Feb 2020,53,28,10,641263,435144,1076407,10,10,1,206119,Out > In
Feb 2020,54,12,12,2382625,414504,2797129,9,12,2,1968121,Out > In
Feb 2020,55,104,7,398480811,122455734,520936545,3,6,7,276025077,Out > In
Feb 2020,55,121,3,479232,160158135,160637367,1,1,3,159678903,In > Out
Feb 2020,55,130,3813,16463845431,86213363,16550058794,983,3558,1,16377632068,Out > In
Feb 2020,55,137,4,508209,219477,727686,3,4,1,288732,Out > In
Feb 2020,55,143,3,466825,218689,685514,2,3,1,248136,Out > In
Feb 2020,55,9,2,326076,14256,340332,1,2,1,311820,Out > In
Feb 2020,55,96,4,1308426871,47360828,1355787699,3,4,1,1261066043,Out > In
Feb 2020,56,132,1,84714,2466384,2551098,1,1,1,2381670,In > Out
Feb 2020,56,154,7,287336,1413581,1700917,6,1,7,1126245,In > Out
Feb 2020,56,163,2,809565,3480015,4289580,1,2,2,2670450,In > Out
Feb 2020,56,249,1,142054268,497767984,639822252,1,1,1,355713716,In > Out
Feb 2020,57,129,485,265011621,23651985,288663606,84,282,1,241359636,Out > In
Feb 2020,57,131,3349,2283952669,72519504,2356472173,120,2995,3,2211433165,Out > In
Feb 2020,57,152,13,1437954,46074,1484028,8,13,1,1391880,Out > In
Feb 2020,57,180,17,121967820,2005566,123973386,1,2,17,119962254,Out > In
Feb 2020,58,212,1,398540338,325996788,724537126,1,1,1,72543550,Out > In
Feb 2020,58,218,1,44705,168169,212874,1,1,1,123464,In > Out
Feb 2020,58,224,1,8331069,1654497,9985566,1,1,1,6676572,Out > In
Feb 2020,58,234,3,1240424866,1683252516,2923677382,3,3,3,442827650,In > Out
Feb 2020,58,237,1,311781,869933,1181714,1,1,1,558152,In > Out
Feb 2020,59,16,8703,6902154194,2888750584,9790904778,543,7672,2,4013403610,Out > In
Feb 2020,59,18,117,1582731418,2019628039,3602359457,48,110,37,436896621,In > Out
Feb 2020,59,19,6306,4461581801,1892242765,6353824566,560,5736,3,2569339036,Out > In
Feb 2020,59,21,84,2255134315,1778356776,4033491091,48,82,41,476777539,Out > In
Feb 2020,60,16,40,5937805,9248255,15186060,1,40,1,3310450,In > Out
Feb 2020,60,17,1,754158,1103856,1858014,1,1,1,349698,In > Out
Feb 2020,60,24,4,554435,46586,601021,3,4,1,507849,Out > In
Feb 2020,60,27,1184,406640816,125814077,532454893,299,1163,1,280826739,Out > In
Feb 2020,60,31,1982,533237012,38776349,572013361,1001,1912,2,494460663,Out > In
Feb 2020,60,35,4280,1903884766,846910339,2750795105,780,3977,1,1056974427,Out > In
Feb 2020,60,38,17,2940529,70453,3010982,17,17,1,2870076,Out > In
Feb 2020,60,43,46,8754767,247973,9002740,38,46,2,8506794,Out > In
Feb 2020,60,44,3735,4592262757,189348246,4781611003,363,3405,1,4402914511,Out > In
Feb 2020,60,45,4,1853675,490706,2344381,2,4,1,1362969,Out > In
Feb 2020,60,47,2,125494,260005,385499,1,2,1,134511,In > Out
Feb 2020,60,48,2,140122,266737,406859,1,2,1,126615,In > Out
Feb 2020,60,49,99,108381156,29177947,137559103,2,99,2,79203209,Out > In
Feb 2020,60,52,2,764385,1084660,1849045,2,2,1,320275,In > Out
Feb 2020,60,54,20,3102669,137395,3240064,9,20,1,2965274,Out > In
Feb 2020,60,56,1,95523,174130,269653,1,1,1,78607,In > Out
Feb 2020,60,66,228,64069852,28094090,92163942,65,225,2,35975762,Out > In
Feb 2020,60,69,23,141457145,4044015,145501160,4,23,2,137413130,Out > In
Feb 2020,60,70,4,460966,26863,487829,3,4,1,434103,Out > In
Feb 2020,60,71,2,598383,926956,1525339,2,2,1,328573,In > Out
Feb 2020,60,72,6,1211315,654768,1866083,2,6,2,556547,Out > In
Feb 2020,60,76,1205,1231755999,165525434,1397281433,287,1183,2,1066230565,Out > In
Feb 2020,60,77,2,218759,117642,336401,1,2,1,101117,Out > In
Feb 2020,60,80,2,96505,165962,262467,2,2,1,69457,In > Out
Feb 2020,60,83,64,117828055,27931651,145759706,24,64,2,89896404,Out > In
Feb 2020,60,87,54,7650433,255108,7905541,45,54,1,7395325,Out > In
Feb 2020,60,88,6,642146,305036,947182,4,6,2,337110,Out > In
Feb 2020,60,89,1,41959,65183,107142,1,1,1,23224,In > Out
Feb 2020,63,149,2,242363,820242,1062605,2,1,2,577879,In > Out
Feb 2020,65,122,5,4748243376,7086238933,11834482309,1,5,1,2337995557,In > Out
Feb 2020,65,21,3,82010356,1743020,83753376,1,1,3,80267336,Out > In
Feb 2020,65,226,2714,706662638,72444204,779106842,40,2627,3,634218434,Out > In
Feb 2020,65,23,9,89513970,242082506,331596476,1,1,9,152568536,In > Out
Feb 2020,65,32,1,4848061,8056345,12904406,1,1,1,3208284,In > Out
Feb 2020,65,99,1,15962400,307124,16269524,1,1,1,15655276,Out > In
Feb 2020,7,1,3,13696,317474,331170,1,3,1,303778,In > Out
Feb 2020,7,11,3,505348,145236,650584,2,3,2,360112,Out > In
Feb 2020,7,119,10,1887408431,1435189421,3322597852,7,9,9,452219010,Out > In
Feb 2020,7,12,4,735172716,1128431963,1863604679,4,4,4,393259247,In > Out
Feb 2020,7,129,804,508822560,29049304,537871864,93,789,3,479773256,Out > In
Feb 2020,7,15,3,20953968,1546778,22500746,2,3,2,19407190,Out > In
Feb 2020,7,165,3,23638262,6882292,30520554,1,3,1,16755970,Out > In
Feb 2020,7,186,9,828362,654975,1483337,5,9,3,173387,Out > In
Feb 2020,7,20,3,16868,393053,409921,1,3,1,376185,In > Out
Feb 2020,7,213,1,453982,14710643,15164625,1,1,1,14256661,In > Out
Feb 2020,7,35,8,3187366,166315,3353681,5,8,1,3021051,Out > In
Feb 2020,7,37,4,23004,518036,541040,1,4,1,495032,In > Out
Feb 2020,7,42,24,21564248,267600,21831848,20,24,1,21296648,Out > In
Feb 2020,7,50,63,10316544,3880782,14197326,4,45,1,6435762,Out > In
Feb 2020,7,56,1,40498677,14789338,55288015,1,1,1,25709339,Out > In
Feb 2020,7,64,1,4824,132128,136952,1,1,1,127304,In > Out
Feb 2020,7,69,281,1171079631,14147355,1185226986,133,281,1,1156932276,Out > In
Feb 2020,7,77,60,37215239,16690622,53905861,46,55,3,20524617,Out > In
Feb 2020,7,91,2,509006,197011,706017,1,2,1,311995,Out > In
Feb 2020,70,10,3,103054809,121541601,224596410,2,3,3,18486792,In > Out
Feb 2020,70,100,1,116855,630661,747516,1,1,1,513806,In > Out
Feb 2020,70,103,1,139835636,521304621,661140257,1,1,1,381468985,In > Out
Feb 2020,70,104,8,8949807,7473532,16423339,2,8,5,1476275,Out > In
Feb 2020,70,106,2,15511304,4985008,20496312,1,2,2,10526296,Out > In
Feb 2020,70,108,5,2813757798,1483431109,4297188907,2,5,5,1330326689,Out > In
Feb 2020,70,11,1,1836243,2398050,4234293,1,1,1,561807,In > Out
Feb 2020,70,113,10,25162692,117056463,142219155,3,9,6,91893771,In > Out
Feb 2020,70,114,3,31673588,72015352,103688940,3,2,3,40341764,In > Out
Feb 2020,70,121,3,76373454,95238236,171611690,3,3,3,18864782,In > Out
Feb 2020,70,124,5,37376501,9213139,46589640,4,5,4,28163362,Out > In
Feb 2020,70,125,23,34135093,5187678,39322771,23,23,5,28947415,Out > In
Feb 2020,70,128,1,12146991,21124706,33271697,1,1,1,8977715,In > Out
Feb 2020,70,131,4,529006,2010919,2539925,1,4,4,1481913,In > Out
Feb 2020,70,134,1024,82609053,1650827142,1733436195,281,531,3,1568218089,In > Out
Feb 2020,70,135,3,10494417,11550904,22045321,3,2,1,1056487,In > Out
Feb 2020,70,136,4,10037520,9120645,19158165,4,4,4,916875,Out > In
Feb 2020,70,138,2,97823816,98290237,196114053,2,2,2,466421,In > Out
Feb 2020,70,14,1,477060882,223072805,700133687,1,1,1,253988077,Out > In
Feb 2020,70,140,2,1725002523,6565176771,8290179294,2,2,2,4840174248,In > Out
Feb 2020,70,142,1,24626206,23697567,48323773,1,1,1,928639,Out > In
Feb 2020,70,143,1,99232,215945,315177,1,1,1,116713,In > Out
Feb 2020,70,148,7,351103,8766356,9117459,2,2,7,8415253,In > Out
Feb 2020,70,149,644,24143975,491554411,515698386,240,335,3,467410436,In > Out
Feb 2020,70,15,8,301920051,98856907,400776958,5,8,5,203063144,Out > In
Feb 2020,70,158,7,459186112,477012862,936198974,3,6,3,17826750,In > Out
Feb 2020,70,159,1,207924,10356044,10563968,1,1,1,10148120,In > Out
Feb 2020,70,165,3,4043910,8563730,12607640,3,3,3,4519820,In > Out
Feb 2020,70,168,2,159581,1508459,1668040,1,1,2,1348878,In > Out
Feb 2020,70,169,1,32102,106237,138339,1,1,1,74135,In > Out
Feb 2020,70,171,14,6064795,9269753,15334548,14,5,1,3204958,In > Out
Feb 2020,70,174,21,515407545,454854999,970262544,16,16,3,60552546,Out > In
Feb 2020,70,175,716,13560439062,3487353864,17047792926,577,510,3,10073085198,Out > In
Feb 2020,70,178,3,57875703,29222384,87098087,3,3,3,28653319,Out > In
Feb 2020,70,183,1,39135242,27340872,66476114,1,1,1,11794370,Out > In
Feb 2020,70,187,17,26809540,214024852,240834392,13,14,10,187215312,In > Out
Feb 2020,70,19,2,50639775,189890390,240530165,1,2,2,139250615,In > Out
Feb 2020,70,193,13,380417266,247140073,627557339,6,13,8,133277193,Out > In
Feb 2020,70,197,2,187648175,18424034,206072209,2,2,2,169224141,Out > In
Feb 2020,70,20,2,570474813,223005349,793480162,1,2,2,347469464,Out > In
Feb 2020,70,200,1,139518,160462,299980,1,1,1,20944,In > Out
Feb 2020,70,201,1,69157,3377160,3446317,1,1,1,3308003,In > Out
Feb 2020,70,206,6,24684065,78171681,102855746,6,6,4,53487616,In > Out
Feb 2020,70,207,2,897123,6176445,7073568,2,2,2,5279322,In > Out
Feb 2020,70,209,3,821669,746059,1567728,3,3,3,75610,Out > In
Feb 2020,70,210,8,83765829,63820036,147585865,7,8,7,19945793,Out > In
Feb 2020,70,211,1,39448,76823,116271,1,1,1,37375,In > Out
Feb 2020,70,214,263,2313054334,590056228,2903110562,200,105,3,1722998106,Out > In
Feb 2020,70,216,2,74796,330065,404861,2,2,2,255269,In > Out
Feb 2020,70,217,2,283006,2249318,2532324,2,2,2,1966312,In > Out
Feb 2020,70,222,2,483944808,403811068,887755876,2,2,1,80133740,Out > In
Feb 2020,70,26,2,991691,1148234,2139925,2,2,2,156543,In > Out
Feb 2020,70,27,4,197638,546292,743930,4,3,3,348654,In > Out
Feb 2020,70,28,2,5703925,5074509,10778434,2,2,2,629416,Out > In
Feb 2020,70,33,4,357290622,217912053,575202675,4,4,4,139378569,Out > In
Feb 2020,70,34,5,16822476,60137746,76960222,4,4,5,43315270,In > Out
Feb 2020,70,35,1,8398,294732,303130,1,1,1,286334,In > Out
Feb 2020,70,37,37,1066100,28803888,29869988,34,37,1,27737788,In > Out
Feb 2020,70,39,1,9574924,11107141,20682065,1,1,1,1532217,In > Out
Feb 2020,70,4,7,229702211,311901541,541603752,2,3,1,82199330,In > Out
Feb 2020,70,40,2,1108949,1573482,2682431,2,2,2,464533,In > Out
Feb 2020,70,43,1,14598024,8408187,23006211,1,1,1,6189837,Out > In
Feb 2020,70,44,12,291503702,320786650,612290352,5,12,11,29282948,In > Out
Feb 2020,70,45,1,610224,646107,1256331,1,1,1,35883,In > Out
Feb 2020,70,48,1,386458,341470,727928,1,1,1,44988,Out > In
Feb 2020,70,51,2,47731314,41138065,88869379,2,2,1,6593249,Out > In
Feb 2020,70,56,6,82245130,75134390,157379520,5,5,6,7110740,Out > In
Feb 2020,70,6,1,120581,54494,175075,1,1,1,66087,Out > In
Feb 2020,70,61,2,22784952,11617731,34402683,2,2,1,11167221,Out > In
Feb 2020,70,66,9,5814737,27098292,32913029,9,7,9,21283555,In > Out
Feb 2020,70,67,5,237518193,451202603,688720796,2,5,3,213684410,In > Out
Feb 2020,70,7,1,75602,125530,201132,1,1,1,49928,In > Out
Feb 2020,70,70,28,336945,8863336,9200281,28,28,2,8526391,In > Out
Feb 2020,70,72,4,18860964,473386569,492247533,4,3,4,454525605,In > Out
Feb 2020,70,75,17,113552,4191850,4305402,17,16,4,4078298,In > Out
Feb 2020,70,76,2,104130,583211,687341,2,2,2,479081,In > Out
Feb 2020,70,77,3,477140643,500502679,977643322,3,3,3,23362036,In > Out
Feb 2020,70,79,4,82339980,43807795,126147775,4,3,4,38532185,Out > In
Feb 2020,70,83,4,17952,928560,946512,4,4,1,910608,In > Out
Feb 2020,70,85,1,41965554,683328,42648882,1,1,1,41282226,Out > In
Feb 2020,70,94,5,2205782,5157472,7363254,5,5,3,2951690,In > Out
Feb 2020,70,95,4,2721327,4353081,7074408,4,4,4,1631754,In > Out
Feb 2020,72,101,5,331336,229880,561216,5,5,1,101456,Out > In
Feb 2020,72,123,12,7541834,2382400,9924234,6,12,2,5159434,Out > In
Feb 2020,72,133,1,227001,5840,232841,1,1,1,221161,Out > In
Feb 2020,72,138,5,1425540,54283,1479823,4,5,1,1371257,Out > In
Feb 2020,72,144,2,181997,139815,321812,2,2,2,42182,Out > In
Feb 2020,72,148,1,131885,4687,136572,1,1,1,127198,Out > In
Feb 2020,72,184,2,115760,209330,325090,1,2,1,93570,In > Out
Feb 2020,72,19,25,5195130,235838,5430968,17,25,2,4959292,Out > In
Feb 2020,72,20,1,58613,108993,167606,1,1,1,50380,In > Out
Feb 2020,72,22,1,58970,99909,158879,1,1,1,40939,In > Out
Feb 2020,72,24,2,386351,10391,396742,1,2,1,375960,Out > In
Feb 2020,72,55,1,276511,6324,282835,1,1,1,270187,Out > In
Feb 2020,72,56,1,41202,124698,165900,1,1,1,83496,In > Out
Feb 2020,72,57,2,649891,18667,668558,1,2,2,631224,Out > In
Feb 2020,72,61,1,55160,80806,135966,1,1,1,25646,In > Out
Feb 2020,72,63,1,105721,17800,123521,1,1,1,87921,Out > In
Feb 2020,72,70,1,54489,75669,130158,1,1,1,21180,In > Out
Feb 2020,72,76,1,58719,100038,158757,1,1,1,41319,In > Out
Feb 2020,72,83,1,29710,80225,109935,1,1,1,50515,In > Out
Feb 2020,73,10,28377,31567694443,797941036,32365635479,6191,19748,3,30769753407,Out > In
Feb 2020,73,113,3,325017,20509,345526,1,1,3,304508,Out > In
Feb 2020,73,14,1356,2910017252,66599790,2976617042,282,1332,1,2843417462,Out > In
Feb 2020,73,142,12,3123921,24177559,27301480,4,2,12,21053638,In > Out
Feb 2020,73,148,57,8353838,3153753,11507591,8,54,2,5200085,Out > In
Feb 2020,73,149,4,412005,254163,666168,3,4,1,157842,Out > In
Feb 2020,73,157,333,227044466,73235296,300279762,59,239,2,153809170,Out > In
Feb 2020,73,163,2,7789276,29424185,37213461,2,1,2,21634909,In > Out
Feb 2020,73,166,49,86837148,1536051,88373199,38,49,2,85301097,Out > In
Feb 2020,73,167,5,718599,361514,1080113,2,5,1,357085,Out > In
Feb 2020,73,181,66,2141655839,3242071065,5383726904,60,58,63,1100415226,In > Out
Feb 2020,73,198,1,97360,23636,120996,1,1,1,73724,Out > In
Feb 2020,73,201,6,488024,2183350,2671374,4,3,6,1695326,In > Out
Feb 2020,73,211,1,11989,93359,105348,1,1,1,81370,In > Out
Feb 2020,73,217,11,16038315,4301430,20339745,3,11,1,11736885,Out > In
Feb 2020,73,237,26589,108627329612,2154757892,110782087504,3982,9530,2,106472571720,Out > In
Feb 2020,73,24,71,15962410,2925250,18887660,45,71,1,13037160,Out > In
Feb 2020,73,246,2,279639,343223,622862,1,1,2,63584,In > Out
Feb 2020,73,31,417,1857867120,442529578,2300396698,218,185,1,1415337542,Out > In
Feb 2020,73,32,426,2028750840,485115517,2513866357,221,188,1,1543635323,Out > In
Feb 2020,73,41,1,2552749,41088503,43641252,1,1,1,38535754,In > Out
Feb 2020,73,62,1,171879,13382,185261,1,1,1,158497,Out > In
Feb 2020,73,66,1,384138,20324,404462,1,1,1,363814,Out > In
Feb 2020,73,78,2,241814,20875,262689,2,1,2,220939,Out > In
Feb 2020,73,8,62,42732653,834036,43566689,39,62,1,41898617,Out > In
Feb 2020,73,9,42,32353847,12155389,44509236,2,42,1,20198458,Out > In
Feb 2020,74,107,3,108768241,197887262,306655503,3,2,3,89119021,In > Out
Feb 2020,74,114,1,28328,482711,511039,1,1,1,454383,In > Out
Feb 2020,74,12,1,235016,98325,333341,1,1,1,136691,Out > In
Feb 2020,74,141,24,117875250,14765594,132640844,19,19,2,103109656,Out > In
Feb 2020,74,149,1,889164,1596574,2485738,1,1,1,707410,In > Out
Feb 2020,74,152,24,3263946,1015920,4279866,3,23,2,2248026,Out > In
Feb 2020,74,154,27,2998892,1101638,4100530,4,27,1,1897254,Out > In
Feb 2020,74,155,33,5011641,1108796,6120437,5,31,2,3902845,Out > In
Feb 2020,74,170,1,594407,1819778,2414185,1,1,1,1225371,In > Out
Feb 2020,74,179,1,1202247,1125321,2327568,1,1,1,76926,Out > In
Feb 2020,74,198,1,456350,1666124,2122474,1,1,1,1209774,In > Out
Feb 2020,74,206,762,1456917784,6620390970,8077308754,121,194,3,5163473186,In > Out
Feb 2020,74,210,14,252374962,126831231,379206193,1,1,1,125543731,Out > In
Feb 2020,74,230,17,2073978,793354,2867332,2,17,1,1280624,Out > In
Feb 2020,74,24,5,135505081,2646402,138151483,4,5,1,132858679,Out > In
Feb 2020,74,240,1,984533,23773326,24757859,1,1,1,22788793,In > Out
Feb 2020,74,41,1,36316,135266,171582,1,1,1,98950,In > Out
Feb 2020,74,45,33,4506007,1434006,5940013,4,31,3,3072001,Out > In
Feb 2020,74,52,243,362567478,58210935,420778413,154,132,2,304356543,Out > In
Feb 2020,77,120,37,29915303,3625304,33540607,12,14,2,26289999,Out > In
Feb 2020,77,121,1,45493,81916,127409,1,1,1,36423,In > Out
Feb 2020,77,122,1621,197050947,195223995,392274942,4,12,1,1826952,Out > In
Feb 2020,77,231,4,14882500,29874261,44756761,4,4,4,14991761,In > Out
Feb 2020,79,11,265,23510742,3117559161,3141069903,2,7,265,3094048419,In > Out
Feb 2020,79,12,31,1109183752,72383279,1181567031,7,31,1,1036800473,Out > In
Feb 2020,79,13,29,14089737,34759797,48849534,1,29,1,20670060,In > Out
Feb 2020,79,14,7,20227884,1629224258,1649452142,3,7,7,1608996374,In > Out
Feb 2020,79,9,3,625196,8279,633475,3,3,1,616917,Out > In
Feb 2020,80,149,1,108613,871984,980597,1,1,1,763371,In > Out
Feb 2020,80,224,5,98417,2615038,2713455,5,5,1,2516621,In > Out
Feb 2020,80,51,1,23736,141609,165345,1,1,1,117873,In > Out
Feb 2020,81,140,24386,17379852487,8520138183,25899990670,1255,13679,1,8859714304,Out > In
Feb 2020,82,116,4,356078509,179177252,535255761,4,3,4,176901257,Out > In
Feb 2020,82,167,12,52749175,5850610,58599785,1,12,1,46898565,Out > In
Feb 2020,82,204,2,171923,38132,210055,2,2,2,133791,Out > In
Feb 2020,82,239,19,2163337,830946,2994283,3,18,1,1332391,Out > In
Feb 2020,82,56,1,26803,563865,590668,1,1,1,537062,In > Out
Feb 2020,82,58,11,18853486,4942589,23796075,1,11,1,13910897,Out > In
Feb 2020,82,92,7,39000,1164619,1203619,6,1,7,1125619,In > Out
Feb 2020,82,93,1,31444947,3148183,34593130,1,1,1,28296764,Out > In
Feb 2020,83,112,2,2542161,34097377,36639538,2,2,2,31555216,In > Out
Feb 2020,83,130,29,7657368,2198694,9856062,12,3,1,5458674,Out > In
Feb 2020,83,142,1,104268,3806,108074,1,1,1,100462,Out > In
Feb 2020,83,156,8,321719363,522819692,844539055,5,8,7,201100329,In > Out
Feb 2020,83,161,1,48709,58309,107018,1,1,1,9600,In > Out
Feb 2020,84,36,1,3398398,664483,4062881,1,1,1,2733915,Out > In
Feb 2020,85,126,2,13318619,149409738,162728357,2,1,2,136091119,In > Out
Feb 2020,85,131,2,3012386,308201427,311213813,1,1,2,305189041,In > Out
Feb 2020,85,16,21,4015090920,1360109847,5375200767,15,4,2,2654981073,Out > In
Feb 2020,85,2,107,66756126,8107706,74863832,48,33,1,58648420,Out > In
Feb 2020,85,56,1,3616,163068,166684,1,1,1,159452,In > Out
Feb 2020,85,6,5,174715800,41653817,216369617,4,3,5,133061983,Out > In
Feb 2020,86,175,37,11963928,284268,12248196,23,37,2,11679660,Out > In
Feb 2020,86,44,2,470419,12969,483388,2,2,1,457450,Out > In
Feb 2020,86,66,16838,6299108523,195200637,6494309160,6317,13068,2,6103907886,Out > In
Feb 2020,89,100,1,2011004,11768416,13779420,1,1,1,9757412,In > Out
Feb 2020,89,123,15,54502688,670472465,724975153,15,15,15,615969777,In > Out
Feb 2020,89,20,3,11920,1814435,1826355,1,3,3,1802515,In > Out
Feb 2020,89,52,4,805957044,9227708,815184752,1,4,4,796729336,Out > In
Feb 2020,89,56,3,2709976,19269264,21979240,1,1,1,16559288,In > Out
Feb 2020,89,93,9,822312,849528,1671840,1,1,1,27216,In > Out
Feb 2020,9,155,2,1100137,2589459,3689596,2,2,2,1489322,In > Out
Feb 2020,9,60,1,332057,523329,855386,1,1,1,191272,In > Out
Feb 2020,90,100,3,12309,497720,510029,1,1,3,485411,In > Out
Feb 2020,90,11,6,9414795,40376423,49791218,5,3,5,30961628,In > Out
Feb 2020,90,12,1,97408111,122220789,219628900,1,1,1,24812678,In > Out
Feb 2020,90,14,2,54754748,38433015,93187763,2,2,2,16321733,Out > In
Feb 2020,90,215,2,3319930,445679,3765609,2,2,1,2874251,Out > In
Feb 2020,90,235,136211,93138659824,4393658994,97532318818,661,50535,9,88745000830,Out > In
Feb 2020,90,236,320,218467136,71256225,289723361,163,220,2,147210911,Out > In
Feb 2020,90,253,11,663354509,17113198,680467707,7,7,11,646241311,Out > In
Feb 2020,90,29,3,3519556618,29303023,3548859641,1,3,3,3490253595,Out > In
Feb 2020,90,43,2,180928484,5225280,186153764,1,2,2,175703204,Out > In
Feb 2020,90,48,3,4946334,14499447,19445781,3,3,3,9553113,In > Out
Feb 2020,90,54,1,66112458,423435805,489548263,1,1,1,357323347,In > Out
Feb 2020,90,7,3,31851013,1444898,33295911,2,3,3,30406115,Out > In
Feb 2020,91,11,1,56067398,68038261,124105659,1,1,1,11970863,In > Out
Feb 2020,91,113,2,21401646,433340,21834986,1,2,1,20968306,Out > In
Feb 2020,91,15,4,211552,5453542,5665094,3,3,4,5241990,In > Out
Feb 2020,91,225,6,1153123,61454218,62607341,1,6,1,60301095,In > Out
Feb 2020,91,239,6029,22910213746,363451298,23273665044,1393,5695,3,22546762448,Out > In
Feb 2020,91,31,1,23192,3132770,3155962,1,1,1,3109578,In > Out
Feb 2020,91,32,11,1708592,12910640,14619232,1,1,4,11202048,In > Out
Feb 2020,91,47,1,36744,103685,140429,1,1,1,66941,In > Out
Feb 2020,91,59,2,193631,1310803,1504434,2,2,2,1117172,In > Out
Feb 2020,91,91,14,544186,3864607,4408793,1,1,1,3320421,In > Out
Feb 2020,92,17,1,14424031,95152245,109576276,1,1,1,80728214,In > Out
Feb 2020,92,227,2,2018905,82524,2101429,1,2,2,1936381,Out > In
Feb 2020,92,228,586,770469272,49692096,820161368,89,508,1,720777176,Out > In
Feb 2020,92,250,16,13484187,3566118,17050305,7,16,1,9918069,Out > In
Feb 2020,92,37,5,357823401,9494380,367317781,1,5,5,348329021,Out > In
Feb 2020,92,40,3,589554,11584684,12174238,3,3,3,10995130,In > Out
Feb 2020,92,45,1,6350468,103320,6453788,1,1,1,6247148,Out > In
Feb 2020,92,6,4,305031813,13313797,318345610,4,2,4,291718016,Out > In
Feb 2020,94,22,1498,1232904569,96409731,1329314300,305,1243,34,1136494838,Out > In
Feb 2020,94,29,630,4313421541,915218300,5228639841,34,34,344,3398203241,Out > In
Feb 2020,94,51,106,137466074,2967500,140433574,2,105,106,134498574,Out > In
Feb 2020,96,1,7362,2669970525,96359504,2766330029,3606,6791,2,2573611021,Out > In
Feb 2020,96,10,156,92188065,6909052,99097117,27,155,2,85279013,Out > In
Feb 2020,96,119,2,528086,15768,543854,1,2,1,512318,Out > In
Feb 2020,96,125,1173487,716790684827,47231229266,764021914093,145283,64503,2,669559455561,Out > In
Feb 2020,96,135,1,741728,1261800,2003528,1,1,1,520072,In > Out
Feb 2020,96,136,59,25579797,1983070,27562867,11,59,1,23596727,Out > In
Feb 2020,96,141,2,766878,1285721,2052599,2,2,1,518843,In > Out
Feb 2020,96,143,1,52232,94418,146650,1,1,1,42186,In > Out
Feb 2020,96,144,284325,123223354357,5821869918,129045224275,48778,56639,2,117401484439,Out > In
Feb 2020,96,145,1,690850,973918,1664768,1,1,1,283068,In > Out
Feb 2020,96,148,19,10712423,588128,11300551,9,19,2,10124295,Out > In
Feb 2020,96,149,203,51904143,3567092,55471235,162,203,1,48337051,Out > In
Feb 2020,96,150,1,44940,67307,112247,1,1,1,22367,In > Out
Feb 2020,96,152,15,2886768,2192514,5079282,9,15,2,694254,Out > In
Feb 2020,96,163,100,30941529,50507628,81449157,15,100,1,19566099,In > Out
Feb 2020,96,17,3,323081,615387,938468,3,3,1,292306,In > Out
Feb 2020,96,24,129,170156134,5434921,175591055,73,128,1,164721213,Out > In
Feb 2020,96,25,13852,2196547827,97071090,2293618917,7203,11817,2,2099476737,Out > In
Feb 2020,96,26,4957,2425405774,50615976,2476021750,1566,4635,2,2374789798,Out > In
Feb 2020,96,30,88,47512790,5350056,52862846,13,88,1,42162734,Out > In
Feb 2020,96,31,97,14108031,12478756,26586787,78,97,2,1629275,Out > In
Feb 2020,96,33,345,286790576,48847227,335637803,2,329,1,237943349,Out > In
Feb 2020,96,34,2,181629,120301,301930,2,2,2,61328,Out > In
Feb 2020,96,39,943,383154901,49985962,433140863,186,904,1,333168939,Out > In
Feb 2020,96,41,262,52213860,3073752,55287612,174,261,2,49140108,Out > In
Feb 2020,96,51,77713,14420607029,1380996578,15801603607,24577,29322,2,13039610451,Out > In
Feb 2020,96,53,5,1106524,48612,1155136,2,5,1,1057912,Out > In
Feb 2020,96,58,8,13976648,659516,14636164,7,8,1,13317132,Out > In
Feb 2020,96,60,157,1902225258,719977531,2622202789,75,157,3,1182247727,Out > In
Feb 2020,96,61,2,624331,14230,638561,1,2,2,610101,Out > In
Feb 2020,96,62,301,84582065,7751957,92334022,71,300,2,76830108,Out > In
Feb 2020,96,78,37,162296921,2059796,164356717,8,37,2,160237125,Out > In
Feb 2020,96,79,80,35569347,3930649,39499996,24,80,2,31638698,Out > In
Feb 2020,96,80,4,2543173,4115249,6658422,4,4,1,1572076,In > Out
Feb 2020,96,81,7540,2863998681,709577136,3573575817,1132,6213,1,2154421545,Out > In
Feb 2020,96,85,1968,317309893,276852394,594162287,297,1854,2,40457499,Out > In
Feb 2020,96,88,1004,489211391,14437287,503648678,337,996,1,474774104,Out > In
Feb 2020,96,91,5,517870,18019,535889,1,5,1,499851,Out > In
Feb 2020,96,92,2,101297,160404,261701,2,2,1,59107,In > Out
Feb 2020,96,94,19,9586500,1653397,11239897,8,19,2,7933103,Out > In
Feb 2020,96,95,4299,794829436,136412012,931241448,252,3749,1,658417424,Out > In
Feb 2020,96,96,14671,4191028579,302966549,4493995128,1888,10171,1,3888062030,Out > In
Feb 2020,96,97,2,181198,293107,474305,2,2,1,111909,In > Out
Feb 2020,97,141,1,7836,181297,189133,1,1,1,173461,In > Out
Feb 2020,97,157,1,5812,141154,146966,1,1,1,135342,In > Out
Feb 2020,97,167,6,32936,775788,808724,1,6,1,742852,In > Out
Feb 2020,97,171,1,5676,136931,142607,1,1,1,131255,In > Out
Feb 2020,97,180,2,7676,217181,224857,1,2,1,209505,In > Out
Feb 2020,97,191,1,4716,109425,114141,1,1,1,104709,In > Out
Feb 2020,97,197,2,8712,201420,210132,1,2,1,192708,In > Out
Feb 2020,97,199,1,5224,126135,131359,1,1,1,120911,In > Out
Feb 2020,97,201,3,13256,310371,323627,1,3,1,297115,In > Out
Feb 2020,97,204,3,17188,409022,426210,1,3,1,391834,In > Out
Feb 2020,97,217,2,8632,200943,209575,1,2,1,192311,In > Out
Feb 2020,97,219,2,10992,257817,268809,1,2,1,246825,In > Out
Feb 2020,97,221,1,4076,101174,105250,1,1,1,97098,In > Out
Feb 2020,97,228,6,31496,738252,769748,1,6,1,706756,In > Out
Feb 2020,97,230,2,9008,222554,231562,1,2,1,213546,In > Out
Feb 2020,97,239,2,8020,197508,205528,1,2,1,189488,In > Out
Feb 2020,97,245,2,9100,223367,232467,1,2,1,214267,In > Out
Feb 2020,98,10,79,1024732099,185568537,1210300636,57,33,3,839163562,Out > In
Feb 2020,98,102,2,14508,771894,786402,2,1,2,757386,In > Out
Feb 2020,98,108,3,2329757,4209058,6538815,3,3,3,1879301,In > Out
Feb 2020,98,11,3,7732409,398632012,406364421,1,1,3,390899603,In > Out
Feb 2020,98,111,1,159189,134490,293679,1,1,1,24699,Out > In
Feb 2020,98,113,1,279672,436585,716257,1,1,1,156913,In > Out
Feb 2020,98,115,2,165864,171708,337572,1,1,1,5844,In > Out
Feb 2020,98,12,1,24428,112610,137038,1,1,1,88182,In > Out
Feb 2020,98,122,7,107297784,186521715,293819499,4,6,7,79223931,In > Out
Feb 2020,98,132,1,20689291,386577,21075868,1,1,1,20302714,Out > In
Feb 2020,98,133,13,2539148713,16322972698,18862121411,4,4,13,13783823985,In > Out
Feb 2020,98,135,3,4054237,3910625,7964862,3,2,2,143612,Out > In
Feb 2020,98,136,1,151330426,59488488,210818914,1,1,1,91841938,Out > In
Feb 2020,98,138,2,756178,1881175,2637353,2,2,2,1124997,In > Out
Feb 2020,98,139,4,26157041,38911706,65068747,3,4,3,12754665,In > Out
Feb 2020,98,140,3,2947921,7815858,10763779,3,3,2,4867937,In > Out
Feb 2020,98,141,1,47466,113215,160681,1,1,1,65749,In > Out
Feb 2020,98,145,15,132512,2619502,2752014,15,15,3,2486990,In > Out
Feb 2020,98,148,2,123358,121669,245027,2,2,2,1689,Out > In
Feb 2020,98,149,2,1031799,717428,1749227,2,2,2,314371,Out > In
Feb 2020,98,15,1,1878794,2489589,4368383,1,1,1,610795,In > Out
Feb 2020,98,150,10,1427011,394795,1821806,2,10,10,1032216,Out > In
Feb 2020,98,157,15,141460035,130324040,271784075,15,15,4,11135995,Out > In
Feb 2020,98,16,3,22041016,27690211,49731227,2,3,3,5649195,In > Out
Feb 2020,98,161,2,15433846,27324082,42757928,2,2,2,11890236,In > Out
Feb 2020,98,163,2,197397507,234518140,431915647,2,2,1,37120633,In > Out
Feb 2020,98,169,3,258143,354824320,355082463,2,3,3,354566177,In > Out
Feb 2020,98,17,2,569609,115826,685435,2,2,2,453783,Out > In
Feb 2020,98,170,1,64224,42636,106860,1,1,1,21588,Out > In
Feb 2020,98,171,3,25268894,130263651,155532545,3,3,1,104994757,In > Out
Feb 2020,98,172,1,52466274,474651474,527117748,1,1,1,422185200,In > Out
Feb 2020,98,173,2,8761680,11713101,20474781,1,2,2,2951421,In > Out
Feb 2020,98,177,2,5625541,12090623,17716164,2,2,2,6465082,In > Out
Feb 2020,98,179,1,406129,320955,727084,1,1,1,85174,Out > In
Feb 2020,98,180,3,2205841,1805818,4011659,3,2,3,400023,Out > In
Feb 2020,98,184,1,50786201,57581125,108367326,1,1,1,6794924,In > Out
Feb 2020,98,186,2,270251,325944,596195,2,2,2,55693,In > Out
Feb 2020,98,195,1,101382,116600,217982,1,1,1,15218,In > Out
Feb 2020,98,196,1,18598,384188,402786,1,1,1,365590,In > Out
Feb 2020,98,20,1,2141082,2611207,4752289,1,1,1,470125,In > Out
Feb 2020,98,200,1,4832194,3470164,8302358,1,1,1,1362030,Out > In
Feb 2020,98,201,2,156399529,9370370,165769899,1,2,2,147029159,Out > In
Feb 2020,98,204,2,44608987,156222005,200830992,2,2,2,111613018,In > Out
Feb 2020,98,208,2,315706952,316686578,632393530,1,1,1,979626,In > Out
Feb 2020,98,210,1,19681197,950467552,970148749,1,1,1,930786355,In > Out
Feb 2020,98,211,3,95408345,43200100,138608445,3,3,2,52208245,Out > In
Feb 2020,98,212,2,6457222,6919064,13376286,2,2,2,461842,In > Out
Feb 2020,98,216,5,53309918,230027836,283337754,5,5,5,176717918,In > Out
Feb 2020,98,219,2,48043964,50555232,98599196,2,2,2,2511268,In > Out
Feb 2020,98,221,1,20343245,520174733,540517978,1,1,1,499831488,In > Out
Feb 2020,98,222,6,19554734,22863486,42418220,5,4,6,3308752,In > Out
Feb 2020,98,223,12,6438775,20543939,26982714,8,6,12,14105164,In > Out
Feb 2020,98,27,1,127356,9256,136612,1,1,1,118100,Out > In
Feb 2020,98,28,9,33141112,42586766,75727878,6,8,9,9445654,In > Out
Feb 2020,98,29,31,401433,12098120,12499553,31,31,3,11696687,In > Out
Feb 2020,98,30,4,1530844,4542956,6073800,3,4,4,3012112,In > Out
Feb 2020,98,31,1,53848,312380,366228,1,1,1,258532,In > Out
Feb 2020,98,33,4,6082006,5282634,11364640,1,4,4,799372,Out > In
Feb 2020,98,34,1,14685142,9751058,24436200,1,1,1,4934084,Out > In
Feb 2020,98,37,1,2901073,4708796,7609869,1,1,1,1807723,In > Out
Feb 2020,98,4,1,60967,131315,192282,1,1,1,70348,In > Out
Feb 2020,98,40,1,258729447,342099805,600829252,1,1,1,83370358,In > Out
Feb 2020,98,43,42,248203876,204280324,452484200,41,16,4,43923552,Out > In
Feb 2020,98,46,5,3009025,6462332,9471357,5,5,5,3453307,In > Out
Feb 2020,98,49,13,19877089,30984487,50861576,9,11,13,11107398,In > Out
Feb 2020,98,51,2,887157,239071,1126228,2,2,2,648086,Out > In
Feb 2020,98,54,80,1208293018,989426196,2197719214,47,80,2,218866822,Out > In
Feb 2020,98,62,1,28519,144384,172903,1,1,1,115865,In > Out
Feb 2020,98,64,4,413142466,3944573614,4357716080,2,2,3,3531431148,In > Out
Feb 2020,98,70,6,2618651,5606545,8225196,5,4,6,2987894,In > Out
Feb 2020,98,73,1,109330,147055,256385,1,1,1,37725,In > Out
Feb 2020,98,75,1,135984273,140465617,276449890,1,1,1,4481344,In > Out
Feb 2020,98,76,1,12441188,353650,12794838,1,1,1,12087538,Out > In
Feb 2020,98,77,2,4562265,6009382,10571647,2,2,1,1447117,In > Out
Feb 2020,98,78,1,126727,19402,146129,1,1,1,107325,Out > In
Feb 2020,98,8,1,2086992,14849510,16936502,1,1,1,12762518,In > Out
Feb 2020,98,80,2,103788,24969510,25073298,2,2,2,24865722,In > Out
Feb 2020,98,83,3,4588065,5119409,9707474,2,3,3,531344,In > Out
Feb 2020,98,84,1,71832,221436,293268,1,1,1,149604,In > Out
Feb 2020,98,86,191,1279057688,856932676,2135990364,179,184,183,422125012,Out > In
Feb 2020,98,87,1,52971,68385,121356,1,1,1,15414,In > Out
Feb 2020,98,90,1,187347,2542009,2729356,1,1,1,2354662,In > Out
Feb 2020,98,93,7,481727,18813160,19294887,1,1,7,18331433,In > Out
Feb 2020,98,94,1,307046,353681,660727,1,1,1,46635,In > Out
Feb 2020,98,96,1,2352221,3398221,5750442,1,1,1,1046000,In > Out
Feb 2020,98,97,3,125046326,95078869,220125195,2,3,2,29967457,Out > In
Feb 2020,98,98,7,31127814,57001202,88129016,5,7,6,25873388,In > Out
Feb 2020,98,99,3,216744492,66081781,282826273,3,3,2,150662711,Out > In
Feb 2020,99,100,3,229584,167612,397196,2,3,1,61972,Out > In
Feb 2020,99,115,3,208052,396645,604697,2,2,3,188593,In > Out
Feb 2020,99,121,1,556200,608440,1164640,1,1,1,52240,In > Out
Feb 2020,99,123,344,166491000,56257872,222748872,169,232,1,110233128,Out > In
Feb 2020,99,129,2,187996,101684,289680,1,2,1,86312,Out > In
Feb 2020,99,130,5,108947980,18560782,127508762,4,5,2,90387198,Out > In
Feb 2020,99,131,1,93517372,31811360,125328732,1,1,1,61706012,Out > In
Feb 2020,99,162,110,1480776831,5367250,1486144081,40,110,2,1475409581,Out > In
Feb 2020,99,167,2,850817242,15130783,865948025,2,2,2,835686459,Out > In
Feb 2020,99,182,33,4117879,1159867,5277746,5,29,2,2958012,Out > In
Feb 2020,99,207,3,3264635,47678,3312313,3,3,1,3216957,Out > In
Feb 2020,99,246,7,2560864451,1561814448,4122678899,3,5,7,999050003,Out > In
Feb 2020,99,248,1,918718,297000,1215718,1,1,1,621718,Out > In
Feb 2020,99,51,5,1365269833,26595470,1391865303,1,5,5,1338674363,Out > In
Feb 2020,99,75,6,405219760,22036188,427255948,2,6,6,383183572,Out > In
Feb 2020,99,92,2,330117,171228,501345,2,2,2,158889,Out > In
Apr 2020,1,21,11,778422,777044,1555466,4,9,1,1378,Out > In
Apr 2020,100,132,52,4393477,3435780,7829257,47,47,4,957697,Out > In
Apr 2020,100,148,6,437012703,4331912,441344615,1,4,4,432680791,Out > In
Apr 2020,100,181,1,166868,40356,207224,1,1,1,126512,Out > In
Apr 2020,100,185,14,1869713,313073,2182786,12,14,3,1556640,Out > In
Apr 2020,100,80,11,1324830,756650,2081480,7,11,1,568180,Out > In
Apr 2020,101,112,3,115642426,8286204,123928630,1,3,1,107356222,Out > In
Apr 2020,101,160,22118,98621957372,32131228172,130753185544,4045,7315,30,66490729200,Out > In
Apr 2020,101,208,2,171306,79565,250871,1,2,1,91741,Out > In
Apr 2020,101,223,12,64735442,7544254,72279696,1,12,1,57191188,Out > In
Apr 2020,101,231,1,499737,186898,686635,1,1,1,312839,Out > In
Apr 2020,101,37,3,425414042,4218879,429632921,1,2,3,421195163,Out > In
Apr 2020,101,49,2,70062982,15071594,85134576,1,2,1,54991388,Out > In
Apr 2020,101,69,260,688377354,6785145,695162499,113,259,1,681592209,Out > In
Apr 2020,101,76,8,74814475,31600913,106415388,1,8,3,43213562,Out > In
Apr 2020,102,102,449,4442708959,1457988204,5900697163,90,446,1,2984720755,Out > In
Apr 2020,103,230,1,53783,155765,209548,1,1,1,101982,In > Out
Apr 2020,103,232,100,46379970,39521618,85901588,49,81,1,6858352,Out > In
Apr 2020,103,246,8,331089,935294,1266383,1,8,1,604205,In > Out
Apr 2020,104,150,4,9579210,1315820,10895030,1,4,1,8263390,Out > In
Apr 2020,104,161,3,1363501,54962861,56326362,1,3,1,53599360,In > Out
Apr 2020,104,206,3,53892281,72018592,125910873,2,2,3,18126311,In > Out
Apr 2020,104,231,5,10491357,899015,11390372,2,5,5,9592342,Out > In
Apr 2020,104,237,6,1136228134,26734758,1162962892,1,6,6,1109493376,Out > In
Apr 2020,104,59,4,170738595,3705600,174444195,1,4,4,167032995,Out > In
Apr 2020,104,81,2,3073115,185662,3258777,1,2,1,2887453,Out > In
Apr 2020,109,188,16,5716589,280155,5996744,10,16,2,5436434,Out > In
Apr 2020,111,5,121,208508492,125879367,334387859,45,89,14,82629125,Out > In
Apr 2020,112,10,9,4143069,483944792,488087861,2,2,9,479801723,In > Out
Apr 2020,112,100,1,696848033,460770397,1157618430,1,1,1,236077636,Out > In
Apr 2020,112,104,7,49869,1355312,1405181,2,1,7,1305443,In > Out
Apr 2020,112,105,12,6309851,13246273,19556124,12,8,12,6936422,In > Out
Apr 2020,112,111,4,24018299,60274826,84293125,3,2,4,36256527,In > Out
Apr 2020,112,119,1,265135,765494,1030629,1,1,1,500359,In > Out
Apr 2020,112,123,2,6522228,27721148,34243376,2,2,2,21198920,In > Out
Apr 2020,112,127,3,26351864,54073222,80425086,1,1,3,27721358,In > Out
Apr 2020,112,129,6,23680435,252199,23932634,4,6,1,23428236,Out > In
Apr 2020,112,132,2,547094,70560,617654,2,1,2,476534,Out > In
Apr 2020,112,137,11,2641486,7251835,9893321,8,4,11,4610349,In > Out
Apr 2020,112,138,1,142240346,125448617,267688963,1,1,1,16791729,Out > In
Apr 2020,112,141,1,298179,1305021,1603200,1,1,1,1006842,In > Out
Apr 2020,112,147,11,25890475,19847629,45738104,4,11,7,6042846,Out > In
Apr 2020,112,15,2,1492500,2234449,3726949,2,2,2,741949,In > Out
Apr 2020,112,152,2,342747,2590522,2933269,2,2,2,2247775,In > Out
Apr 2020,112,155,10,163105085,121701641,284806726,5,9,8,41403444,Out > In
Apr 2020,112,156,7,690008275,659000063,1349008338,5,5,7,31008212,Out > In
Apr 2020,112,157,1,77456,91560,169016,1,1,1,14104,In > Out
Apr 2020,112,158,1,146032,333237,479269,1,1,1,187205,In > Out
Apr 2020,112,162,8,126601,3856989,3983590,1,1,8,3730388,In > Out
Apr 2020,112,165,2,639711430,749552525,1389263955,2,2,2,109841095,In > Out
Apr 2020,112,175,10,7270214,6528159467,6535429681,2,10,3,6520889253,In > Out
Apr 2020,112,177,336,5374611560,532161558,5906773118,232,186,6,4842450002,Out > In
Apr 2020,112,181,3,343529931,213739287,557269218,1,3,3,129790644,Out > In
Apr 2020,112,183,1,1091277,1021542,2112819,1,1,1,69735,Out > In
Apr 2020,112,184,3,175259192,180969934,356229126,3,2,2,5710742,In > Out
Apr 2020,112,185,6,5972273,8948861,14921134,5,2,6,2976588,In > Out
Apr 2020,112,186,24,310095748,790344200,1100439948,13,10,15,480248452,In > Out
Apr 2020,112,190,12,70789742,276321338,347111080,9,10,12,205531596,In > Out
Apr 2020,112,202,4,26074548,122734197,148808745,2,3,3,96659649,In > Out
Apr 2020,112,209,2,325431,12882455,13207886,1,1,2,12557024,In > Out
Apr 2020,112,212,4,2289662210,972772724,3262434934,2,4,4,1316889486,Out > In
Apr 2020,112,219,1,106953840,123921408,230875248,1,1,1,16967568,In > Out
Apr 2020,112,22,8,27559715,96815695,124375410,8,8,8,69255980,In > Out
Apr 2020,112,220,1,1633687,63700,1697387,1,1,1,1569987,Out > In
Apr 2020,112,25,2,511418,636074,1147492,2,1,2,124656,In > Out
Apr 2020,112,28,4,344144231,189122406,533266637,3,3,4,155021825,Out > In
Apr 2020,112,38,6,3457525,75555319,79012844,6,6,6,72097794,In > Out
Apr 2020,112,40,1,101070,116874,217944,1,1,1,15804,In > Out
Apr 2020,112,41,5,438928467,377570688,816499155,4,4,4,61357779,Out > In
Apr 2020,112,49,1,10206,1252650,1262856,1,1,1,1242444,In > Out
Apr 2020,112,53,1,10310931,11498417,21809348,1,1,1,1187486,In > Out
Apr 2020,112,64,1,251784,629432,881216,1,1,1,377648,In > Out
Apr 2020,112,68,2,15214250,59051911,74266161,2,2,2,43837661,In > Out
Apr 2020,112,71,3,4856473,12635555,17492028,3,3,3,7779082,In > Out
Apr 2020,112,73,1,20991564,70905619,91897183,1,1,1,49914055,In > Out
Apr 2020,112,76,6,731525413,669847847,1401373260,5,6,6,61677566,Out > In
Apr 2020,112,78,2,512678916,493463327,1006142243,2,2,2,19215589,Out > In
Apr 2020,112,86,14,81662949,92494211,174157160,10,9,14,10831262,In > Out
Apr 2020,114,110,4,182678623,3721315,186399938,3,4,1,178957308,Out > In
Apr 2020,115,195,5,14073148,2360727,16433875,2,5,5,11712421,Out > In
Apr 2020,117,16,35,21216236,691930,21908166,3,35,1,20524306,Out > In
Apr 2020,117,177,4,485552,705068,1190620,1,1,1,219516,In > Out
Apr 2020,117,208,28,343741904,1763252,345505156,1,28,1,341978652,Out > In
Apr 2020,117,209,2,1268098,30125,1298223,1,1,2,1237973,Out > In
Apr 2020,117,236,101,43426114,3113069,46539183,22,101,2,40313045,Out > In
Apr 2020,117,238,5,407104,401776,808880,1,1,1,5328,Out > In
Apr 2020,117,254,895,12223960403,430432911,12654393314,583,315,1,11793527492,Out > In
Apr 2020,117,50,213,728413545,223104807,951518352,2,20,205,505308738,Out > In
Apr 2020,117,76,16,4659412,3095128,7754540,1,1,1,1564284,Out > In
Apr 2020,118,143,109,3495280,29523680,33018960,2,1,1,26028400,In > Out
Apr 2020,118,162,515,308924622,252214938,561139560,308,216,1,56709684,Out > In
Apr 2020,118,182,141,35667324,19979112,55646436,21,14,1,15688212,Out > In
Apr 2020,118,210,2,209064,7424,216488,1,1,1,201640,Out > In
Apr 2020,118,217,21,4182776,128933,4311709,16,21,2,4053843,Out > In
Apr 2020,118,233,5,34816105,3555296,38371401,1,5,5,31260809,Out > In
Apr 2020,118,246,1,14497,647287,661784,1,1,1,632790,In > Out
Apr 2020,118,27,4,332885,642574,975459,4,4,1,309689,In > Out
Apr 2020,118,47,6,3055583,813158,3868741,1,3,3,2242425,Out > In
Apr 2020,118,59,86,42185236,875561167,917746403,77,86,11,833375931,In > Out
Apr 2020,118,63,21,1407816,1401360,2809176,1,1,1,6456,Out > In
Apr 2020,118,80,17,15779576,3643909,19423485,1,16,7,12135667,Out > In
Apr 2020,118,88,2,3333686,946444,4280130,1,2,1,2387242,Out > In
Apr 2020,118,90,6,1489883,276635,1766518,1,6,1,1213248,Out > In
Apr 2020,119,102,11,111220330,95460962,206681292,4,11,1,15759368,Out > In
Apr 2020,119,152,18,968906332,76652916,1045559248,10,12,2,892253416,Out > In
Apr 2020,119,16,5,499792,524652,1024444,4,5,3,24860,In > Out
Apr 2020,119,161,1,541958,9348,551306,1,1,1,532610,Out > In
Apr 2020,119,168,361,146103892,42154102,188257994,30,252,6,103949790,Out > In
Apr 2020,119,169,59,384899163,20983761,405882924,2,58,3,363915402,Out > In
Apr 2020,119,42,15,5872423,182743,6055166,10,15,1,5689680,Out > In
Apr 2020,119,59,2,230898,6242,237140,1,2,1,224656,Out > In
Apr 2020,119,71,3,536110,46302,582412,2,3,1,489808,Out > In
Apr 2020,120,71,608,180609581,133839059,314448640,10,599,2,46770522,Out > In
Apr 2020,122,10,6,513288,329672,842960,6,3,2,183616,Out > In
Apr 2020,122,119,2,34147676,1883571,36031247,1,2,1,32264105,Out > In
Apr 2020,122,160,8,2432338,535821,2968159,6,8,2,1896517,Out > In
Apr 2020,122,165,5,7391246,1625758,9017004,3,5,1,5765488,Out > In
Apr 2020,122,176,2,936642788,2289401,938932189,1,2,1,934353387,Out > In
Apr 2020,122,205,12,1198711,9556061,10754772,10,12,2,8357350,In > Out
Apr 2020,122,214,269,124254963,40047415,164302378,36,161,2,84207548,Out > In
Apr 2020,122,222,32,3292905,6741482,10034387,3,3,5,3448577,In > Out
Apr 2020,122,227,366,684803397,17735191923,18419995320,50,365,8,17050388526,In > Out
Apr 2020,122,237,4413,9623457582,408406586469,418030044051,24,4367,5,398783128887,In > Out
Apr 2020,123,103,2,501676,8604717,9106393,1,1,2,8103041,In > Out
Apr 2020,123,107,3,1127555,1543237,2670792,3,3,3,415682,In > Out
Apr 2020,123,11,8,68992883,142239407,211232290,6,6,8,73246524,In > Out
Apr 2020,123,111,2,423918,1913437,2337355,2,2,2,1489519,In > Out
Apr 2020,123,113,9,23830585,45602463,69433048,5,7,9,21771878,In > Out
Apr 2020,123,116,1,2531183709,2427454217,4958637926,1,1,1,103729492,Out > In
Apr 2020,123,119,1,880952,2644637,3525589,1,1,1,1763685,In > Out
Apr 2020,123,128,2,61122619,4846422,65969041,2,2,2,56276197,Out > In
Apr 2020,123,132,7,324099485,174784258,498883743,3,5,7,149315227,Out > In
Apr 2020,123,133,1,357915138,1109331556,1467246694,1,1,1,751416418,In > Out
Apr 2020,123,135,1,1163029952,1394481731,2557511683,1,1,1,231451779,In > Out
Apr 2020,123,136,2,172371,613312,785683,2,2,2,440941,In > Out
Apr 2020,123,140,4,2398101,96049825,98447926,3,1,4,93651724,In > Out
Apr 2020,123,146,3,30323965,68586063,98910028,2,3,3,38262098,In > Out
Apr 2020,123,159,1,491899,805903,1297802,1,1,1,314004,In > Out
Apr 2020,123,163,1,269210058,190983266,460193324,1,1,1,78226792,Out > In
Apr 2020,123,167,7,7212396,135441393,142653789,3,2,7,128228997,In > Out
Apr 2020,123,169,2,776143397,665903467,1442046864,1,2,2,110239930,Out > In
Apr 2020,123,17,745,288716889,1570119515,1858836404,659,682,49,1281402626,In > Out
Apr 2020,123,177,2,30784870,30515525,61300395,2,2,2,269345,Out > In
Apr 2020,123,178,4,33998,848598,882596,1,1,4,814600,In > Out
Apr 2020,123,189,2,31828828,30280906,62109734,2,2,2,1547922,Out > In
Apr 2020,123,190,13,9006494,13974720,22981214,13,13,1,4968226,In > Out
Apr 2020,123,192,5,16035315,38274381,54309696,4,5,3,22239066,In > Out
Apr 2020,123,197,15,154267130,9734308468,9888575598,6,11,10,9580041338,In > Out
Apr 2020,123,199,40,516119,15583348,16099467,1,1,40,15067229,In > Out
Apr 2020,123,20,1,471292,47154,518446,1,1,1,424138,Out > In
Apr 2020,123,204,1,160016093,84933335,244949428,1,1,1,75082758,Out > In
Apr 2020,123,208,1,537462,246056,783518,1,1,1,291406,Out > In
Apr 2020,123,21,792,1183396043,2240555570,3423951613,245,787,3,1057159527,In > Out
Apr 2020,123,211,1,195479834,144613247,340093081,1,1,1,50866587,Out > In
Apr 2020,123,216,5,15210021,80691784,95901805,5,4,5,65481763,In > Out
Apr 2020,123,217,2,4350186,9217712,13567898,2,2,2,4867526,In > Out
Apr 2020,123,222,2,1908799,2548281,4457080,1,2,2,639482,In > Out
Apr 2020,123,223,5,48771281,482454417,531225698,3,1,5,433683136,In > Out
Apr 2020,123,23,3,883067,22426722,23309789,1,1,3,21543655,In > Out
Apr 2020,123,27,1,43106336,92309789,135416125,1,1,1,49203453,In > Out
Apr 2020,123,28,1,181732,1075211,1256943,1,1,1,893479,In > Out
Apr 2020,123,4,5,992193,3355656,4347849,3,4,5,2363463,In > Out
Apr 2020,123,48,7,67272829,64485359,131758188,6,5,6,2787470,Out > In
Apr 2020,123,5,5,352490,6592503,6944993,1,1,5,6240013,In > Out
Apr 2020,123,53,1,106289477,73546591,179836068,1,1,1,32742886,Out > In
Apr 2020,123,54,7,197827749,138632950,336460699,2,7,5,59194799,Out > In
Apr 2020,123,57,1,510128,2111664,2621792,1,1,1,1601536,In > Out
Apr 2020,123,58,2,654211656,376936246,1031147902,2,2,1,277275410,Out > In
Apr 2020,123,60,3,239239,404078,643317,1,1,3,164839,In > Out
Apr 2020,123,75,8,1612652476,1086399012,2699051488,3,8,8,526253464,Out > In
Apr 2020,123,77,89,246706054,223467327,470173381,86,89,89,23238727,Out > In
Apr 2020,123,79,4,74745065,116265923,191010988,2,4,4,41520858,In > Out
Apr 2020,123,93,6,240205540,455886842,696092382,6,5,3,215681302,In > Out
Apr 2020,123,94,5,69561398,88097135,157658533,3,5,5,18535737,In > Out
Apr 2020,123,99,4,85268560,97115377,182383937,4,4,4,11846817,In > Out
Apr 2020,124,101,4,8925759,11488228,20413987,2,2,4,2562469,In > Out
Apr 2020,124,108,58,111968791,75474367,187443158,4,4,58,36494424,Out > In
Apr 2020,124,110,2,32689964,57716738,90406702,1,1,2,25026774,In > Out
Apr 2020,124,113,9,1231213,20769504,22000717,1,1,9,19538291,In > Out
Apr 2020,124,116,2,1138575,5421442334,5422580909,1,2,2,5420303759,In > Out
Apr 2020,124,121,3,678197,3998633,4676830,3,3,3,3320436,In > Out
Apr 2020,124,124,13,268647153,1061002882,1329650035,3,11,12,792355729,In > Out
Apr 2020,124,125,1,9686576,9525530,19212106,1,1,1,161046,Out > In
Apr 2020,124,126,2,423121,3159526,3582647,2,2,2,2736405,In > Out
Apr 2020,124,129,1,121420,157179,278599,1,1,1,35759,In > Out
Apr 2020,124,133,5,73050253,168810973,241861226,5,4,4,95760720,In > Out
Apr 2020,124,135,3,2702434,5238226,7940660,1,3,1,2535792,In > Out
Apr 2020,124,138,1,3241275,3020659,6261934,1,1,1,220616,Out > In
Apr 2020,124,14,3,611057655,776541705,1387599360,2,3,1,165484050,In > Out
Apr 2020,124,141,2,3256946,2901044,6157990,2,2,2,355902,Out > In
Apr 2020,124,143,2,14148197,25808749,39956946,2,2,2,11660552,In > Out
Apr 2020,124,145,3,11557790,18799777,30357567,1,3,1,7241987,In > Out
Apr 2020,124,146,16,399844452,418791980,818636432,4,16,14,18947528,In > Out
Apr 2020,124,152,1,418624,103398,522022,1,1,1,315226,Out > In
Apr 2020,124,154,3,50075254,55875491,105950745,2,2,3,5800237,In > Out
Apr 2020,124,155,8,2256839,7645965,9902804,2,8,1,5389126,In > Out
Apr 2020,124,157,2,977597,132730794,133708391,1,1,2,131753197,In > Out
Apr 2020,124,161,1,30794070,41410105,72204175,1,1,1,10616035,In > Out
Apr 2020,124,165,10,78299346,280495275,358794621,4,10,2,202195929,In > Out
Apr 2020,124,167,7,6454519,240238486,246693005,1,1,7,233783967,In > Out
Apr 2020,124,168,9,1431678048,1366734154,2798412202,7,9,9,64943894,Out > In
Apr 2020,124,172,5,371040749,344091997,715132746,4,5,4,26948752,Out > In
Apr 2020,124,173,1,481077,3783193,4264270,1,1,1,3302116,In > Out
Apr 2020,124,183,14,125395752,501743124,627138876,11,12,11,376347372,In > Out
Apr 2020,124,188,2,12261117,11221056,23482173,1,2,2,1040061,Out > In
Apr 2020,124,19,2,1623129415,1653748005,3276877420,2,2,2,30618590,In > Out
Apr 2020,124,190,126,93470447,105419789,198890236,111,45,1,11949342,In > Out
Apr 2020,124,195,1,157054,637576,794630,1,1,1,480522,In > Out
Apr 2020,124,204,3,3681753,32960991,36642744,3,2,3,29279238,In > Out
Apr 2020,124,206,1,35996016,32101402,68097418,1,1,1,3894614,Out > In
Apr 2020,124,207,2,5261463,6352597,11614060,1,2,2,1091134,In > Out
Apr 2020,124,21,2,931325,467741,1399066,2,2,2,463584,Out > In
Apr 2020,124,212,1,53052,457261,510313,1,1,1,404209,In > Out
Apr 2020,124,32,2,1617012,7277284,8894296,2,1,2,5660272,In > Out
Apr 2020,124,33,4,4952328,34445418,39397746,3,3,4,29493090,In > Out
Apr 2020,124,37,1,33929,86736,120665,1,1,1,52807,In > Out
Apr 2020,124,40,5,1623146,62762601,64385747,5,5,4,61139455,In > Out
Apr 2020,124,43,4,23610,711356,734966,1,1,4,687746,In > Out
Apr 2020,124,46,6,749910,34697724,35447634,1,1,6,33947814,In > Out
Apr 2020,124,5,1,1384635,905130,2289765,1,1,1,479505,Out > In
Apr 2020,124,51,68,667750756,135865168,803615924,27,60,5,531885588,Out > In
Apr 2020,124,54,3,11274857,28870489,40145346,2,3,3,17595632,In > Out
Apr 2020,124,56,2,181558,2834390,3015948,1,1,2,2652832,In > Out
Apr 2020,124,60,1,78296,60592,138888,1,1,1,17704,Out > In
Apr 2020,124,64,59,683922,21057920,21741842,59,59,9,20373998,In > Out
Apr 2020,124,65,6,1032294292,1219363477,2251657769,5,6,5,187069185,In > Out
Apr 2020,124,70,1,2952680,3861500,6814180,1,1,1,908820,In > Out
Apr 2020,124,71,11,179442250,7544002163,7723444413,3,11,4,7364559913,In > Out
Apr 2020,124,82,2,58079,1335831,1393910,2,1,2,1277752,In > Out
Apr 2020,124,9,2,333325,30682977,31016302,1,1,2,30349652,In > Out
Apr 2020,124,91,6,374043370,618644728,992688098,3,2,5,244601358,In > Out
Apr 2020,124,92,6,543158,1776849,2320007,2,2,6,1233691,In > Out
Apr 2020,125,167,13,1350652229,23831105,1374483334,1,13,1,1326821124,Out > In
Apr 2020,125,69,1,11078744,597206,11675950,1,1,1,10481538,Out > In
Apr 2020,126,13,2,516327,20753,537080,2,2,1,495574,Out > In
Apr 2020,126,234,11,472132,1423098,1895230,1,11,1,950966,In > Out
Apr 2020,126,25,3,8642028,392214,9034242,1,3,1,8249814,Out > In
Apr 2020,127,10,1,117204300,168611641,285815941,1,1,1,51407341,In > Out
Apr 2020,127,100,1,396203,909270,1305473,1,1,1,513067,In > Out
Apr 2020,127,105,24,73526461,74840476,148366937,16,18,7,1314015,In > Out
Apr 2020,127,111,1,299985,166502,466487,1,1,1,133483,Out > In
Apr 2020,127,122,2,1548498336,1558615591,3107113927,2,2,2,10117255,In > Out
Apr 2020,127,131,5,7832425,6129172,13961597,5,5,5,1703253,Out > In
Apr 2020,127,133,1,10074739,5409095,15483834,1,1,1,4665644,Out > In
Apr 2020,127,135,3,17128343,31564654,48692997,1,3,3,14436311,In > Out
Apr 2020,127,14,1,258456,656968382,657226838,1,1,1,656709926,In > Out
Apr 2020,127,142,1,12942699,38494281,51436980,1,1,1,25551582,In > Out
Apr 2020,127,144,1,1012208,1059799,2072007,1,1,1,47591,In > Out
Apr 2020,127,145,1,2172712,3625938,5798650,1,1,1,1453226,In > Out
Apr 2020,127,148,5,118145258,462827026,580972284,2,2,2,344681768,In > Out
Apr 2020,127,149,2,581488,38578632,39160120,1,1,2,37997144,In > Out
Apr 2020,127,152,159,1622113,48568388,50190501,147,146,11,46946275,In > Out
Apr 2020,127,155,1,12936021,11578054,24514075,1,1,1,1357967,Out > In
Apr 2020,127,156,2,107120158,234674378,341794536,1,1,2,127554220,In > Out
Apr 2020,127,157,1,1237980221,842621069,2080601290,1,1,1,395359152,Out > In
Apr 2020,127,158,5,11761387,247204306,258965693,4,4,5,235442919,In > Out
Apr 2020,127,159,216,161327035,165603799,326930834,215,42,1,4276764,In > Out
Apr 2020,127,163,2,7932634,9784267,17716901,2,2,1,1851633,In > Out
Apr 2020,127,165,2,29721710,22000811,51722521,2,2,2,7720899,Out > In
Apr 2020,127,167,1,471232,327389,798621,1,1,1,143843,Out > In
Apr 2020,127,168,3,50293804,649655477,699949281,2,2,3,599361673,In > Out
Apr 2020,127,169,1,7970565,9845202,17815767,1,1,1,1874637,In > Out
Apr 2020,127,170,2,143626,1747753,1891379,2,2,2,1604127,In > Out
Apr 2020,127,175,3,123916628,420133937,544050565,3,3,3,296217309,In > Out
Apr 2020,127,187,11,28824945,114336382,143161327,11,11,11,85511437,In > Out
Apr 2020,127,188,4,1610078,8374067,9984145,2,4,4,6763989,In > Out
Apr 2020,127,190,2,80663808,33301903,113965711,2,2,2,47361905,Out > In
Apr 2020,127,191,1,2372293,3358496,5730789,1,1,1,986203,In > Out
Apr 2020,127,193,29,7947252,42016406,49963658,9,16,29,34069154,In > Out
Apr 2020,127,194,1,131357,277655,409012,1,1,1,146298,In > Out
Apr 2020,127,196,2,17777551,15133263,32910814,2,2,2,2644288,Out > In
Apr 2020,127,201,1,54127,1081286,1135413,1,1,1,1027159,In > Out
Apr 2020,127,203,14,60086836,112827339,172914175,12,12,9,52740503,In > Out
Apr 2020,127,205,13,88774618,311462161,400236779,13,12,12,222687543,In > Out
Apr 2020,127,206,6,1139316188,1001252000,2140568188,3,6,6,138064188,Out > In
Apr 2020,127,207,1,875824198,2358299305,3234123503,1,1,1,1482475107,In > Out
Apr 2020,127,209,13,672514,27384712,28057226,12,11,4,26712198,In > Out
Apr 2020,127,210,1,5855737,6281902,12137639,1,1,1,426165,In > Out
Apr 2020,127,214,1,84870,563477,648347,1,1,1,478607,In > Out
Apr 2020,127,219,7,97152,3318576,3415728,7,7,1,3221424,In > Out
Apr 2020,127,220,26,6268139,82640654,88908793,4,1,26,76372515,In > Out
Apr 2020,127,221,5,435722276,515425334,951147610,3,4,4,79703058,In > Out
Apr 2020,127,222,3,345916702,847085342,1193002044,2,2,3,501168640,In > Out
Apr 2020,127,223,5,422431591,395115222,817546813,4,4,2,27316369,Out > In
Apr 2020,127,27,1,355880,583359,939239,1,1,1,227479,In > Out
Apr 2020,127,31,1,7210876,5550997,12761873,1,1,1,1659879,Out > In
Apr 2020,127,37,2,108941529,102632480,211574009,1,1,2,6309049,Out > In
Apr 2020,127,41,5,203828177,278498356,482326533,3,4,5,74670179,In > Out
Apr 2020,127,42,7,3717626,33387221,37104847,3,4,7,29669595,In > Out
Apr 2020,127,45,2,85348576,45448279,130796855,1,2,2,39900297,Out > In
Apr 2020,127,48,3,3709386,4644995,8354381,1,3,3,935609,In > Out
Apr 2020,127,5,15,20048444,754147791,774196235,3,3,15,734099347,In > Out
Apr 2020,127,50,1,18821019,11009643,29830662,1,1,1,7811376,Out > In
Apr 2020,127,52,24,112744232,4887428,117631660,11,12,2,107856804,Out > In
Apr 2020,127,55,1073,88497656340,724635425,89222291765,639,574,135,87773020915,Out > In
Apr 2020,127,56,5,607733636,403405821,1011139457,4,4,5,204327815,Out > In
Apr 2020,127,59,18,30146511,29436222,59582733,18,18,4,710289,Out > In
Apr 2020,127,64,1,9669937,14910024,24579961,1,1,1,5240087,In > Out
Apr 2020,127,65,1,472079,210153,682232,1,1,1,261926,Out > In
Apr 2020,127,66,1,7753270,20277251,28030521,1,1,1,12523981,In > Out
Apr 2020,127,7,1,18506100,83743771,102249871,1,1,1,65237671,In > Out
Apr 2020,127,73,7,1380934,2124526,3505460,6,2,7,743592,In > Out
Apr 2020,127,74,2,16863,253010,269873,2,2,2,236147,In > Out
Apr 2020,127,80,2,844532581,1287402968,2131935549,2,2,2,442870387,In > Out
Apr 2020,127,82,5,4115886,5215832,9331718,4,3,5,1099946,In > Out
Apr 2020,127,89,1,10979,210295,221274,1,1,1,199316,In > Out
Apr 2020,127,92,341,16323211032,955635688,17278846720,73,139,11,15367575344,Out > In
Apr 2020,127,93,1,7499843,9961503,17461346,1,1,1,2461660,In > Out
Apr 2020,127,94,10,1775627,2395601,4171228,7,1,10,619974,In > Out
Apr 2020,127,95,3,10804902,11019968,21824870,1,3,3,215066,In > Out
Apr 2020,127,98,1,4224,109054,113278,1,1,1,104830,In > Out
Apr 2020,128,101,4,2382559036,317207664,2699766700,3,3,1,2065351372,Out > In
Apr 2020,128,105,1,1232024,398539,1630563,1,1,1,833485,Out > In
Apr 2020,128,107,9,9859067,10180016,20039083,6,9,7,320949,In > Out
Apr 2020,128,110,3,417291,5004578,5421869,2,2,3,4587287,In > Out
Apr 2020,128,111,4,4158063252,3965835177,8123898429,2,3,2,192228075,Out > In
Apr 2020,128,112,12,55421465,89716343,145137808,10,11,5,34294878,In > Out
Apr 2020,128,116,1,47249,58412,105661,1,1,1,11163,In > Out
Apr 2020,128,124,1,231443,167743,399186,1,1,1,63700,Out > In
Apr 2020,128,125,7,117098903,143438371,260537274,5,6,6,26339468,In > Out
Apr 2020,128,130,1,29452,87535,116987,1,1,1,58083,In > Out
Apr 2020,128,132,3,4176841,2447658887,2451835728,1,1,3,2443482046,In > Out
Apr 2020,128,14,4,1075773979,1113286786,2189060765,4,4,4,37512807,In > Out
Apr 2020,128,141,2,15325184,47745897,63071081,1,1,2,32420713,In > Out
Apr 2020,128,142,11,12660498,16605176,29265674,4,10,5,3944678,In > Out
Apr 2020,128,146,4,955724517,670382482,1626106999,3,4,4,285342035,Out > In
Apr 2020,128,153,1,479067,16329849,16808916,1,1,1,15850782,In > Out
Apr 2020,128,155,4,59448500,60641613,120090113,2,4,4,1193113,In > Out
Apr 2020,128,156,3,34748380,36860884,71609264,1,1,2,2112504,In > Out
Apr 2020,128,159,4,322025356,1091313795,1413339151,3,3,4,769288439,In > Out
Apr 2020,128,16,1,153205964,154969323,308175287,1,1,1,1763359,In > Out
Apr 2020,128,162,4,394995982,379247983,774243965,2,4,2,15747999,Out > In
Apr 2020,128,163,4,755464047,680485914,1435949961,2,4,3,74978133,Out > In
Apr 2020,128,165,2,2863237,26392374,29255611,2,2,2,23529137,In > Out
Apr 2020,128,177,1,1575953,25866565,27442518,1,1,1,24290612,In > Out
Apr 2020,128,181,5,514875254,437083288,951958542,3,5,5,77791966,Out > In
Apr 2020,128,182,126,118872196,124655404,243527600,121,23,1,5783208,In > Out
Apr 2020,128,186,1,473089,1541730,2014819,1,1,1,1068641,In > Out
Apr 2020,128,187,9,78914546,124086097,203000643,5,6,9,45171551,In > Out
Apr 2020,128,189,1,302423903,257481604,559905507,1,1,1,44942299,Out > In
Apr 2020,128,19,9,227125120,403225602,630350722,3,9,9,176100482,In > Out
Apr 2020,128,191,1,29275695,17665067,46940762,1,1,1,11610628,Out > In
Apr 2020,128,192,9,519018,1640422,2159440,5,5,3,1121404,In > Out
Apr 2020,128,195,2,395847493,1371417474,1767264967,2,2,2,975569981,In > Out
Apr 2020,128,199,9,924501328,1355813010,2280314338,8,8,9,431311682,In > Out
Apr 2020,128,206,4,1934124,815051,2749175,4,4,2,1119073,Out > In
Apr 2020,128,207,2,66072,503766,569838,2,2,2,437694,In > Out
Apr 2020,128,21,3,167008,1088506,1255514,2,3,3,921498,In > Out
Apr 2020,128,210,1,3204328,3891104,7095432,1,1,1,686776,In > Out
Apr 2020,128,212,2,2527753,98664162,101191915,1,1,2,96136409,In > Out
Apr 2020,128,214,32,91099596,136275107,227374703,31,31,14,45175511,In > Out
Apr 2020,128,215,1,6505303,149635502,156140805,1,1,1,143130199,In > Out
Apr 2020,128,219,2,2836193,49865265,52701458,2,2,2,47029072,In > Out
Apr 2020,128,220,1,100024,117459,217483,1,1,1,17435,In > Out
Apr 2020,128,25,3,7476270,27953665,35429935,3,3,3,20477395,In > Out
Apr 2020,128,27,1,68848402,40406495,109254897,1,1,1,28441907,Out > In
Apr 2020,128,44,1,137563002,129157803,266720805,1,1,1,8405199,Out > In
Apr 2020,128,57,1,27479061,19861760,47340821,1,1,1,7617301,Out > In
Apr 2020,128,60,1,13467575,14133811,27601386,1,1,1,666236,In > Out
Apr 2020,128,62,1,32870450,30659694,63530144,1,1,1,2210756,Out > In
Apr 2020,128,65,1,31457,279086,310543,1,1,1,247629,In > Out
Apr 2020,128,68,19,2772802151,4958283613,7731085764,7,18,17,2185481462,In > Out
Apr 2020,128,70,2,186910992,213253776,400164768,2,2,2,26342784,In > Out
Apr 2020,128,77,2,450619,643338,1093957,2,2,2,192719,In > Out
Apr 2020,128,79,8,2785189120,3124580446,5909769566,6,5,4,339391326,In > Out
Apr 2020,128,84,5,279439977,494372248,773812225,3,4,4,214932271,In > Out
Apr 2020,128,94,6,31583340,1875152214,1906735554,4,3,6,1843568874,In > Out
Apr 2020,128,96,1,4278027,24880262,29158289,1,1,1,20602235,In > Out
Apr 2020,129,10,4,743246,24247,767493,3,4,1,718999,Out > In
Apr 2020,129,160,1408,243868948,8729187,252598135,578,1380,2,235139761,Out > In
Apr 2020,129,203,1,6444382,77789880,84234262,1,1,1,71345498,In > Out
Apr 2020,129,229,6,1342008,1316352,2658360,2,1,1,25656,Out > In
Apr 2020,129,230,633,329342628,80051184,409393812,184,258,1,249291444,Out > In
Apr 2020,129,234,2,777792,9430,787222,1,2,1,768362,Out > In
Apr 2020,129,236,101,52664,21525946,21578610,12,90,1,21473282,In > Out
Apr 2020,129,242,2434,717047882,274979116,992026998,51,2013,1,442068766,Out > In
Apr 2020,129,31,3,675599,8027,683626,3,3,1,667572,Out > In
Apr 2020,129,36,1,546708,8317,555025,1,1,1,538391,Out > In
Apr 2020,129,46,2,180164,44964,225128,1,1,2,135200,Out > In
Apr 2020,129,51,11,1756107,673030,2429137,9,11,1,1083077,Out > In
Apr 2020,129,52,2493,909108165,350291654,1259399819,44,2192,1,558816511,Out > In
Apr 2020,129,57,1,154267,157368,311635,1,1,1,3101,In > Out
Apr 2020,129,63,1,1553172,2316208,3869380,1,1,1,763036,In > Out
Apr 2020,129,87,3,8936909,36534105,45471014,3,3,3,27597196,In > Out
Apr 2020,129,97,1,290529,4484,295013,1,1,1,286045,Out > In
Apr 2020,13,16,5,14305130,764047,15069177,1,5,1,13541083,Out > In
Apr 2020,130,104,4,428731123,323291730,752022853,3,2,4,105439393,Out > In
Apr 2020,130,119,2,939040,144824337,145763377,1,2,2,143885297,In > Out
Apr 2020,130,86,4,797592309,21360291,818952600,1,4,4,776232018,Out > In
Apr 2020,131,110,2,18681431,35573087,54254518,2,2,2,16891656,In > Out
Apr 2020,131,113,6,66133587,402354928,468488515,6,5,5,336221341,In > Out
Apr 2020,131,115,2,394782460,325076507,719858967,1,1,2,69705953,Out > In
Apr 2020,131,118,1,285352,14091212,14376564,1,1,1,13805860,In > Out
Apr 2020,131,121,7,12750833,53508614,66259447,7,7,7,40757781,In > Out
Apr 2020,131,124,1,77245522,83991388,161236910,1,1,1,6745866,In > Out
Apr 2020,131,125,675,3018856761,2040982509,5059839270,203,670,3,977874252,Out > In
Apr 2020,131,128,1,656702412,664858556,1321560968,1,1,1,8156144,In > Out
Apr 2020,131,129,1,188864,68058,256922,1,1,1,120806,Out > In
Apr 2020,131,131,20,703373246,617853213,1321226459,14,19,12,85520033,Out > In
Apr 2020,131,132,2,428240954,272858314,701099268,2,2,2,155382640,Out > In
Apr 2020,131,136,1,43381926,292557744,335939670,1,1,1,249175818,In > Out
Apr 2020,131,138,11,209741197,418751780,628492977,2,11,1,209010583,In > Out
Apr 2020,131,139,1,19947586,119873022,139820608,1,1,1,99925436,In > Out
Apr 2020,131,14,4,180774505,415740344,596514849,4,4,4,234965839,In > Out
Apr 2020,131,141,8,710712,18377490,19088202,7,7,3,17666778,In > Out
Apr 2020,131,145,3,277771,1036912,1314683,2,1,3,759141,In > Out
Apr 2020,131,151,2,66806898,274820487,341627385,2,2,2,208013589,In > Out
Apr 2020,131,152,1,4652519,6949764,11602283,1,1,1,2297245,In > Out
Apr 2020,131,167,12,1769324482,1689548478,3458872960,8,12,9,79776004,Out > In
Apr 2020,131,171,3,212880139,174916641,387796780,2,3,3,37963498,Out > In
Apr 2020,131,175,5,15995317,20120672,36115989,4,5,3,4125355,In > Out
Apr 2020,131,176,1,45172,4188014,4233186,1,1,1,4142842,In > Out
Apr 2020,131,177,1,103328,36436,139764,1,1,1,66892,Out > In
Apr 2020,131,18,3,7698827,9925823,17624650,3,3,3,2226996,In > Out
Apr 2020,131,181,2421,103970021881,4965833045,108935854926,1575,1389,6,99004188836,Out > In
Apr 2020,131,186,5,1335260492,1446748051,2782008543,4,2,4,111487559,In > Out
Apr 2020,131,188,1,229728674,207978774,437707448,1,1,1,21749900,Out > In
Apr 2020,131,192,1,252037039,170040910,422077949,1,1,1,81996129,Out > In
Apr 2020,131,193,3,301915455,655792381,957707836,3,3,3,353876926,In > Out
Apr 2020,131,196,2,19235380,19068019,38303399,1,1,2,167361,Out > In
Apr 2020,131,201,2,234868,3415044,3649912,1,1,2,3180176,In > Out
Apr 2020,131,207,14,635851,28866529,29502380,1,1,14,28230678,In > Out
Apr 2020,131,210,1,103742256,20362155,124104411,1,1,1,83380101,Out > In
Apr 2020,131,219,5,2258458,11260606,13519064,5,5,5,9002148,In > Out
Apr 2020,131,220,2,401747091,481833199,883580290,1,1,2,80086108,In > Out
Apr 2020,131,24,7,71028623,304496955,375525578,7,6,6,233468332,In > Out
Apr 2020,131,29,3,1250216,61248,1311464,3,3,1,1188968,Out > In
Apr 2020,131,30,4,1564698579,1392152300,2956850879,1,4,1,172546279,Out > In
Apr 2020,131,33,15,1598464,5575140,7173604,2,1,15,3976676,In > Out
Apr 2020,131,35,1,4130297,26656063,30786360,1,1,1,22525766,In > Out
Apr 2020,131,39,48,10271738,50838921,61110659,8,21,48,40567183,In > Out
Apr 2020,131,40,54,55453132,61219759,116672891,53,15,2,5766627,In > Out
Apr 2020,131,41,5,13263393,104257530,117520923,5,5,5,90994137,In > Out
Apr 2020,131,45,13,899514841,1070329330,1969844171,5,12,12,170814489,In > Out
Apr 2020,131,49,1,4532720,4054272,8586992,1,1,1,478448,Out > In
Apr 2020,131,52,5,55574298,65282924,120857222,3,4,5,9708626,In > Out
Apr 2020,131,54,3,4944331,5082213,10026544,3,3,2,137882,In > Out
Apr 2020,131,57,22,5873607,24988797,30862404,7,14,22,19115190,In > Out
Apr 2020,131,61,4,28684,683005,711689,1,1,4,654321,In > Out
Apr 2020,131,8,2,139037,1697778,1836815,2,1,2,1558741,In > Out
Apr 2020,131,86,2,7275078,20957985,28233063,2,2,2,13682907,In > Out
Apr 2020,131,87,12,645548371,548313652,1193862023,10,12,8,97234719,Out > In
Apr 2020,131,94,1,374836,348804,723640,1,1,1,26032,Out > In
Apr 2020,131,98,12,23031635,116054427,139086062,9,8,12,93022792,In > Out
Apr 2020,132,100,9,528494,32978361,33506855,7,6,5,32449867,In > Out
Apr 2020,132,105,3,12230282,10848159,23078441,2,3,2,1382123,Out > In
Apr 2020,132,106,13,170486811,88357125,258843936,5,10,13,82129686,Out > In
Apr 2020,132,112,67,61812707,296300752,358113459,3,2,67,234488045,In > Out
Apr 2020,132,116,7,221222121,312436524,533658645,6,6,6,91214403,In > Out
Apr 2020,132,119,3,144116075,280353604,424469679,3,3,3,136237529,In > Out
Apr 2020,132,120,1,7809,139272,147081,1,1,1,131463,In > Out
Apr 2020,132,122,12,1325743910,1714046102,3039790012,7,4,11,388302192,In > Out
Apr 2020,132,124,1,6145629,5527744,11673373,1,1,1,617885,Out > In
Apr 2020,132,129,40,761149,29823511,30584660,1,1,40,29062362,In > Out
Apr 2020,132,139,2,211320,335548,546868,2,2,2,124228,In > Out
Apr 2020,132,145,5,6116618,333916684,340033302,2,1,5,327800066,In > Out
Apr 2020,132,148,2,829997244,596425072,1426422316,2,2,2,233572172,Out > In
Apr 2020,132,153,1,307855735,300184769,608040504,1,1,1,7670966,Out > In
Apr 2020,132,154,1,149132,297898,447030,1,1,1,148766,In > Out
Apr 2020,132,158,3,98669602,259995370,358664972,2,3,3,161325768,In > Out
Apr 2020,132,165,8,771567022,602540543,1374107565,8,8,8,169026479,Out > In
Apr 2020,132,170,2,1059813393,2032412469,3092225862,2,2,2,972599076,In > Out
Apr 2020,132,175,8,1364864,4568146,5933010,3,6,8,3203282,In > Out
Apr 2020,132,176,18,15459379,346961227,362420606,1,18,12,331501848,In > Out
Apr 2020,132,178,4,748118,2239380,2987498,2,4,4,1491262,In > Out
Apr 2020,132,179,4,280829794,304605434,585435228,2,3,2,23775640,In > Out
Apr 2020,132,181,2,817990,3073555,3891545,2,2,2,2255565,In > Out
Apr 2020,132,182,1,1551603,18291375,19842978,1,1,1,16739772,In > Out
Apr 2020,132,183,1,106662615,92898084,199560699,1,1,1,13764531,Out > In
Apr 2020,132,184,27,85460520,591893533,677354053,27,27,27,506433013,In > Out
Apr 2020,132,191,94,216052104,231701015,447753119,85,93,94,15648911,In > Out
Apr 2020,132,194,7,36746020,34216352,70962372,3,7,7,2529668,Out > In
Apr 2020,132,197,1,63233313,57651595,120884908,1,1,1,5581718,Out > In
Apr 2020,132,201,9,352146,2831896,3184042,6,8,9,2479750,In > Out
Apr 2020,132,204,4,689179,61174,750353,4,4,1,628005,Out > In
Apr 2020,132,21,3,1306209,919116,2225325,2,2,2,387093,Out > In
Apr 2020,132,216,1,5616,130816,136432,1,1,1,125200,In > Out
Apr 2020,132,223,98,1523955012,1851182724,3375137736,47,67,22,327227712,In > Out
Apr 2020,132,23,2,947375,16954849,17902224,1,1,2,16007474,In > Out
Apr 2020,132,28,1,259589949,245431456,505021405,1,1,1,14158493,Out > In
Apr 2020,132,29,3,6738262,6180380,12918642,3,2,3,557882,Out > In
Apr 2020,132,43,2,147139070,553100509,700239579,1,1,2,405961439,In > Out
Apr 2020,132,48,1,111109367,264388560,375497927,1,1,1,153279193,In > Out
Apr 2020,132,49,1,192507,97504,290011,1,1,1,95003,Out > In
Apr 2020,132,50,3,172981389,229309174,402290563,2,2,2,56327785,In > Out
Apr 2020,132,56,5,62571422,70322653,132894075,4,5,5,7751231,In > Out
Apr 2020,132,58,1,94752,79172,173924,1,1,1,15580,Out > In
Apr 2020,132,6,2,218212579,550570587,768783166,2,2,2,332358008,In > Out
Apr 2020,132,7,7,614388126,1032051559,1646439685,4,7,6,417663433,In > Out
Apr 2020,132,71,505,1673653098,178927592,1852580690,145,448,3,1494725506,Out > In
Apr 2020,132,76,1,1406856,4764514,6171370,1,1,1,3357658,In > Out
Apr 2020,132,78,1,1514846,1434941,2949787,1,1,1,79905,Out > In
Apr 2020,132,79,1,7833300,7133269,14966569,1,1,1,700031,Out > In
Apr 2020,132,82,4,226308426,1058570781,1284879207,3,1,4,832262355,In > Out
Apr 2020,132,85,1,878656,4274184,5152840,1,1,1,3395528,In > Out
Apr 2020,132,89,1,15368412,31296637,46665049,1,1,1,15928225,In > Out
Apr 2020,132,96,8,1272388,1591102,2863490,8,8,2,318714,In > Out
Apr 2020,132,98,1,887330,10349073,11236403,1,1,1,9461743,In > Out
Apr 2020,133,103,4,2160086,909612119,911772205,3,3,4,907452033,In > Out
Apr 2020,133,104,6,1327701,16947095,18274796,5,5,2,15619394,In > Out
Apr 2020,133,106,1,58644,80857,139501,1,1,1,22213,In > Out
Apr 2020,133,11,2,373899,625686,999585,1,2,2,251787,In > Out
Apr 2020,133,116,3,63223527,22537192,85760719,2,3,1,40686335,Out > In
Apr 2020,133,121,1,5667981,3001357,8669338,1,1,1,2666624,Out > In
Apr 2020,133,123,1,224013,164974,388987,1,1,1,59039,Out > In
Apr 2020,133,131,1,1174054,2358842,3532896,1,1,1,1184788,In > Out
Apr 2020,133,135,8,333381194,228700312,562081506,6,6,5,104680882,Out > In
Apr 2020,133,137,4,38557395,202507492,241064887,3,1,4,163950097,In > Out
Apr 2020,133,138,1,103776790,263012374,366789164,1,1,1,159235584,In > Out
Apr 2020,133,140,1,85104,30324,115428,1,1,1,54780,Out > In
Apr 2020,133,142,1,58010274,40117017,98127291,1,1,1,17893257,Out > In
Apr 2020,133,147,7,25611869,71966353,97578222,7,7,6,46354484,In > Out
Apr 2020,133,15,4,214034051,221495506,435529557,3,4,4,7461455,In > Out
Apr 2020,133,150,2,23241701,23258679,46500380,2,2,2,16978,In > Out
Apr 2020,133,156,3,4924107,7958344,12882451,2,3,3,3034237,In > Out
Apr 2020,133,16,1,200367,8870541,9070908,1,1,1,8670174,In > Out
Apr 2020,133,163,1,42114,745193,787307,1,1,1,703079,In > Out
Apr 2020,133,164,2,7260514,13774846,21035360,2,2,2,6514332,In > Out
Apr 2020,133,165,3,6171327,102241708,108413035,2,2,3,96070381,In > Out
Apr 2020,133,168,8,8055919,7725141,15781060,2,8,2,330778,Out > In
Apr 2020,133,169,2,212065895,492681990,704747885,2,2,2,280616095,In > Out
Apr 2020,133,17,4,59336796,159245739,218582535,4,4,3,99908943,In > Out
Apr 2020,133,171,1,93427885,88209860,181637745,1,1,1,5218025,Out > In
Apr 2020,133,188,4,9856893,35786982,45643875,3,4,4,25930089,In > Out
Apr 2020,133,19,1,642905,644637,1287542,1,1,1,1732,In > Out
Apr 2020,133,192,14,194779,5912353,6107132,14,14,2,5717574,In > Out
Apr 2020,133,193,1,4071480,11462991,15534471,1,1,1,7391511,In > Out
Apr 2020,133,198,1,21777300,480089595,501866895,1,1,1,458312295,In > Out
Apr 2020,133,201,26,1397653072,242495629,1640148701,24,8,1,1155157443,Out > In
Apr 2020,133,204,5,24075832,64803621,88879453,5,5,5,40727789,In > Out
Apr 2020,133,207,99,9060259,690240088,699300347,55,72,1,681179829,In > Out
Apr 2020,133,211,25,5368297956,7110980790,12479278746,4,24,24,1742682834,In > Out
Apr 2020,133,216,1,9209843,24947464,34157307,1,1,1,15737621,In > Out
Apr 2020,133,217,5,20449749,126035767,146485516,5,5,5,105586018,In > Out
Apr 2020,133,220,1,70458,88663,159121,1,1,1,18205,In > Out
Apr 2020,133,223,2,134988,191124,326112,2,2,2,56136,In > Out
Apr 2020,133,25,3,17679903,139337706,157017609,1,1,3,121657803,In > Out
Apr 2020,133,27,2,27068852,29127107,56195959,2,2,2,2058255,In > Out
Apr 2020,133,31,1,644561,3300058,3944619,1,1,1,2655497,In > Out
Apr 2020,133,37,33,28741596,75119797,103861393,28,11,33,46378201,In > Out
Apr 2020,133,44,21,1417834732,1723443184,3141277916,7,15,21,305608452,In > Out
Apr 2020,133,45,111,799705352,1089183885,1888889237,94,102,8,289478533,In > Out
Apr 2020,133,46,4,52838672,119008016,171846688,2,1,4,66169344,In > Out
Apr 2020,133,47,5,5118294,242792858,247911152,3,2,5,237674564,In > Out
Apr 2020,133,54,911,63222979121,1493254776,64716233897,641,579,6,61729724345,Out > In
Apr 2020,133,57,1,233832,4541561,4775393,1,1,1,4307729,In > Out
Apr 2020,133,61,2,217467976,163026597,380494573,2,2,2,54441379,Out > In
Apr 2020,133,62,7,363987441,411274742,775262183,5,6,4,47287301,In > Out
Apr 2020,133,63,7,3206507539,2151995301,5358502840,4,7,7,1054512238,Out > In
Apr 2020,133,70,3,1294366387,1327403192,2621769579,2,3,2,33036805,In > Out
Apr 2020,133,75,2,3513122,21717055,25230177,2,2,2,18203933,In > Out
Apr 2020,133,84,5,537801380,795809091,1333610471,5,5,4,258007711,In > Out
Apr 2020,133,95,506,10554315,381663328,392217643,494,485,54,371109013,In > Out
Apr 2020,134,102,1,58135,1777260,1835395,1,1,1,1719125,In > Out
Apr 2020,134,110,7,100891535,1147587715,1248479250,5,2,7,1046696180,In > Out
Apr 2020,134,115,3,1637902,1377902,3015804,3,3,3,260000,Out > In
Apr 2020,134,123,3,109522181,488961032,598483213,1,1,3,379438851,In > Out
Apr 2020,134,127,1,583897545,490108934,1074006479,1,1,1,93788611,Out > In
Apr 2020,134,130,2,9860135,7399650,17259785,1,2,2,2460485,Out > In
Apr 2020,134,131,1,328186225,336746194,664932419,1,1,1,8559969,In > Out
Apr 2020,134,136,1,420879,561259,982138,1,1,1,140380,In > Out
Apr 2020,134,138,5,504300,928772,1433072,4,5,5,424472,In > Out
Apr 2020,134,142,1,145665,1697247,1842912,1,1,1,1551582,In > Out
Apr 2020,134,156,16,433881785,17178006,451059791,10,9,1,416703779,Out > In
Apr 2020,134,162,13,2469048006,2118023348,4587071354,6,12,11,351024658,Out > In
Apr 2020,134,167,1,375050,633808,1008858,1,1,1,258758,In > Out
Apr 2020,134,174,1,974894,701345,1676239,1,1,1,273549,Out > In
Apr 2020,134,180,3,29946549,21282340,51228889,3,3,2,8664209,Out > In
Apr 2020,134,182,1,80812,117554,198366,1,1,1,36742,In > Out
Apr 2020,134,185,1,4517768,2699101,7216869,1,1,1,1818667,Out > In
Apr 2020,134,190,434,11750753,419239007,430989760,424,415,58,407488254,In > Out
Apr 2020,134,192,5,25531062,85149624,110680686,2,2,2,59618562,In > Out
Apr 2020,134,194,3,11696197,24965048,36661245,2,2,3,13268851,In > Out
Apr 2020,134,20,1,3571816,3406286,6978102,1,1,1,165530,Out > In
Apr 2020,134,204,7,269389767,272268888,541658655,6,7,7,2879121,In > Out
Apr 2020,134,206,4,4622216,5846494356,5851116572,4,4,4,5841872140,In > Out
Apr 2020,134,209,508,14553064,554138960,568692024,485,477,116,539585896,In > Out
Apr 2020,134,213,1,599976,668355,1268331,1,1,1,68379,In > Out
Apr 2020,134,217,85,194910475,239935845,434846320,82,41,83,45025370,In > Out
Apr 2020,134,218,1,179682641,277864110,457546751,1,1,1,98181469,In > Out
Apr 2020,134,222,1,569922,110004,679926,1,1,1,459918,Out > In
Apr 2020,134,23,3,2683202,1553879,4237081,3,3,3,1129323,Out > In
Apr 2020,134,26,2,25418593,50013369,75431962,2,2,2,24594776,In > Out
Apr 2020,134,30,35,345608,8159206,8504814,35,35,7,7813598,In > Out
Apr 2020,134,34,2,169345878,137163907,306509785,1,1,2,32181971,Out > In
Apr 2020,134,42,8,146914296,11838795348,11985709644,3,8,4,11691881052,In > Out
Apr 2020,134,47,1,59395214,10412854,69808068,1,1,1,48982360,Out > In
Apr 2020,134,48,1,104375101,157244286,261619387,1,1,1,52869185,In > Out
Apr 2020,134,52,3,15745,495672,511417,2,2,3,479927,In > Out
Apr 2020,134,53,3,5221093,175149387,180370480,1,1,3,169928294,In > Out
Apr 2020,134,64,3,345331756,410429818,755761574,2,2,3,65098062,In > Out
Apr 2020,134,66,892,284605691,2968103237,3252708928,756,833,61,2683497546,In > Out
Apr 2020,134,7,6,12363582,15129727,27493309,6,6,6,2766145,In > Out
Apr 2020,134,73,1,129361582,116482049,245843631,1,1,1,12879533,Out > In
Apr 2020,134,76,16,24813176,43133931,67947107,13,8,16,18320755,In > Out
Apr 2020,134,80,4,3725957,11344962,15070919,4,4,4,7619005,In > Out
Apr 2020,134,81,17,7168992,23276472,30445464,17,17,5,16107480,In > Out
Apr 2020,134,84,1,2514543,41527103,44041646,1,1,1,39012560,In > Out
Apr 2020,134,86,1,280296,16385804,16666100,1,1,1,16105508,In > Out
Apr 2020,134,88,3,413621061,768333192,1181954253,2,2,3,354712131,In > Out
Apr 2020,134,91,1,200462872,200291191,400754063,1,1,1,171681,Out > In
Apr 2020,134,98,11,10508843,60090489,70599332,8,8,9,49581646,In > Out
Apr 2020,14,12,3,371743,192660,564403,2,3,1,179083,Out > In
Apr 2020,14,16,41,178403231,6882106,185285337,1,41,1,171521125,Out > In
Apr 2020,142,10,33,5445906,105813,5551719,2,33,1,5340093,Out > In
Apr 2020,142,11,66,16955836,1895653,18851489,14,66,2,15060183,Out > In
Apr 2020,142,121,9,14217281,117682,14334963,7,9,1,14099599,Out > In
Apr 2020,142,14,16,83360,11525807,11609167,1,16,16,11442447,In > Out
Apr 2020,142,16,36,474839721,7111326,481951047,8,36,1,467728395,Out > In
Apr 2020,142,17,11463,25059154,2259963112,2285022266,16,6368,3,2234903958,In > Out
Apr 2020,142,18,29,21478175,588091,22066266,21,29,2,20890084,Out > In
Apr 2020,142,19,27,15313466,263369,15576835,20,27,1,15050097,Out > In
Apr 2020,142,22,1024946,1190110693833,18352317563,1208463011396,3329,63075,2,1171758376270,Out > In
Apr 2020,142,24,74,688722125,13475555,702197680,9,74,2,675246570,Out > In
Apr 2020,142,28,9223,25287022,2507925179,2533212201,2,978,2,2482638157,In > Out
Apr 2020,142,30,2,336574,127371,463945,1,2,1,209203,Out > In
Apr 2020,142,32,1,203943,6422,210365,1,1,1,197521,Out > In
Apr 2020,142,35,183,183167443,3891513,187058956,68,183,2,179275930,Out > In
Apr 2020,142,36,2421,890591518,30187131,920778649,120,2279,1860,860404387,Out > In
Apr 2020,142,37,5,1508490,24776,1533266,2,5,1,1483714,Out > In
Apr 2020,142,43,8718,1075843486,29286878,1105130364,656,7605,1,1046556608,Out > In
Apr 2020,142,44,2,242868,8252,251120,2,2,1,234616,Out > In
Apr 2020,142,46,97,60771457,1104527,61875984,40,93,1,59666930,Out > In
Apr 2020,142,47,2,148159,157169,305328,2,2,1,9010,In > Out
Apr 2020,142,49,4,1012076,9260,1021336,3,4,1,1002816,Out > In
Apr 2020,142,51,2,219198,11430,230628,1,2,1,207768,Out > In
Apr 2020,142,52,2,425241,9159,434400,1,2,1,416082,Out > In
Apr 2020,142,53,216,492308262,7209758,499518020,86,215,1,485098504,Out > In
Apr 2020,142,54,17697,7389126231,153610947,7542737178,1080,13248,161,7235515284,Out > In
Apr 2020,142,55,747,944898743,8725427,953624170,408,733,1,936173316,Out > In
Apr 2020,142,56,15753,5004343940,75009340,5079353280,69,2614,13331,4929334600,Out > In
Apr 2020,142,57,12065,8472639964,105576576,8578216540,84,2559,10477,8367063388,Out > In
Apr 2020,142,58,1392,2467308072,57485497,2524793569,83,1356,693,2409822575,Out > In
Apr 2020,142,59,12588,6565138008,79265538,6644403546,67,1625,10904,6485872470,Out > In
Apr 2020,142,60,2,2279179,130435257,132714436,2,2,2,128156078,In > Out
Apr 2020,142,61,3,388394,198348,586742,2,3,1,190046,Out > In
Apr 2020,142,63,14,64172832,774849,64947681,4,14,2,63397983,Out > In
Apr 2020,142,66,1360,1556475879,23208277,1579684156,295,1344,1,1533267602,Out > In
Apr 2020,142,68,7,42432,985369,1027801,3,1,7,942937,In > Out
Apr 2020,142,69,27,1683262,70179838,71863100,5,2,27,68496576,In > Out
Apr 2020,142,70,19,97721,2278465,2376186,1,1,19,2180744,In > Out
Apr 2020,142,71,2007,19876714,658918309,678795023,6,8,1883,639041595,In > Out
Apr 2020,142,73,6290,2001968608,38429637,2040398245,162,5723,1,1963538971,Out > In
Apr 2020,142,74,60,38844697,756558,39601255,34,60,1,38088139,Out > In
Apr 2020,142,75,4,958760,384536,1343296,2,4,1,574224,Out > In
Apr 2020,142,79,62,761578,27031540,27793118,10,2,62,26269962,In > Out
Apr 2020,142,84,2,352369,136625,488994,1,2,1,215744,Out > In
Apr 2020,142,86,1167,2492279,145853492,148345771,4,1150,2,143361213,In > Out
Apr 2020,142,87,4,819898,297186,1117084,2,4,1,522712,Out > In
Apr 2020,142,88,1,129318,80456,209774,1,1,1,48862,Out > In
Apr 2020,142,89,3,487957,223827,711784,2,3,1,264130,Out > In
Apr 2020,142,9,44,26341245,1137172,27478417,9,44,2,25204073,Out > In
Apr 2020,142,90,1,170841,83099,253940,1,1,1,87742,Out > In
Apr 2020,142,91,10,1164154,599974,1764128,6,10,1,564180,Out > In
Apr 2020,142,93,27,2773447,225313,2998760,5,27,1,2548134,Out > In
Apr 2020,142,96,23,22876122,344263,23220385,10,23,2,22531859,Out > In
Apr 2020,142,97,12,7349012,194235,7543247,3,12,1,7154777,Out > In
Apr 2020,142,98,1,158142,64293,222435,1,1,1,93849,Out > In
Apr 2020,142,99,1,121541,77959,199500,1,1,1,43582,Out > In
Apr 2020,143,128,16,291530971,147283379,438814350,14,13,15,144247592,Out > In
Apr 2020,143,152,78,2504500152,43948870838,46453370990,31,27,76,41444370686,In > Out
Apr 2020,143,20,14,1570729877,1791207307,3361937184,10,10,12,220477430,In > Out
Apr 2020,143,205,2,29090093,29728768,58818861,2,2,2,638675,In > Out
Apr 2020,143,28,91,50660687,227676638,278337325,61,9,89,177015951,In > Out
Apr 2020,143,32,4,615964175,241504976,857469151,2,2,4,374459199,Out > In
Apr 2020,144,142,10,2586406,134312,2720718,4,10,1,2452094,Out > In
Apr 2020,146,119,2,2756137,275064142,277820279,2,2,2,272308005,In > Out
Apr 2020,146,152,1,14822,287557,302379,1,1,1,272735,In > Out
Apr 2020,146,157,1,64295,20497983,20562278,1,1,1,20433688,In > Out
Apr 2020,149,15,13,3434532,179674,3614206,9,13,2,3254858,Out > In
Apr 2020,149,160,414,783631760,243938152,1027569912,210,305,1,539693608,Out > In
Apr 2020,149,187,10,1607224,496105,2103329,7,10,2,1111119,Out > In
Apr 2020,149,205,4,3870048,101202,3971250,2,4,1,3768846,Out > In
Apr 2020,149,63,3956,25717625418,1220134350,26937759768,504,3581,1,24497491068,Out > In
Apr 2020,150,115,5,7640690,915241035,922881725,2,1,5,907600345,In > Out
Apr 2020,150,143,2,1138314,69839288,70977602,1,1,2,68700974,In > Out
Apr 2020,150,15,2,19562195,701695,20263890,1,1,2,18860500,Out > In
Apr 2020,150,182,14295,62741371894,2383464337,65124836231,2853,9854,1,60357907557,Out > In
Apr 2020,150,70,2,255436,13309658,13565094,1,1,2,13054222,In > Out
Apr 2020,151,51,182,33904728,19000018,52904746,23,16,1,14904710,Out > In
Apr 2020,154,100,2370,847352157,336602583,1183954740,25,2134,3,510749574,Out > In
Apr 2020,154,172,1,15832,267340,283172,1,1,1,251508,In > Out
Apr 2020,155,103,8,3547709,210049,3757758,7,8,2,3337660,Out > In
Apr 2020,155,106,121,30464505,15673867,46138372,25,22,2,14790638,Out > In
Apr 2020,155,135,644,3214718523,48851250,3263569773,147,634,98,3165867273,Out > In
Apr 2020,155,136,67,113019159,1840952,114860111,16,67,2,111178207,Out > In
Apr 2020,155,137,2091,6444701930,85066462,6529768392,149,2014,2,6359635468,Out > In
Apr 2020,155,142,14760,5238170717,90946260,5329116977,182,11898,4,5147224457,Out > In
Apr 2020,155,143,192,151566158,6461298,158027456,83,146,2,145104860,Out > In
Apr 2020,155,146,9,3500411,1533439782,1536940193,6,9,3,1529939371,In > Out
Apr 2020,155,149,266778,142592801302,2722098149,145314899451,5929,49912,4,139870703153,Out > In
Apr 2020,155,150,4915,2821980298,75981632,2897961930,369,4574,2,2745998666,Out > In
Apr 2020,155,151,549,28491536954,352672639,28844209593,182,542,14,28138864315,Out > In
Apr 2020,155,153,266,592184772,3704298,595889070,12,213,2,588480474,Out > In
Apr 2020,155,154,163,90159661,2249992,92409653,55,163,2,87909669,Out > In
Apr 2020,155,166,2,233815,19249,253064,1,2,1,214566,Out > In
Apr 2020,155,167,20,6634571,667654,7302225,12,20,2,5966917,Out > In
Apr 2020,155,169,458,859170617,317060510,1176231127,218,348,3,542110107,Out > In
Apr 2020,155,170,951,1045910404,223123258,1269033662,505,431,1,822787146,Out > In
Apr 2020,155,198,380,164770819,3733188,168504007,77,380,2,161037631,Out > In
Apr 2020,155,199,8,28941855,251176,29193031,6,8,1,28690679,Out > In
Apr 2020,155,201,41,103841417,1042162,104883579,6,41,2,102799255,Out > In
Apr 2020,155,202,549,198101658,54017992,252119650,27,539,2,144083666,Out > In
Apr 2020,155,205,2234,492255301,23624373,515879674,88,2173,2,468630928,Out > In
Apr 2020,155,72,24,6035333,223757,6259090,9,24,2,5811576,Out > In
Apr 2020,155,73,5,1770733,56125,1826858,2,5,1,1714608,Out > In
Apr 2020,155,74,6,1785617,57326,1842943,2,6,1,1728291,Out > In
Apr 2020,155,75,8,2325382,80085,2405467,5,8,1,2245297,Out > In
Apr 2020,156,189,21,3348223,130455892,133804115,8,3,21,127107669,In > Out
Apr 2020,159,67,1,361902,677680,1039582,1,1,1,315778,In > Out
Apr 2020,16,10,1,171550,38493,210043,1,1,1,133057,Out > In
Apr 2020,16,14,33,1793478305,46899105,1840377410,9,32,31,1746579200,Out > In
Apr 2020,16,16,5,254518,1259868,1514386,1,1,5,1005350,In > Out
Apr 2020,16,20,19,65349271,4074049,69423320,7,5,4,61275222,Out > In
Apr 2020,160,105,2,105346316,4187256,109533572,1,1,2,101159060,Out > In
Apr 2020,160,109,49,16263744,11240443,27504187,1,1,49,5023301,Out > In
Apr 2020,160,110,1,275809,7399,283208,1,1,1,268410,Out > In
Apr 2020,160,121,176,8958284019,9655634353,18613918372,70,97,138,697350334,In > Out
Apr 2020,160,122,205,4833764869,5250163347,10083928216,48,56,160,416398478,In > Out
Apr 2020,160,123,406,8811780103,3005549290,11817329393,285,328,133,5806230813,Out > In
Apr 2020,160,124,239,11789931316,9036513137,20826444453,62,41,237,2753418179,Out > In
Apr 2020,160,125,89,8637801633,30593131925,39230933558,52,36,76,21955330292,In > Out
Apr 2020,160,126,134,5220731714,5496228022,10716959736,53,61,103,275496308,In > Out
Apr 2020,160,127,119,10177700716,8176579199,18354279915,53,55,119,2001121517,Out > In
Apr 2020,160,128,18,1368130502,2731328180,4099458682,10,10,18,1363197678,In > Out
Apr 2020,160,132,1,322036,682946,1004982,1,1,1,360910,In > Out
Apr 2020,160,152,106,542082509,1622819609,2164902118,69,85,105,1080737100,In > Out
Apr 2020,160,153,141,835748607,2391938276,3227686883,98,107,138,1556189669,In > Out
Apr 2020,160,154,110,657501929,1952973301,2610475230,74,89,110,1295471372,In > Out
Apr 2020,160,155,109,610138550,1787686189,2397824739,78,80,108,1177547639,In > Out
Apr 2020,160,156,141,866186311,2540976063,3407162374,93,110,141,1674789752,In > Out
Apr 2020,160,157,96,595866835,1750894623,2346761458,67,73,95,1155027788,In > Out
Apr 2020,160,16,3,1501567,1320736,2822303,1,3,3,180831,Out > In
Apr 2020,160,196,2361,77586940050,165114875727,242701815777,1304,617,1859,87527935677,In > Out
Apr 2020,160,197,2894,71848487054,167641077867,239489564921,1417,756,1709,95792590813,In > Out
Apr 2020,160,198,2186,87405894561,175436286767,262842181328,1134,374,1818,88030392206,In > Out
Apr 2020,160,199,2129,87634693139,195599186871,283233880010,1126,397,1707,107964493732,In > Out
Apr 2020,160,200,674,16310562524,39511420662,55821983186,378,119,439,23200858138,In > Out
Apr 2020,160,201,673,17992250564,44923244067,62915494631,376,100,448,26930993503,In > Out
Apr 2020,160,202,846,21170472004,51322899274,72493371278,443,165,591,30152427270,In > Out
Apr 2020,160,203,766,22206441388,59106374784,81312816172,398,122,517,36899933396,In > Out
Apr 2020,160,236,1,31131,117828,148959,1,1,1,86697,In > Out
Apr 2020,160,238,15,2203329459,42927719,2246257178,4,15,14,2160401740,Out > In
Apr 2020,160,239,111,770532053,1585442754,2355974807,86,88,66,814910701,In > Out
Apr 2020,160,240,53,1111307547,1959700092,3071007639,35,41,41,848392545,In > Out
Apr 2020,160,241,17,1614472849,1549374925,3163847774,10,6,17,65097924,Out > In
Apr 2020,160,242,143,5592181444,6871732176,12463913620,100,58,116,1279550732,In > Out
Apr 2020,160,243,13,260369776,277382021,537751797,7,6,13,17012245,In > Out
Apr 2020,160,244,162,1722270754,4116696447,5838967201,131,128,43,2394425693,In > Out
Apr 2020,160,245,14,464598291,877065553,1341663844,7,5,14,412467262,In > Out
Apr 2020,160,246,279,1119081080,1436357324,2555438404,241,89,34,317276244,In > Out
Apr 2020,160,247,18,1288609743,1234582545,2523192288,11,9,18,54027198,Out > In
Apr 2020,160,33,1,1680424,26556514,28236938,1,1,1,24876090,In > Out
Apr 2020,160,34,13,1655722,334405780,336061502,1,1,13,332750058,In > Out
Apr 2020,160,36,29,27647042,6520164,34167206,7,1,5,21126878,Out > In
Apr 2020,160,38,1,1983025,2725027,4708052,1,1,1,742002,In > Out
Apr 2020,160,39,66,58301546,16392108,74693654,11,1,9,41909438,Out > In
Apr 2020,160,57,17,1841868747,26086131,1867954878,3,17,17,1815782616,Out > In
Apr 2020,160,58,17,1197176538,746440883,1943617421,7,16,17,450735655,Out > In
Apr 2020,160,59,18,867907245,40593217,908500462,4,18,18,827314028,Out > In
Apr 2020,160,60,8,285980631,892696755,1178677386,4,8,8,606716124,In > Out
Apr 2020,160,61,2,83190150,1611965,84802115,2,2,2,81578185,Out > In
Apr 2020,160,62,25,1545105252,91810013,1636915265,7,23,25,1453295239,Out > In
Apr 2020,160,63,40,2100625158,510516282,2611141440,5,24,25,1590108876,Out > In
Apr 2020,160,65,25,381611005,860671560,1242282565,12,8,23,479060555,In > Out
Apr 2020,160,66,13,95317356,13237178,108554534,8,11,13,82080178,Out > In
Apr 2020,160,67,30,472779710,403221337,876001047,13,22,30,69558373,Out > In
Apr 2020,160,68,24,1474108568,1337509208,2811617776,15,18,23,136599360,Out > In
Apr 2020,160,69,27,667143786,524127717,1191271503,12,21,25,143016069,Out > In
Apr 2020,160,70,33,922099541,790764383,1712863924,13,14,32,131335158,Out > In
Apr 2020,160,71,9,1167104,1372683,2539787,3,3,5,205579,In > Out
Apr 2020,160,72,79,1855167302,175974355,2031141657,31,73,43,1679192947,Out > In
Apr 2020,160,77,1,28371,9138843,9167214,1,1,1,9110472,In > Out
Apr 2020,161,102,6,697304004,1081220160,1778524164,4,6,6,383916156,In > Out
Apr 2020,161,105,1,70646,208096,278742,1,1,1,137450,In > Out
Apr 2020,161,107,6,4759297,96868603,101627900,5,6,6,92109306,In > Out
Apr 2020,161,112,1,30295723,100884479,131180202,1,1,1,70588756,In > Out
Apr 2020,161,113,2,20047181,20299867,40347048,2,2,2,252686,In > Out
Apr 2020,161,116,1,1644628,1667103,3311731,1,1,1,22475,In > Out
Apr 2020,161,119,7,39524516,39063369,78587885,2,7,2,461147,Out > In
Apr 2020,161,121,1,47039,122240,169279,1,1,1,75201,In > Out
Apr 2020,161,129,2,231928,371921,603849,2,2,2,139993,In > Out
Apr 2020,161,130,1,467807919,514795403,982603322,1,1,1,46987484,In > Out
Apr 2020,161,133,7,250362549,890654661,1141017210,3,3,3,640292112,In > Out
Apr 2020,161,135,9,8214611,14546868,22761479,9,9,9,6332257,In > Out
Apr 2020,161,139,8,302082095,557096012,859178107,4,8,6,255013917,In > Out
Apr 2020,161,144,1,581540,560360,1141900,1,1,1,21180,Out > In
Apr 2020,161,148,39,3022766,79551518,82574284,32,34,9,76528752,In > Out
Apr 2020,161,152,2,1796492,3818103,5614595,2,2,2,2021611,In > Out
Apr 2020,161,153,5,102034966,198448766,300483732,1,5,5,96413800,In > Out
Apr 2020,161,16,3,18663946,128722688,147386634,2,2,3,110058742,In > Out
Apr 2020,161,160,4,50898983,215563871,266462854,2,2,4,164664888,In > Out
Apr 2020,161,165,1,49355,5737197,5786552,1,1,1,5687842,In > Out
Apr 2020,161,167,16,794826476,1805472397,2600298873,9,4,16,1010645921,In > Out
Apr 2020,161,168,2,52437567,75807863,128245430,2,2,2,23370296,In > Out
Apr 2020,161,17,1,5320545,1881117,7201662,1,1,1,3439428,Out > In
Apr 2020,161,174,47,264381047,1142987167,1407368214,47,42,47,878606120,In > Out
Apr 2020,161,176,1,33449557,12869903,46319460,1,1,1,20579654,Out > In
Apr 2020,161,180,1,6977919,4821625,11799544,1,1,1,2156294,Out > In
Apr 2020,161,182,5,89614611,333475053,423089664,3,5,5,243860442,In > Out
Apr 2020,161,183,2,108763928,457141322,565905250,1,1,1,348377394,In > Out
Apr 2020,161,186,19,1224657198,2373007879,3597665077,7,17,19,1148350681,In > Out
Apr 2020,161,187,1,3060036,2632280,5692316,1,1,1,427756,Out > In
Apr 2020,161,188,2,10195843,10148502,20344345,1,2,1,47341,Out > In
Apr 2020,161,189,225,6549043,231218595,237767638,210,205,40,224669552,In > Out
Apr 2020,161,195,3,17056313,13260939,30317252,2,3,3,3795374,Out > In
Apr 2020,161,20,2,22164037,32732118,54896155,2,2,2,10568081,In > Out
Apr 2020,161,201,1,5752017,258262299,264014316,1,1,1,252510282,In > Out
Apr 2020,161,202,1,3721507,3165827,6887334,1,1,1,555680,Out > In
Apr 2020,161,203,5,130148008,255216622,385364630,2,1,5,125068614,In > Out
Apr 2020,161,208,11,1067866790,902676981,1970543771,6,11,11,165189809,Out > In
Apr 2020,161,216,1,98542,83692,182234,1,1,1,14850,Out > In
Apr 2020,161,220,1,2954480,3866486,6820966,1,1,1,912006,In > Out
Apr 2020,161,31,4,127341601,92357750,219699351,3,3,2,34983851,Out > In
Apr 2020,161,33,1,273246828,26774058,300020886,1,1,1,246472770,Out > In
Apr 2020,161,35,1,928825,161566,1090391,1,1,1,767259,Out > In
Apr 2020,161,37,12,869355037,1745454639,2614809676,11,12,12,876099602,In > Out
Apr 2020,161,38,1,57838,374121,431959,1,1,1,316283,In > Out
Apr 2020,161,40,7,16549092,248623530,265172622,7,6,7,232074438,In > Out
Apr 2020,161,43,5,13907574,36084264,49991838,2,5,5,22176690,In > Out
Apr 2020,161,44,21,2289557,12277950,14567507,8,2,21,9988393,In > Out
Apr 2020,161,50,2,10031805,29465004,39496809,2,2,2,19433199,In > Out
Apr 2020,161,51,1,1997524,1956187,3953711,1,1,1,41337,Out > In
Apr 2020,161,53,2,1132402,1310361,2442763,2,2,2,177959,In > Out
Apr 2020,161,56,160,5055063,178355589,183410652,156,155,28,173300526,In > Out
Apr 2020,161,6,1,5726672,46464456,52191128,1,1,1,40737784,In > Out
Apr 2020,161,63,1,203136,2604428,2807564,1,1,1,2401292,In > Out
Apr 2020,161,65,1,108504626,322559347,431063973,1,1,1,214054721,In > Out
Apr 2020,161,67,3,11343432,21282856,32626288,3,2,2,9939424,In > Out
Apr 2020,161,76,2,9985211,73596514,83581725,1,1,2,63611303,In > Out
Apr 2020,161,78,9,4334234,61220873,65555107,9,9,1,56886639,In > Out
Apr 2020,161,91,3,731078976,669890866,1400969842,1,2,2,61188110,Out > In
Apr 2020,161,95,4,112995100,369484802,482479902,1,1,4,256489702,In > Out
Apr 2020,161,96,5,88250935,291776392,380027327,3,2,5,203525457,In > Out
Apr 2020,164,81,157,31530048,17681264,49211312,23,14,1,13848784,Out > In
Apr 2020,164,82,125,24731256,13885212,38616468,18,16,1,10846044,Out > In
Apr 2020,164,83,2786,1014969546,367261604,1382231150,70,2086,3,647707942,Out > In
Apr 2020,164,93,107,28342776,15888392,44231168,19,16,1,12454384,Out > In
Apr 2020,165,153,1,25550751,5502401,31053152,1,1,1,20048350,Out > In
Apr 2020,165,158,2,7749406,2563610,10313016,1,2,2,5185796,Out > In
Apr 2020,165,176,710,554759406,17005725426,17560484832,10,699,2,16450966020,In > Out
Apr 2020,165,233,3163,27227847799,965715883,28193563682,775,2398,1,26262131916,Out > In
Apr 2020,165,61,1,1628802,386616799,388245601,1,1,1,384987997,In > Out
Apr 2020,165,70,4,717409833,18155539,735565372,1,4,4,699254294,Out > In
Apr 2020,166,198,4,1017376063,1421507505,2438883568,3,2,4,404131442,In > Out
Apr 2020,166,34,1,587252,415021,1002273,1,1,1,172231,Out > In
Apr 2020,167,156,1,14891603,303651,15195254,1,1,1,14587952,Out > In
Apr 2020,167,24,1,556759,19069,575828,1,1,1,537690,Out > In
Apr 2020,167,40,4,21665586,340079553,361745139,2,1,4,318413967,In > Out
Apr 2020,168,112,181,45172933,23405222,68578155,32,24,16,21767711,Out > In
Apr 2020,168,153,9,52024724,387573,52412297,2,9,1,51637151,Out > In
Apr 2020,168,155,32696,87727688368,3512421371,91240109739,6252,14972,1,84215266997,Out > In
Apr 2020,168,159,4,1105392,44162,1149554,3,4,1,1061230,Out > In
Apr 2020,168,164,1,33288,1245284,1278572,1,1,1,1211996,In > Out
Apr 2020,168,186,42,115328178,1770381,117098559,13,42,2,113557797,Out > In
Apr 2020,168,21,1,466681,63744463,64211144,1,1,1,63277782,In > Out
Apr 2020,168,29,4,1151177,30713,1181890,3,4,1,1120464,Out > In
Apr 2020,168,57,2911,913635849,340286375,1253922224,81,2398,5,573349474,Out > In
Apr 2020,168,85,28,15666684,191266,15857950,14,28,1,15475418,Out > In
Apr 2020,169,156,5,7081964,1014312,8096276,1,5,1,6067652,Out > In
Apr 2020,169,194,1,102848437,13695796995,13798645432,1,1,1,13592948558,In > Out
Apr 2020,169,4,7,817765,289874,1107639,2,7,1,527891,Out > In
Apr 2020,169,6,163,144182902568,204587598759,348770501327,48,157,45,60404696191,In > Out
Apr 2020,169,8,313,12432922369,30292064907,42724987276,46,201,1,17859142538,In > Out
Apr 2020,169,82,57,16087650,1333852,17421502,31,57,1,14753798,Out > In
Apr 2020,169,87,7,1912690,256156,2168846,4,7,1,1656534,Out > In
Apr 2020,170,129,622,81640160,63153130,144793290,4,615,3,18487030,Out > In
Apr 2020,170,227,10,1294967,681837,1976804,8,10,2,613130,Out > In
Apr 2020,170,241,1,3522019,278996,3801015,1,1,1,3243023,Out > In
Apr 2020,170,246,1,1085735,264120928,265206663,1,1,1,263035193,In > Out
Apr 2020,171,101,6,46995899,71225623,118221522,2,6,1,24229724,In > Out
Apr 2020,171,102,10,251842387,948328771,1200171158,7,5,9,696486384,In > Out
Apr 2020,171,103,4,42380739,36741964,79122703,2,4,4,5638775,Out > In
Apr 2020,171,104,3,77279611,235686112,312965723,3,2,3,158406501,In > Out
Apr 2020,171,105,3,3579752263,373326451,3953078714,3,3,3,3206425812,Out > In
Apr 2020,171,107,1,66623,58763,125386,1,1,1,7860,Out > In
Apr 2020,171,112,8,57697098,115680427,173377525,8,7,6,57983329,In > Out
Apr 2020,171,114,7,9756906,62537348,72294254,7,7,1,52780442,In > Out
Apr 2020,171,116,2,2339066,2172575,4511641,2,2,2,166491,Out > In
Apr 2020,171,125,1,2746,116342,119088,1,1,1,113596,In > Out
Apr 2020,171,127,4,42265614,137665286,179930900,4,4,4,95399672,In > Out
Apr 2020,171,128,5,122022674,440800299,562822973,3,3,5,318777625,In > Out
Apr 2020,171,133,1,130772,116716,247488,1,1,1,14056,Out > In
Apr 2020,171,134,9,59700579,78995161,138695740,8,7,9,19294582,In > Out
Apr 2020,171,137,1,52670046,48331086,101001132,1,1,1,4338960,Out > In
Apr 2020,171,139,2,49166,772141,821307,2,2,2,722975,In > Out
Apr 2020,171,141,31,16686782,41052309,57739091,16,25,30,24365527,In > Out
Apr 2020,171,142,5,7509616,9210726,16720342,5,5,5,1701110,In > Out
Apr 2020,171,143,3,18412875,29753801,48166676,3,3,2,11340926,In > Out
Apr 2020,171,145,5,1711266,40695617,42406883,1,5,5,38984351,In > Out
Apr 2020,171,148,1,14534260,29115004,43649264,1,1,1,14580744,In > Out
Apr 2020,171,149,10,890986252,925424122,1816410374,6,9,8,34437870,In > Out
Apr 2020,171,15,3,571769655,544458941,1116228596,3,3,3,27310714,Out > In
Apr 2020,171,150,15,1204752,5803251,7008003,1,1,15,4598499,In > Out
Apr 2020,171,151,1,952837,22859177,23812014,1,1,1,21906340,In > Out
Apr 2020,171,153,14,88514289,82606486,171120775,9,11,12,5907803,Out > In
Apr 2020,171,157,7,304722865,586191546,890914411,5,7,7,281468681,In > Out
Apr 2020,171,16,8,18639096,43352840,61991936,7,5,8,24713744,In > Out
Apr 2020,171,165,1,1147541,139168859,140316400,1,1,1,138021318,In > Out
Apr 2020,171,167,5,1193317208,1195427777,2388744985,3,2,3,2110569,In > Out
Apr 2020,171,168,3,29047089,28683960,57731049,2,3,3,363129,Out > In
Apr 2020,171,17,3,628030731,1036861745,1664892476,3,3,3,408831014,In > Out
Apr 2020,171,170,1,80752,70422,151174,1,1,1,10330,Out > In
Apr 2020,171,173,1,342712,987917,1330629,1,1,1,645205,In > Out
Apr 2020,171,175,2,3833968,26550175,30384143,2,2,2,22716207,In > Out
Apr 2020,171,179,54,270717390,118726757,389444147,45,54,51,151990633,Out > In
Apr 2020,171,181,4,2192051,1553601,3745652,3,3,4,638450,Out > In
Apr 2020,171,184,8,293273,979774,1273047,3,5,8,686501,In > Out
Apr 2020,171,185,3,3045216,14930056,17975272,3,3,3,11884840,In > Out
Apr 2020,171,186,4,434479214,392909686,827388900,2,4,4,41569528,Out > In
Apr 2020,171,187,3,868518329,859574396,1728092725,2,3,3,8943933,Out > In
Apr 2020,171,188,2,158316152,157553729,315869881,2,2,2,762423,Out > In
Apr 2020,171,196,39,7062558,176023284,183085842,37,38,3,168960726,In > Out
Apr 2020,171,205,6,5624143,116872978,122497121,3,2,6,111248835,In > Out
Apr 2020,171,206,18,473897884,462819017,936716901,9,16,17,11078867,Out > In
Apr 2020,171,209,3,13694872,3617304,17312176,2,2,3,10077568,Out > In
Apr 2020,171,215,8,2935128,6085275,9020403,6,3,8,3150147,In > Out
Apr 2020,171,222,5,77795893,222167668,299963561,4,4,5,144371775,In > Out
Apr 2020,171,30,1,30455,5212144,5242599,1,1,1,5181689,In > Out
Apr 2020,171,42,3,4849562,16255289,21104851,2,2,3,11405727,In > Out
Apr 2020,171,44,8,90933269,11509999531,11600932800,3,8,4,11419066262,In > Out
Apr 2020,171,47,2,1961603,7771429,9733032,1,1,2,5809826,In > Out
Apr 2020,171,48,1,2069071,2286197,4355268,1,1,1,217126,In > Out
Apr 2020,171,64,1,327734963,330293088,658028051,1,1,1,2558125,In > Out
Apr 2020,171,66,3,2248960,2040661,4289621,2,3,3,208299,Out > In
Apr 2020,171,72,1,161963359,158972675,320936034,1,1,1,2990684,Out > In
Apr 2020,171,75,2,301959168,270806864,572766032,2,2,2,31152304,Out > In
Apr 2020,171,76,2,130018,324595,454613,2,1,2,194577,In > Out
Apr 2020,171,81,12,965816,34808491,35774307,12,12,5,33842675,In > Out
Apr 2020,171,84,1,151242,30734,181976,1,1,1,120508,Out > In
Apr 2020,171,86,1,295084,57318,352402,1,1,1,237766,Out > In
Apr 2020,171,92,261,12292163,433158440,445450603,248,244,44,420866277,In > Out
Apr 2020,171,96,3,68935282,6286675,75221957,2,2,1,62648607,Out > In
Apr 2020,174,167,7,4333448,12638216,16971664,2,1,2,8304768,In > Out
Apr 2020,175,192,13,220488169,27933920,248422089,1,13,1,192554249,Out > In
Apr 2020,176,175,4,530394,281831,812225,2,4,1,248563,Out > In
Apr 2020,177,174,11,9709944,257171,9967115,2,11,1,9452773,Out > In
Apr 2020,178,118,1,85643,56051,141694,1,1,1,29592,Out > In
Apr 2020,178,78,2,1635180,329063475,330698655,1,1,2,327428295,In > Out
Apr 2020,179,160,32193,87860107382,3480071171,91340178553,6225,15233,2,84380036211,Out > In
Apr 2020,179,44,6,1768471,126314,1894785,1,6,1,1642157,Out > In
Apr 2020,179,87,68,50302150,2235583,52537733,7,68,1,48066567,Out > In
Apr 2020,180,140,2,1199102,87455680,88654782,1,1,1,86256578,In > Out
Apr 2020,180,189,398,228813371,92675522,321488893,173,378,3,136137849,Out > In
Apr 2020,180,32,1,5005659,9408000,14413659,1,1,1,4402341,In > Out
Apr 2020,180,96,4,108128553,247971653,356100206,2,1,4,139843100,In > Out
Apr 2020,181,127,4,356568106,12086678,368654784,1,4,4,344481428,Out > In
Apr 2020,181,168,4238,1421567310,457804794,1879372104,179,3853,4,963762516,Out > In
Apr 2020,181,182,2,334664,154034,488698,1,2,1,180630,Out > In
Apr 2020,181,212,184,52973998,15846249,68820247,28,23,2,37127749,Out > In
Apr 2020,181,228,1,146496,12625,159121,1,1,1,133871,Out > In
Apr 2020,181,244,2569,955351544,362879185,1318230729,52,2179,2,592472359,Out > In
Apr 2020,181,248,27,715009842,1868855666,2583865508,10,25,27,1153845824,In > Out
Apr 2020,181,59,3,5770241,23947294,29717535,2,1,3,18177053,In > Out
Apr 2020,181,64,553,110574061,54257825,164831886,91,132,2,56316236,Out > In
Apr 2020,181,9,2,2148445,25486955,27635400,1,1,2,23338510,In > Out
Apr 2020,183,119,201,289909461,6066987,295976448,65,198,1,283842474,Out > In
Apr 2020,183,17,982,398690083,15010719,413700802,51,974,1,383679364,Out > In
Apr 2020,183,19,4,3246913,30170098,33417011,4,4,2,26923185,In > Out
Apr 2020,183,77,1,40854836,124580588,165435424,1,1,1,83725752,In > Out
Apr 2020,183,93,1,24838488,436134804,460973292,1,1,1,411296316,In > Out
Apr 2020,183,94,4,6470120,18325573,24795693,4,4,4,11855453,In > Out
Apr 2020,184,134,400,270802391,226659295,497461686,83,396,8,44143096,Out > In
Apr 2020,184,135,80,151823975,43044614,194868589,5,80,1,108779361,Out > In
Apr 2020,184,136,90,42418861,49384013,91802874,3,3,86,6965152,In > Out
Apr 2020,184,216,10,306912,807356,1114268,2,9,2,500444,In > Out
Apr 2020,184,218,4,20196752,1339933,21536685,1,4,1,18856819,Out > In
Apr 2020,184,219,23,503259,5081496,5584755,3,21,23,4578237,In > Out
Apr 2020,184,220,38,59400209,291459203,350859412,28,11,30,232058994,In > Out
Apr 2020,19,100,1,58164,101594,159758,1,1,1,43430,In > Out
Apr 2020,19,105,10,2980684,63307,3043991,1,10,1,2917377,Out > In
Apr 2020,19,106,14,3403777,80424,3484201,1,14,1,3323353,Out > In
Apr 2020,19,12,1,54332,82224,136556,1,1,1,27892,In > Out
Apr 2020,19,121,2,111508,190360,301868,1,2,1,78852,In > Out
Apr 2020,19,122,1,2214,218162,220376,1,1,1,215948,In > Out
Apr 2020,19,130,8,899850,38564,938414,2,8,1,861286,Out > In
Apr 2020,19,138,2,119818,179106,298924,2,2,1,59288,In > Out
Apr 2020,19,140,7,966375,121713,1088088,2,7,2,844662,Out > In
Apr 2020,19,141,6129,4238969402,6949919028,11188888430,164,5237,1,2710949626,In > Out
Apr 2020,19,142,9,1273643,48606,1322249,2,9,1,1225037,Out > In
Apr 2020,19,143,273,3825367,194452689,198278056,24,267,2,190627322,In > Out
Apr 2020,19,150,111628,49784697625,3714880122,53499577747,21636,31385,2,46069817503,Out > In
Apr 2020,19,152,44070,6092347227,2597731938,8690079165,2879,17283,2,3494615289,Out > In
Apr 2020,19,155,27,3975692,11895872,15871564,10,27,2,7920180,In > Out
Apr 2020,19,160,286,216929023,6232285,223161308,205,283,1,210696738,Out > In
Apr 2020,19,165,158,45065875,5090686,50156561,122,158,1,39975189,Out > In
Apr 2020,19,166,4,738142,20725,758867,2,4,1,717417,Out > In
Apr 2020,19,167,43,8167019,528378,8695397,14,43,1,7638641,Out > In
Apr 2020,19,190,3,466273,15303,481576,2,3,1,450970,Out > In
Apr 2020,19,191,555,1818186711,252185410,2070372121,47,546,2,1566001301,Out > In
Apr 2020,19,193,48,150681065,53148826,203829891,5,48,2,97532239,Out > In
Apr 2020,19,27,1,72417,107045,179462,1,1,1,34628,In > Out
Apr 2020,19,28,13,3939952,87160,4027112,1,13,1,3852792,Out > In
Apr 2020,19,87,14,3291760,166921,3458681,3,14,2,3124839,Out > In
Apr 2020,19,92,13,4078482,88016,4166498,1,13,1,3990466,Out > In
Apr 2020,19,98,1,54994,85625,140619,1,1,1,30631,In > Out
Apr 2020,190,128,1201,188686368,5773512,194459880,171,1158,1,182912856,Out > In
Apr 2020,190,135,11,3056097,278367,3334464,3,11,2,2777730,Out > In
Apr 2020,190,140,449,94215820,1796855,96012675,65,440,1,92418965,Out > In
Apr 2020,190,158,2,306090,182169,488259,1,2,1,123921,Out > In
Apr 2020,190,164,3,413193,206872,620065,2,3,1,206321,Out > In
Apr 2020,190,165,3,422070,151881,573951,3,3,2,270189,Out > In
Apr 2020,190,184,4,959214,19445,978659,4,4,1,939769,Out > In
Apr 2020,190,185,24,8970792,175148,9145940,1,24,1,8795644,Out > In
Apr 2020,190,188,7,10885600,254286,11139886,5,7,1,10631314,Out > In
Apr 2020,190,199,69820,46626867474,1669561715,48296429189,20052,36230,2,44957305759,Out > In
Apr 2020,190,216,3,318560,17241,335801,1,3,1,301319,Out > In
Apr 2020,190,37,83,32140166,2506252,34646418,29,82,2,29633914,Out > In
Apr 2020,190,39,166,78416961,12011567,90428528,12,164,1,66405394,Out > In
Apr 2020,190,43,1784,262122588,7768852,269891440,454,1719,1,254353736,Out > In
Apr 2020,190,44,20857,5025099709,149134283,5174233992,1585,15311,2,4875965426,Out > In
Apr 2020,190,46,29,451233883,18788864,470022747,5,29,2,432445019,Out > In
Apr 2020,190,48,12716,382492308,8494745927,8877238235,5,8782,5,8112253619,In > Out
Apr 2020,190,57,1,19587,90625,110212,1,1,1,71038,In > Out
Apr 2020,190,91,108,12552230,658558,13210788,87,106,2,11893672,Out > In
Apr 2020,191,13,11,3532527017,697506696,4230033713,2,11,1,2835020321,Out > In
Apr 2020,191,48,1,65637155,618067,66255222,1,1,1,65019088,Out > In
Apr 2020,191,56,12,948590177,23647783,972237960,1,12,12,924942394,Out > In
Apr 2020,192,38,2,143216,407238,550454,1,2,1,264022,In > Out
Apr 2020,192,40,9,698892,18167334,18866226,2,6,5,17468442,In > Out
Apr 2020,192,44,1,47679,132307,179986,1,1,1,84628,In > Out
Apr 2020,195,10,4,9321811,11432711,20754522,3,3,3,2110900,In > Out
Apr 2020,195,11,4,27664575,80957476,108622051,4,4,1,53292901,In > Out
Apr 2020,195,113,7,45415195,586635509,632050704,5,4,7,541220314,In > Out
Apr 2020,195,114,3,51779430,45091431,96870861,3,3,3,6687999,Out > In
Apr 2020,195,115,5,314989088,964434518,1279423606,3,3,5,649445430,In > Out
Apr 2020,195,117,1,17758796,58468569,76227365,1,1,1,40709773,In > Out
Apr 2020,195,12,1,330761001,369632816,700393817,1,1,1,38871815,In > Out
Apr 2020,195,128,1,40094036,86476528,126570564,1,1,1,46382492,In > Out
Apr 2020,195,130,10,302371663,201548666,503920329,5,9,8,100822997,Out > In
Apr 2020,195,132,1,4065,481914,485979,1,1,1,477849,In > Out
Apr 2020,195,134,1,87142,116943,204085,1,1,1,29801,In > Out
Apr 2020,195,137,2,954174,2337694,3291868,1,1,1,1383520,In > Out
Apr 2020,195,140,8,52884118,195642612,248526730,5,5,5,142758494,In > Out
Apr 2020,195,141,1,1698955,8293316,9992271,1,1,1,6594361,In > Out
Apr 2020,195,150,1,38510281,33223981,71734262,1,1,1,5286300,Out > In
Apr 2020,195,153,3,31560238,25477326,57037564,3,3,3,6082912,Out > In
Apr 2020,195,157,1,1129518,2916870,4046388,1,1,1,1787352,In > Out
Apr 2020,195,159,1,6842172,6090427,12932599,1,1,1,751745,Out > In
Apr 2020,195,161,1,470570,666503,1137073,1,1,1,195933,In > Out
Apr 2020,195,168,1,2114840,1419404,3534244,1,1,1,695436,Out > In
Apr 2020,195,172,4,104839997,70402223,175242220,1,4,3,34437774,Out > In
Apr 2020,195,174,2,739964,202115625,202855589,1,1,2,201375661,In > Out
Apr 2020,195,177,15,1085866,51070103,52155969,2,1,15,49984237,In > Out
Apr 2020,195,180,8,12944179,66383853,79328032,4,8,8,53439674,In > Out
Apr 2020,195,181,3,40457358,16243382,56700740,2,3,2,24213976,Out > In
Apr 2020,195,192,1,69196,189743,258939,1,1,1,120547,In > Out
Apr 2020,195,194,2,16815081,69571159,86386240,1,1,2,52756078,In > Out
Apr 2020,195,198,1,53070864,52922061,105992925,1,1,1,148803,Out > In
Apr 2020,195,20,2,18827,277916,296743,1,1,2,259089,In > Out
Apr 2020,195,200,3,885616778,905873729,1791490507,3,3,3,20256951,In > Out
Apr 2020,195,206,8,184724437,210414968,395139405,8,6,8,25690531,In > Out
Apr 2020,195,208,1,54168,54397054,54451222,1,1,1,54342886,In > Out
Apr 2020,195,210,1,7871483,9642344,17513827,1,1,1,1770861,In > Out
Apr 2020,195,218,9,66339287,436816262,503155549,4,8,3,370476975,In > Out
Apr 2020,195,22,18,448086993,643778749,1091865742,18,16,18,195691756,In > Out
Apr 2020,195,221,16,318236447,967147740,1285384187,8,3,16,648911293,In > Out
Apr 2020,195,222,7,15618411,18447556,34065967,6,5,7,2829145,In > Out
Apr 2020,195,223,1,174498421,230982580,405481001,1,1,1,56484159,In > Out
Apr 2020,195,30,1,165029,1897696,2062725,1,1,1,1732667,In > Out
Apr 2020,195,35,1,10607525,30458086,41065611,1,1,1,19850561,In > Out
Apr 2020,195,41,2,1420076,285303,1705379,2,2,2,1134773,Out > In
Apr 2020,195,42,2,24760029,369524274,394284303,2,2,2,344764245,In > Out
Apr 2020,195,52,4,25445295,31145749,56591044,4,4,3,5700454,In > Out
Apr 2020,195,54,1,72894,1234982,1307876,1,1,1,1162088,In > Out
Apr 2020,195,55,2,358136,2279667,2637803,2,2,2,1921531,In > Out
Apr 2020,195,56,2,885848,817384,1703232,2,2,2,68464,Out > In
Apr 2020,195,60,1,114974,1136488,1251462,1,1,1,1021514,In > Out
Apr 2020,195,61,3,7727049,5487412,13214461,2,3,2,2239637,Out > In
Apr 2020,195,65,1,80720,25600,106320,1,1,1,55120,Out > In
Apr 2020,195,66,1,7080,143360,150440,1,1,1,136280,In > Out
Apr 2020,195,68,869,27852328445,1275590145,29127918590,195,324,60,26576738300,Out > In
Apr 2020,195,73,4,1997220,1887807,3885027,4,4,4,109413,Out > In
Apr 2020,195,74,23,686506,72245157,72931663,23,23,1,71558651,In > Out
Apr 2020,195,77,1,396787687,385784669,782572356,1,1,1,11003018,Out > In
Apr 2020,195,79,522,936769385,48817244,985586629,78,202,2,887952141,Out > In
Apr 2020,195,82,3,2807777,2367207,5174984,2,3,1,440570,Out > In
Apr 2020,195,83,2,913444717,732744565,1646189282,1,2,2,180700152,Out > In
Apr 2020,195,84,7,416111234,702872300,1118983534,3,7,7,286761066,In > Out
Apr 2020,195,89,1,5272918,192661718,197934636,1,1,1,187388800,In > Out
Apr 2020,196,110,2,214836,17088,231924,2,2,1,197748,Out > In
Apr 2020,196,124,1,112440,9173,121613,1,1,1,103267,Out > In
Apr 2020,196,126,3,208323,161154,369477,3,3,2,47169,Out > In
Apr 2020,196,136,2,193649,111863,305512,2,2,2,81786,Out > In
Apr 2020,196,165,3,324582,25055,349637,3,3,1,299527,Out > In
Apr 2020,196,166,2,149646,229369,379015,1,2,1,79723,In > Out
Apr 2020,196,171,2,163876,83546,247422,2,2,2,80330,Out > In
Apr 2020,196,186,2,216607,15825,232432,2,2,1,200782,Out > In
Apr 2020,196,188,1,112376,7524,119900,1,1,1,104852,Out > In
Apr 2020,196,197,1,104139,8131,112270,1,1,1,96008,Out > In
Apr 2020,196,199,1,109752,7179,116931,1,1,1,102573,Out > In
Apr 2020,196,202,2,189746,109828,299574,2,2,2,79918,Out > In
Apr 2020,196,206,1,66076,88239,154315,1,1,1,22163,In > Out
Apr 2020,196,212,2,217767,16356,234123,2,2,1,201411,Out > In
Apr 2020,196,213,2,214845,13819,228664,2,2,1,201026,Out > In
Apr 2020,196,23,1,61494,86480,147974,1,1,1,24986,In > Out
Apr 2020,196,25,1,57789,89491,147280,1,1,1,31702,In > Out
Apr 2020,196,27,4,389504,102714,492218,4,4,2,286790,Out > In
Apr 2020,196,28,1,107331,9890,117221,1,1,1,97441,Out > In
Apr 2020,196,38,1,92755,109211,201966,1,1,1,16456,In > Out
Apr 2020,196,45,1,68570,106048,174618,1,1,1,37478,In > Out
Apr 2020,196,48,1,109539,8020,117559,1,1,1,101519,Out > In
Apr 2020,196,64,2,105612,166692,272304,2,2,1,61080,In > Out
Apr 2020,196,66,3,319590,23482,343072,3,3,1,296108,Out > In
Apr 2020,196,70,2,171857,98449,270306,2,2,2,73408,Out > In
Apr 2020,196,73,4,380054,115655,495709,3,4,2,264399,Out > In
Apr 2020,196,78,2,199305,14810,214115,2,2,1,184495,Out > In
Apr 2020,196,82,1,50714,77070,127784,1,1,1,26356,In > Out
Apr 2020,196,90,2,217335,17719,235054,2,2,1,199616,Out > In
Apr 2020,196,91,1,52636,74440,127076,1,1,1,21804,In > Out
Apr 2020,196,93,2,168887,97339,266226,2,2,2,71548,Out > In
Apr 2020,196,95,2,161504,75275,236779,2,2,2,86229,Out > In
Apr 2020,197,101,6,17560796,13002752,30563548,6,5,1,4558044,Out > In
Apr 2020,197,11,1,473754,201778,675532,1,1,1,271976,Out > In
Apr 2020,197,113,3,5961907,644383897,650345804,2,2,3,638421990,In > Out
Apr 2020,197,115,2,58347299,57440061,115787360,1,2,2,907238,Out > In
Apr 2020,197,117,6,256483468,29126984,285610452,6,6,1,227356484,Out > In
Apr 2020,197,12,1,182329,163997,346326,1,1,1,18332,Out > In
Apr 2020,197,124,1,26464,114738,141202,1,1,1,88274,In > Out
Apr 2020,197,125,3,171240704,10184464,181425168,3,3,3,161056240,Out > In
Apr 2020,197,130,1,93046,937948,1030994,1,1,1,844902,In > Out
Apr 2020,197,132,1,562770,1275774,1838544,1,1,1,713004,In > Out
Apr 2020,197,135,1,4177508,6003908,10181416,1,1,1,1826400,In > Out
Apr 2020,197,139,1,82776,611511,694287,1,1,1,528735,In > Out
Apr 2020,197,142,1,288881074,292967688,581848762,1,1,1,4086614,In > Out
Apr 2020,197,146,1,149582305,131322497,280904802,1,1,1,18259808,Out > In
Apr 2020,197,152,11,941037,10019529,10960566,6,6,9,9078492,In > Out
Apr 2020,197,156,1,38249,228011,266260,1,1,1,189762,In > Out
Apr 2020,197,167,1,111060,164592,275652,1,1,1,53532,In > Out
Apr 2020,197,169,224,4201773051,65345073,4267118124,149,151,1,4136427978,Out > In
Apr 2020,197,178,4,5962293,14103811,20066104,4,4,4,8141518,In > Out
Apr 2020,197,184,1,28120149,28039850,56159999,1,1,1,80299,Out > In
Apr 2020,197,188,3,2478041,8176938,10654979,3,2,2,5698897,In > Out
Apr 2020,197,19,66,38730635,2650491,41381126,16,24,1,36080144,Out > In
Apr 2020,197,191,3,778004,28670497,29448501,1,1,3,27892493,In > Out
Apr 2020,197,193,2,326058,1339223,1665281,2,2,2,1013165,In > Out
Apr 2020,197,197,8,20134366,25521862,45656228,1,8,8,5387496,In > Out
Apr 2020,197,212,1,92349,237107,329456,1,1,1,144758,In > Out
Apr 2020,197,215,1,18960826,390576,19351402,1,1,1,18570250,Out > In
Apr 2020,197,216,2,45435260,97218240,142653500,2,2,2,51782980,In > Out
Apr 2020,197,219,1,93419,89152,182571,1,1,1,4267,Out > In
Apr 2020,197,22,2,242232,155280,397512,2,2,2,86952,Out > In
Apr 2020,197,220,1,51853996,252330700,304184696,1,1,1,200476704,In > Out
Apr 2020,197,223,1,27448,129250,156698,1,1,1,101802,In > Out
Apr 2020,197,31,7,701252,48639962,49341214,2,2,7,47938710,In > Out
Apr 2020,197,41,1,141383,415038,556421,1,1,1,273655,In > Out
Apr 2020,197,44,3,507170,16545618,17052788,1,1,3,16038448,In > Out
Apr 2020,197,51,312,15088678980,367064147,15455743127,172,139,74,14721614833,Out > In
Apr 2020,197,57,1,84782,165539,250321,1,1,1,80757,In > Out
Apr 2020,197,62,1,60911,69018,129929,1,1,1,8107,In > Out
Apr 2020,197,64,1,65888688,62897180,128785868,1,1,1,2991508,Out > In
Apr 2020,197,75,2,1168160,1279047,2447207,2,2,2,110887,In > Out
Apr 2020,197,77,2,73529,344090,417619,2,2,2,270561,In > Out
Apr 2020,197,78,2,138749576,125220596,263970172,1,2,2,13528980,Out > In
Apr 2020,197,80,1,50768,766868,817636,1,1,1,716100,In > Out
Apr 2020,197,83,1,868863,142946,1011809,1,1,1,725917,Out > In
Apr 2020,197,9,2,131299,231605,362904,2,2,2,100306,In > Out
Apr 2020,197,93,1,186459,4660,191119,1,1,1,181799,Out > In
Apr 2020,197,94,3,131716454,293136309,424852763,1,3,3,161419855,In > Out
Apr 2020,197,95,1,31263808,33519431,64783239,1,1,1,2255623,In > Out
Apr 2020,198,22,780,366688835,467236347,833925182,239,337,6,100547512,In > Out
Apr 2020,2,1,16,999476,999096,1998572,3,3,1,380,Out > In
Apr 2020,2,100,6,450366470,43448045,493814515,5,6,3,406918425,Out > In
Apr 2020,2,12,8159,10790512963,2552902111,13343415074,46,7286,3,8237610852,Out > In
Apr 2020,2,14,416,114655952,79565405,194221357,11,412,1,35090547,Out > In
Apr 2020,2,15,62,31958715,115876080,147834795,2,62,62,83917365,In > Out
Apr 2020,2,17,35847,70776767970,846921156,71623689126,6787,22797,2,69929846814,Out > In
Apr 2020,2,19,24649,93221803200,1051091563,94272894763,3942,18268,1,92170711637,Out > In
Apr 2020,2,21,35315,57721673654,3537197583,61258871237,5991,24660,524,54184476071,Out > In
Apr 2020,2,22,2,214708,9647,224355,2,2,2,205061,Out > In
Apr 2020,2,23,5,753280,38345,791625,5,5,2,714935,Out > In
Apr 2020,2,24,7,8509191,76733,8585924,4,7,2,8432458,Out > In
Apr 2020,2,244,2575,836998054,670240867,1507238921,18,2516,2,166757187,Out > In
Apr 2020,2,25,10,1740543,388853,2129396,7,10,4,1351690,Out > In
Apr 2020,2,26,3,356683,126467,483150,2,3,2,230216,Out > In
Apr 2020,2,29,104,26281646,3612780,29894426,38,104,2,22668866,Out > In
Apr 2020,2,30,6551,18917723732,241163620,19158887352,2117,6030,3,18676560112,Out > In
Apr 2020,2,31,6,914536,139754,1054290,5,6,4,774782,Out > In
Apr 2020,2,32,6,1037120,437236,1474356,3,6,1,599884,Out > In
Apr 2020,2,33,4,710089,192538,902627,3,4,3,517551,Out > In
Apr 2020,2,36,5,619114,36615,655729,5,5,1,582499,Out > In
Apr 2020,2,38,86,92901278,2427226,95328504,43,86,2,90474052,Out > In
Apr 2020,2,39,2,258025,10849,268874,2,2,1,247176,Out > In
Apr 2020,2,4,2,115520,111416,226936,1,1,1,4104,Out > In
Apr 2020,2,7,2,433042,51197,484239,2,2,1,381845,Out > In
Apr 2020,2,8,4,856653,51967,908620,3,4,1,804686,Out > In
Apr 2020,2,85,855,660531132,32538763,693069895,166,830,2,627992369,Out > In
Apr 2020,2,91,12519,232280237833,45426552734,277706790567,867,9130,52,186853685099,Out > In
Apr 2020,200,16,1,506208,9033,515241,1,1,1,497175,Out > In
Apr 2020,200,17,1,119097,17472,136569,1,1,1,101625,Out > In
Apr 2020,200,199,44990,126462894755,2549369746,129012264501,12558,26049,2,123913525009,Out > In
Apr 2020,200,200,11,1584215,112865,1697080,11,11,1,1471350,Out > In
Apr 2020,200,204,849,397707574,12291837,409999411,62,832,1,385415737,Out > In
Apr 2020,200,205,191,72610260,2614766,75225026,32,191,2,69995494,Out > In
Apr 2020,200,206,38,49163696,1798674,50962370,5,38,2,47365022,Out > In
Apr 2020,200,21,52,265726897,1612285,267339182,45,52,1,264114612,Out > In
Apr 2020,200,210,2773,356416990,77669803,434086793,312,2582,2,278747187,Out > In
Apr 2020,200,211,93,265941549,4050603,269992152,24,93,1,261890946,Out > In
Apr 2020,200,22,4,633498,191508,825006,3,4,2,441990,Out > In
Apr 2020,200,24,285,1102935633,19738600,1122674233,122,285,1,1083197033,Out > In
Apr 2020,200,25,25,43791777,933477,44725254,1,25,1,42858300,Out > In
Apr 2020,200,26,2821,15933539674,217844323,16151383997,697,2690,2,15715695351,Out > In
Apr 2020,200,27,2962,893299785,32871063,926170848,1068,2842,2,860428722,Out > In
Apr 2020,200,28,55,21189505,713477,21902982,40,55,1,20476028,Out > In
Apr 2020,200,29,144,124491859,3527177,128019036,87,144,2,120964682,Out > In
Apr 2020,200,30,956,1013361857,29272027,1042633884,292,916,2,984089830,Out > In
Apr 2020,200,33,20,3937505,592940,4530445,15,20,2,3344565,Out > In
Apr 2020,200,34,67,54606476,3195367,57801843,10,67,1,51411109,Out > In
Apr 2020,200,35,80,98285890,3583604,101869494,25,80,2,94702286,Out > In
Apr 2020,200,36,67,9968818,687167,10655985,41,67,2,9281651,Out > In
Apr 2020,200,38,84,39245007,1167991,40412998,56,84,2,38077016,Out > In
Apr 2020,200,39,3,3516481,196144,3712625,3,3,2,3320337,Out > In
Apr 2020,200,40,1,95122,66073,161195,1,1,1,29049,Out > In
Apr 2020,200,45,3636,10912228714,184622811,11096851525,297,3484,2,10727605903,Out > In
Apr 2020,200,46,856,429475963,31789796,461265759,44,792,2,397686167,Out > In
Apr 2020,200,48,266,42904019,30271798,73175817,10,264,1,12632221,Out > In
Apr 2020,200,53,4883,20797771134,321282458,21119053592,1221,4400,2,20476488676,Out > In
Apr 2020,200,55,77,13842224,1173489,15015713,44,77,2,12668735,Out > In
Apr 2020,200,60,43,39017013,1137739,40154752,20,43,1,37879274,Out > In
Apr 2020,200,61,26,11707693,571343,12279036,14,26,1,11136350,Out > In
Apr 2020,200,65,1395,170741103,92090412,262831515,27,1344,2,78650691,Out > In
Apr 2020,200,68,185,2319175565,104146015,2423321580,23,185,2,2215029550,Out > In
Apr 2020,202,114,23,3143142,85927,3229069,19,23,1,3057215,Out > In
Apr 2020,202,209,1,177700,11070,188770,1,1,1,166630,Out > In
Apr 2020,202,251,1,70561,95275,165836,1,1,1,24714,In > Out
Apr 2020,202,40,2,345776,154726,500502,1,2,1,191050,Out > In
Apr 2020,203,221,1,114646,3576413,3691059,1,1,1,3461767,In > Out
Apr 2020,204,205,1,560436,55316447,55876883,1,1,1,54756011,In > Out
Apr 2020,204,223,27,219095638,374689770,593785408,24,26,4,155594132,In > Out
Apr 2020,206,200,17,8704800,11358043,20062843,8,14,1,2653243,In > Out
Apr 2020,206,33,502,54445394,116313062,170758456,269,276,2,61867668,In > Out
Apr 2020,206,7,738,459337343,77074202,536411545,347,493,3,382263141,Out > In
Apr 2020,207,127,3027,3308498681,442982405,3751481086,224,2844,2,2865516276,Out > In
Apr 2020,208,113,70697,73791472442,1094632813,74886105255,17815,36410,2,72696839629,Out > In
Apr 2020,208,114,2474,12171362616,98038747,12269401363,700,2405,1,12073323869,Out > In
Apr 2020,208,115,8033,4855028210,307336298,5162364508,281,6665,2,4547691912,Out > In
Apr 2020,208,116,2,371134,184886,556020,1,2,1,186248,Out > In
Apr 2020,208,117,31,6561201,97600,6658801,3,31,1,6463601,Out > In
Apr 2020,208,125,76652,112063715170,3097096824,115160811994,14480,33114,2,108966618346,Out > In
Apr 2020,208,126,61,15390246,550063,15940309,40,61,2,14840183,Out > In
Apr 2020,208,127,355,161767886,4818113,166585999,113,348,2,156949773,Out > In
Apr 2020,208,128,83995,39693997575,1147374549,40841372124,13081,37183,1,38546623026,Out > In
Apr 2020,208,195,2904,499927045,14679030,514606075,401,2095,2,485248015,Out > In
Apr 2020,208,29,3,8145842,50010,8195852,3,3,2,8095832,Out > In
Apr 2020,208,30,1,292995,6843,299838,1,1,1,286152,Out > In
Apr 2020,208,39,280,62480619,1895414,64376033,79,279,1,60585205,Out > In
Apr 2020,208,40,1,303359,6436,309795,1,1,1,296923,Out > In
Apr 2020,208,41,1,311391,4324,315715,1,1,1,307067,Out > In
Apr 2020,208,44,25536,396917677163,11807400245,408725077408,788,13749,2,385110276918,Out > In
Apr 2020,208,45,56765,63258000811,1288536492,64546537303,1421,21188,2,61969464319,Out > In
Apr 2020,208,47,44,4757900,1846786,6604686,25,44,2,2911114,Out > In
Apr 2020,208,49,402,175145286,9421323,184566609,152,397,2,165723963,Out > In
Apr 2020,208,50,1017,400831407,64513254,465344661,287,996,1,336318153,Out > In
Apr 2020,208,52,45409,12317195316,382158567,12699353883,363,18006,3,11935036749,Out > In
Apr 2020,208,53,698,190210131,3595238,193805369,124,688,2,186614893,Out > In
Apr 2020,208,56,83,12901478,367240,13268718,59,80,1,12534238,Out > In
Apr 2020,208,59,317,73505046,11953614,85458660,32,314,1,61551432,Out > In
Apr 2020,208,61,7,3196032,46021,3242053,1,7,2,3150011,Out > In
Apr 2020,208,64,8,2446744,25893,2472637,2,8,2,2420851,Out > In
Apr 2020,208,71,2,640103,110849,750952,1,2,1,529254,Out > In
Apr 2020,208,81,54,13763882,254621,14018503,14,54,2,13509261,Out > In
Apr 2020,208,83,23113,16096714453,760195870,16856910323,1694,15961,2,15336518583,Out > In
Apr 2020,208,84,25,258309708,329393917,587703625,2,25,1,71084209,In > Out
Apr 2020,208,85,4,39276272,12404161,51680433,1,4,1,26872111,Out > In
Apr 2020,208,87,4004,798297066,27315512,825612578,1108,3782,2,770981554,Out > In
Apr 2020,208,88,117,23151342,1080358,24231700,37,117,2,22070984,Out > In
Apr 2020,208,89,10,4061546,385367,4446913,3,10,1,3676179,Out > In
Apr 2020,208,90,1,299561,11761,311322,1,1,1,287800,Out > In
Apr 2020,208,91,5,2567306,36261,2603567,1,5,1,2531045,Out > In
Apr 2020,208,92,220,149329468,6948716,156278184,20,219,2,142380752,Out > In
Apr 2020,208,93,58,33719603,833590,34553193,19,58,2,32886013,Out > In
Apr 2020,208,96,27133,46641903231,816962937,47458866168,13319,18201,1,45824940294,Out > In
Apr 2020,209,100,1,29905942228,115138452,30021080680,1,1,1,29790803776,Out > In
Apr 2020,209,19,2,195371,22599,217970,2,2,1,172772,Out > In
Apr 2020,209,202,3,403429,188470,591899,3,3,2,214959,Out > In
Apr 2020,209,203,3,367876,140538,508414,1,3,1,227338,Out > In
Apr 2020,209,204,660,278441517,48193279,326634796,1,660,4,230248238,Out > In
Apr 2020,209,214,127,57351069,2226539,59577608,1,127,2,55124530,Out > In
Apr 2020,209,32,14,475864,1564288,2040152,1,14,1,1088424,In > Out
Apr 2020,21,187,1,12812500,248162,13060662,1,1,1,12564338,Out > In
Apr 2020,210,12,6381,704928107043,203520041936,908448148979,2067,5352,1,501408065107,Out > In
Apr 2020,210,4,1412,134750017038,40168714930,174918731968,633,1339,1,94581302108,Out > In
Apr 2020,212,21,48,20360877,2642378,23003255,12,48,1,17718499,Out > In
Apr 2020,212,22,2,604266,11520,615786,1,2,1,592746,Out > In
Apr 2020,212,24,2,111199,151835,263034,1,2,1,40636,In > Out
Apr 2020,212,25,1227,2259563933,103689562,2363253495,103,1199,1,2155874371,Out > In
Apr 2020,212,26,5367,33395990562,368392902,33764383464,2273,4983,1,33027597660,Out > In
Apr 2020,212,27,781,1003307448,13779955,1017087403,463,775,1,989527493,Out > In
Apr 2020,212,31,19026,44166116660,5060052347,49226169007,825,11832,3,39106064313,Out > In
Apr 2020,213,1,299,7563006428,8141680556,15704686984,224,132,107,578674128,In > Out
Apr 2020,213,10,372,2432436012,3799987170,6232423182,276,280,265,1367551158,In > Out
Apr 2020,213,100,58,2442585084,3122149878,5564734962,49,48,46,679564794,In > Out
Apr 2020,213,101,1025,3338441493,2258121250,5596562743,376,388,90,1080320243,Out > In
Apr 2020,213,102,633,3122371332,4420516588,7542887920,438,594,593,1298145256,In > Out
Apr 2020,213,103,63,1576948783,2509578318,4086527101,44,45,52,932629535,In > Out
Apr 2020,213,104,841,5645731670,6621666383,12267398053,749,350,117,975934713,In > Out
Apr 2020,213,105,125,3537733010,3074502335,6612235345,102,97,115,463230675,Out > In
Apr 2020,213,106,164,6367995447,5112064852,11480060299,114,117,124,1255930595,Out > In
Apr 2020,213,107,144,8043439329,11628607650,19672046979,81,88,113,3585168321,In > Out
Apr 2020,213,108,70,1965887878,2255995985,4221883863,43,43,66,290108107,In > Out
Apr 2020,213,109,55,810182968,4133174108,4943357076,41,37,50,3322991140,In > Out
Apr 2020,213,11,131,1662588371,3425382151,5087970522,85,74,84,1762793780,In > Out
Apr 2020,213,110,80,1383327363,1488090968,2871418331,57,60,60,104763605,In > Out
Apr 2020,213,111,172,2646141978,4672856974,7318998952,113,155,162,2026714996,In > Out
Apr 2020,213,112,47,1859391273,1516742664,3376133937,37,35,44,342648609,Out > In
Apr 2020,213,113,83,3216705639,5717579122,8934284761,49,43,72,2500873483,In > Out
Apr 2020,213,114,666,5547594224,10170248321,15717842545,381,390,109,4622654097,In > Out
Apr 2020,213,115,478,1564629385,2818003899,4382633284,277,464,470,1253374514,In > Out
Apr 2020,213,116,97,3542106662,6960713622,10502820284,67,54,83,3418606960,In > Out
Apr 2020,213,117,1732,7994550277,9521801766,17516352043,1410,1615,142,1527251489,In > Out
Apr 2020,213,118,302,5172930773,5287664439,10460595212,177,286,294,114733666,In > Out
Apr 2020,213,119,653,2780097565,3736743839,6516841404,477,604,602,956646274,In > Out
Apr 2020,213,12,247,2216037273,4615181001,6831218274,215,215,95,2399143728,In > Out
Apr 2020,213,120,156,4583999270,6996593673,11580592943,106,103,136,2412594403,In > Out
Apr 2020,213,121,138,3583721360,2962742884,6546464244,95,47,53,620978476,Out > In
Apr 2020,213,122,2317,7981019424,17282583120,25263602544,2046,2143,281,9301563696,In > Out
Apr 2020,213,123,307,6383665184,10634857600,17018522784,233,145,147,4251192416,In > Out
Apr 2020,213,124,241,3822136344,4813996880,8636133224,184,127,111,991860536,In > Out
Apr 2020,213,125,64,1929536815,2517957905,4447494720,48,52,50,588421090,In > Out
Apr 2020,213,126,101,6028088147,7209605174,13237693321,80,64,83,1181517027,In > Out
Apr 2020,213,127,1508,3601994174,9429396208,13031390382,1426,1458,166,5827402034,In > Out
Apr 2020,213,128,81,2268547869,3287187927,5555735796,64,59,79,1018640058,In > Out
Apr 2020,213,129,68,544474646,519547818,1064022464,53,56,61,24926828,Out > In
Apr 2020,213,13,135,1664425934,3012049215,4676475149,118,121,133,1347623281,In > Out
Apr 2020,213,130,112,2387335765,4449474921,6836810686,72,57,105,2062139156,In > Out
Apr 2020,213,131,102,2269211955,2873949878,5143161833,71,70,63,604737923,In > Out
Apr 2020,213,132,339,5994419524,13309141078,19303560602,163,135,289,7314721554,In > Out
Apr 2020,213,133,653,8241774450,4990869313,13232643763,349,354,107,3250905137,Out > In
Apr 2020,213,134,125,4948548378,5510955741,10459504119,104,90,75,562407363,In > Out
Apr 2020,213,135,88,3279169738,4110033237,7389202975,73,56,71,830863499,In > Out
Apr 2020,213,136,612,1883001505,3655151609,5538153114,588,589,109,1772150104,In > Out
Apr 2020,213,137,78,6269637960,7727592304,13997230264,67,62,67,1457954344,In > Out
Apr 2020,213,138,191,2566736419,5024473162,7591209581,80,90,183,2457736743,In > Out
Apr 2020,213,139,146,3474177125,5463429795,8937606920,55,47,136,1989252670,In > Out
Apr 2020,213,14,375,1580321302,5033701772,6614023074,306,335,62,3453380470,In > Out
Apr 2020,213,140,183,2865647501,3837120449,6702767950,120,146,145,971472948,In > Out
Apr 2020,213,141,186,4009700186,3876045313,7885745499,143,168,184,133654873,Out > In
Apr 2020,213,142,128,1743849864,55424080632,57167930496,93,96,60,53680230768,In > Out
Apr 2020,213,143,245,3621799357,4453900730,8075700087,218,218,217,832101373,In > Out
Apr 2020,213,144,80,978464328,1820066129,2798530457,59,56,73,841601801,In > Out
Apr 2020,213,145,83,2620309423,3559094429,6179403852,61,65,74,938785006,In > Out
Apr 2020,213,146,82,3504649949,5922644069,9427294018,63,64,58,2417994120,In > Out
Apr 2020,213,147,164,2945201703,8123872402,11069074105,114,86,103,5178670699,In > Out
Apr 2020,213,148,283,3582221914,4891894730,8474116644,209,183,178,1309672816,In > Out
Apr 2020,213,149,62,948417383,1832505948,2780923331,56,43,37,884088565,In > Out
Apr 2020,213,15,1331,3050497000,7115517206,10166014206,1203,1232,206,4065020206,In > Out
Apr 2020,213,150,144,2124162189,2850175799,4974337988,130,119,95,726013610,In > Out
Apr 2020,213,151,85,1398886637,1912130497,3311017134,46,69,74,513243860,In > Out
Apr 2020,213,152,320,4271530822,5584711354,9856242176,211,214,186,1313180532,In > Out
Apr 2020,213,153,94,5437951709,5383519488,10821471197,47,72,75,54432221,Out > In
Apr 2020,213,154,316,1492246375,4085305511,5577551886,281,262,129,2593059136,In > Out
Apr 2020,213,155,67,1276607782,2218030980,3494638762,47,53,42,941423198,In > Out
Apr 2020,213,156,24,894487577,1549481638,2443969215,20,17,21,654994061,In > Out
Apr 2020,213,157,1912,2628539574,15911383405,18539922979,1720,1790,162,13282843831,In > Out
Apr 2020,213,158,95,3544590232,3218176049,6762766281,74,69,79,326414183,Out > In
Apr 2020,213,159,74,1634838684,1865416081,3500254765,55,44,53,230577397,In > Out
Apr 2020,213,16,565,4734582703,15596982791,20331565494,444,428,410,10862400088,In > Out
Apr 2020,213,160,78,5080964175,4702229412,9783193587,55,40,65,378734763,Out > In
Apr 2020,213,161,114,2316885298,2633103380,4949988678,87,99,103,316218082,In > Out
Apr 2020,213,162,37,1593551036,2524521606,4118072642,30,25,32,930970570,In > Out
Apr 2020,213,163,121,2691653407,3441551109,6133204516,73,75,110,749897702,In > Out
Apr 2020,213,164,61,983814298,1085983239,2069797537,43,35,57,102168941,In > Out
Apr 2020,213,165,101,5995597014,5938193834,11933790848,64,76,78,57403180,Out > In
Apr 2020,213,166,113,5895250812,4215459762,10110710574,80,99,98,1679791050,Out > In
Apr 2020,213,167,178,4168877669,9287382331,13456260000,114,118,108,5118504662,In > Out
Apr 2020,213,168,74,824936652,1874448023,2699384675,51,40,64,1049511371,In > Out
Apr 2020,213,169,106,3203449682,3258867290,6462316972,92,84,104,55417608,In > Out
Apr 2020,213,17,529,1837575175,5295426784,7133001959,442,506,61,3457851609,In > Out
Apr 2020,213,170,33,2404686761,3426772950,5831459711,24,22,29,1022086189,In > Out
Apr 2020,213,171,61,424427018,1391045773,1815472791,48,43,59,966618755,In > Out
Apr 2020,213,172,316,3119594659,3592682461,6712277120,278,296,101,473087802,In > Out
Apr 2020,213,173,122,1079386325,3252602492,4331988817,55,80,114,2173216167,In > Out
Apr 2020,213,174,100,2159521001,2442897031,4602418032,67,60,90,283376030,In > Out
Apr 2020,213,175,81,2589357430,3827358387,6416715817,54,38,66,1238000957,In > Out
Apr 2020,213,176,48,2406809168,2031269844,4438079012,38,34,47,375539324,Out > In
Apr 2020,213,177,140,1168352795,1339391498,2507744293,115,127,51,171038703,In > Out
Apr 2020,213,178,89,2790643259,4114628620,6905271879,60,59,82,1323985361,In > Out
Apr 2020,213,179,106,1476106385,9972585200,11448691585,90,83,62,8496478815,In > Out
Apr 2020,213,18,135,4679860512,6418061480,11097921992,96,104,123,1738200968,In > Out
Apr 2020,213,180,51,3222589542,3221060133,6443649675,41,33,44,1529409,Out > In
Apr 2020,213,181,764,6194065038,8886825062,15080890100,735,738,83,2692760024,In > Out
Apr 2020,213,182,29,1375986463,2314011824,3689998287,22,17,25,938025361,In > Out
Apr 2020,213,183,77,594096434,410504922,1004601356,59,29,18,183591512,Out > In
Apr 2020,213,184,157,1307504420,1860244354,3167748774,125,61,37,552739934,In > Out
Apr 2020,213,185,105,2039557103,2769191949,4808749052,49,83,88,729634846,In > Out
Apr 2020,213,186,30,948933939,1175822711,2124756650,21,17,28,226888772,In > Out
Apr 2020,213,187,264,2624631452,3658443553,6283075005,227,221,104,1033812101,In > Out
Apr 2020,213,188,56,737356114,555567254,1292923368,37,26,40,181788860,Out > In
Apr 2020,213,189,299,1408355445,2435638471,3843993916,264,257,97,1027283026,In > Out
Apr 2020,213,19,899,8717113059,9402843065,18119956124,749,806,851,685730006,In > Out
Apr 2020,213,190,41,2996812124,3658976488,6655788612,25,23,24,662164364,In > Out
Apr 2020,213,191,185,2175844377,2671901579,4847745956,77,52,170,496057202,In > Out
Apr 2020,213,192,50,3228502232,5172592987,8401095219,37,40,38,1944090755,In > Out
Apr 2020,213,193,26,671020685,1458639453,2129660138,22,18,22,787618768,In > Out
Apr 2020,213,194,51,459958013,624315088,1084273101,41,37,21,164357075,In > Out
Apr 2020,213,195,52,703541943,1654894473,2358436416,30,23,35,951352530,In > Out
Apr 2020,213,196,17,1775206034,2334116944,4109322978,13,10,17,558910910,In > Out
Apr 2020,213,197,17,811547784,865458599,1677006383,11,10,16,53910815,In > Out
Apr 2020,213,198,58,1117964610,1512470910,2630435520,51,45,55,394506300,In > Out
Apr 2020,213,199,31,1191323894,3624511453,4815835347,21,26,23,2433187559,In > Out
Apr 2020,213,2,76,1635127916,3091323203,4726451119,60,58,65,1456195287,In > Out
Apr 2020,213,20,144,1920188033,4062672237,5982860270,69,84,132,2142484204,In > Out
Apr 2020,213,200,42,1294731364,1151001916,2445733280,36,36,41,143729448,Out > In
Apr 2020,213,201,24,541178009,898410677,1439588686,18,12,24,357232668,In > Out
Apr 2020,213,202,114,1641541780,8209247513,9850789293,96,52,47,6567705733,In > Out
Apr 2020,213,203,13,460076478,775297085,1235373563,11,10,12,315220607,In > Out
Apr 2020,213,204,35,436489693,380825198,817314891,19,24,31,55664495,Out > In
Apr 2020,213,205,86,3453598303,4737744556,8191342859,76,69,53,1284146253,In > Out
Apr 2020,213,206,39,959249211,2140237747,3099486958,28,28,36,1180988536,In > Out
Apr 2020,213,207,44,668135179,820649915,1488785094,28,31,41,152514736,In > Out
Apr 2020,213,208,37,1355448912,1302497123,2657946035,31,30,34,52951789,Out > In
Apr 2020,213,209,422,2301605299,3262666724,5564272023,217,169,161,961061425,In > Out
Apr 2020,213,21,327,7080217910,41767011903,48847229813,230,97,65,34686793993,In > Out
Apr 2020,213,210,56,1439722506,2494770560,3934493066,29,26,55,1055048054,In > Out
Apr 2020,213,211,31,2355119114,3327614206,5682733320,26,24,24,972495092,In > Out
Apr 2020,213,212,37,3571287063,537221727,4108508790,22,20,34,3034065336,Out > In
Apr 2020,213,213,58,3854375237,6584720518,10439095755,46,43,42,2730345281,In > Out
Apr 2020,213,214,46,5010837316,4885807491,9896644807,39,30,38,125029825,Out > In
Apr 2020,213,215,56,3797363775,33755817873,37553181648,21,15,24,29958454098,In > Out
Apr 2020,213,216,44,3301350504,7043855851,10345206355,36,32,39,3742505347,In > Out
Apr 2020,213,217,36,766415804,869373401,1635789205,33,30,36,102957597,In > Out
Apr 2020,213,218,430,15993864271,20702420034,36696284305,377,307,73,4708555763,In > Out
Apr 2020,213,219,51,237440592,145567610,383008202,30,33,46,91872982,Out > In
Apr 2020,213,22,162,3746966540,6905710560,10652677100,121,85,91,3158744020,In > Out
Apr 2020,213,220,173,1601695790,2315660180,3917355970,167,162,66,713964390,In > Out
Apr 2020,213,221,133,3531008993,5547245411,9078254404,104,108,113,2016236418,In > Out
Apr 2020,213,222,196,2331515741,4195040570,6526556311,101,83,123,1863524829,In > Out
Apr 2020,213,223,194,943587422,2302705728,3246293150,171,69,41,1359118306,In > Out
Apr 2020,213,224,72,407190450,1220553535,1627743985,44,29,72,813363085,In > Out
Apr 2020,213,225,37,158558621,138773840,297332461,29,28,36,19784781,Out > In
Apr 2020,213,226,96,628595121,1301575769,1930170890,30,47,58,672980648,In > Out
Apr 2020,213,227,65,3753481429,3552044031,7305525460,46,53,53,201437398,Out > In
Apr 2020,213,228,44,2155263860,2452689114,4607952974,37,32,28,297425254,In > Out
Apr 2020,213,229,48,5993475647,5283635428,11277111075,31,29,44,709840219,Out > In
Apr 2020,213,23,208,7601824059,8905307632,16507131691,165,117,92,1303483573,In > Out
Apr 2020,213,230,33,1017042506,1020275645,2037318151,26,24,30,3233139,In > Out
Apr 2020,213,231,56,3072097570,3736705737,6808803307,31,48,47,664608167,In > Out
Apr 2020,213,232,44,859656091,4509746267,5369402358,38,30,38,3650090176,In > Out
Apr 2020,213,233,82,2351945565,9755521838,12107467403,59,46,64,7403576273,In > Out
Apr 2020,213,234,264,1838229160,2560385835,4398614995,231,236,120,722156675,In > Out
Apr 2020,213,235,166,389226178,454359384,843585562,156,152,131,65133206,In > Out
Apr 2020,213,236,61,2506867648,3142477466,5649345114,46,38,57,635609818,In > Out
Apr 2020,213,237,316,2055323704,4166454429,6221778133,268,62,42,2111130725,In > Out
Apr 2020,213,238,103,2626105567,3238400751,5864506318,54,66,84,612295184,In > Out
Apr 2020,213,239,191,3410863406,3448139816,6859003222,50,55,174,37276410,In > Out
Apr 2020,213,24,219,4091718381,4527781105,8619499486,158,196,212,436062724,In > Out
Apr 2020,213,240,122,5967339234,7580091073,13547430307,95,70,95,1612751839,In > Out
Apr 2020,213,241,57,1119587133,4551320446,5670907579,46,46,55,3431733313,In > Out
Apr 2020,213,242,75,8100321871,8780574416,16880896287,48,40,61,680252545,In > Out
Apr 2020,213,243,417,2802457614,10206981097,13009438711,270,333,293,7404523483,In > Out
Apr 2020,213,244,25,823970267,601469903,1425440170,20,22,25,222500364,Out > In
Apr 2020,213,245,124,1869046421,3364225540,5233271961,69,70,93,1495179119,In > Out
Apr 2020,213,246,304,6071742123,6602010162,12673752285,212,291,299,530268039,In > Out
Apr 2020,213,247,405,2151232179,3801572211,5952804390,338,369,84,1650340032,In > Out
Apr 2020,213,248,234,3326023481,2081299828,5407323309,196,184,51,1244723653,Out > In
Apr 2020,213,249,108,762623948,4007721145,4770345093,71,78,90,3245097197,In > Out
Apr 2020,213,25,93,3286889696,7254233907,10541123603,57,54,80,3967344211,In > Out
Apr 2020,213,250,473,2101334506,3475870902,5577205408,325,332,210,1374536396,In > Out
Apr 2020,213,251,88,1858294301,1846435815,3704730116,59,56,54,11858486,Out > In
Apr 2020,213,252,38,7334417415,8803997839,16138415254,30,21,33,1469580424,In > Out
Apr 2020,213,253,98,4446746893,4665880175,9112627068,57,65,79,219133282,In > Out
Apr 2020,213,254,55,1563824966,1549334330,3113159296,37,32,49,14490636,Out > In
Apr 2020,213,26,245,5815907283,8025581276,13841488559,133,173,98,2209673993,In > Out
Apr 2020,213,27,205,3897636694,5514049921,9411686615,138,101,99,1616413227,In > Out
Apr 2020,213,28,467,3233377713,3673057525,6906435238,308,301,453,439679812,In > Out
Apr 2020,213,29,67,3617725621,3314809805,6932535426,53,50,47,302915816,Out > In
Apr 2020,213,3,249,3972618303,4942088359,8914706662,204,208,101,969470056,In > Out
Apr 2020,213,30,196,3021658848,10695821241,13717480089,127,148,179,7674162393,In > Out
Apr 2020,213,31,61,2351723972,4646727395,6998451367,40,36,54,2295003423,In > Out
Apr 2020,213,32,1427,12901288468,10394657578,23295946046,973,861,377,2506630890,Out > In
Apr 2020,213,33,549,9173442878,13836931315,23010374193,304,344,232,4663488437,In > Out
Apr 2020,213,34,1043,6211422672,21728556088,27939978760,809,933,789,15517133416,In > Out
Apr 2020,213,35,192,11352659268,9662818672,21015477940,110,91,136,1689840596,Out > In
Apr 2020,213,36,729,2645478237,5384040395,8029518632,690,709,105,2738562158,In > Out
Apr 2020,213,37,82,932578514,2832101790,3764680304,56,45,62,1899523276,In > Out
Apr 2020,213,38,97,4580495623,8408312479,12988808102,59,67,81,3827816856,In > Out
Apr 2020,213,39,203,1935661705,3922103586,5857765291,174,174,200,1986441881,In > Out
Apr 2020,213,4,146,5602854357,7822601457,13425455814,103,66,95,2219747100,In > Out
Apr 2020,213,40,131,4263537238,6090870979,10354408217,110,104,73,1827333741,In > Out
Apr 2020,213,41,247,8286494922,10334442972,18620937894,116,76,192,2047948050,In > Out
Apr 2020,213,42,379,5464999711,10597318785,16062318496,302,341,188,5132319074,In > Out
Apr 2020,213,43,61,2609424631,4922281554,7531706185,53,42,42,2312856923,In > Out
Apr 2020,213,44,155,7081942791,10624889724,17706832515,134,78,65,3542946933,In > Out
Apr 2020,213,45,200,2462000271,4247811928,6709812199,183,168,179,1785811657,In > Out
Apr 2020,213,46,56,3197193008,4626693942,7823886950,30,43,49,1429500934,In > Out
Apr 2020,213,47,155,4919301780,6653956681,11573258461,103,101,99,1734654901,In > Out
Apr 2020,213,48,155,5462502410,6464581783,11927084193,123,125,89,1002079373,In > Out
Apr 2020,213,49,367,2062430852,2013461838,4075892690,257,357,365,48969014,Out > In
Apr 2020,213,5,75,4069069081,10479198980,14548268061,45,38,60,6410129899,In > Out
Apr 2020,213,50,388,3718304070,5130789266,8849093336,126,113,342,1412485196,In > Out
Apr 2020,213,51,102,5106886032,8239597514,13346483546,77,71,80,3132711482,In > Out
Apr 2020,213,52,90,3408305985,3831675459,7239981444,72,57,61,423369474,In > Out
Apr 2020,213,53,105,3593781485,4645250098,8239031583,71,66,83,1051468613,In > Out
Apr 2020,213,54,351,3845745040,2567903082,6413648122,263,158,115,1277841958,Out > In
Apr 2020,213,55,986,3351134926,6546512107,9897647033,936,953,95,3195377181,In > Out
Apr 2020,213,56,124,2073908823,3986124596,6060033419,98,105,102,1912215773,In > Out
Apr 2020,213,57,1627,4002090092,5008132356,9010222448,1484,1422,176,1006042264,In > Out
Apr 2020,213,58,563,2627346955,7499477737,10126824692,293,330,62,4872130782,In > Out
Apr 2020,213,59,390,3921958123,7783046240,11705004363,251,214,76,3861088117,In > Out
Apr 2020,213,6,48,3532340538,5499456365,9031796903,36,27,36,1967115827,In > Out
Apr 2020,213,60,1202,7856061176,9415898228,17271959404,1065,1026,1017,1559837052,In > Out
Apr 2020,213,61,222,2403857771,3676717628,6080575399,80,93,87,1272859857,In > Out
Apr 2020,213,62,147,2535097017,4636687382,7171784399,93,90,82,2101590365,In > Out
Apr 2020,213,63,560,7526015921,5374636133,12900652054,346,171,121,2151379788,Out > In
Apr 2020,213,64,283,2210562823,12419677560,14630240383,132,178,176,10209114737,In > Out
Apr 2020,213,65,223,8529510525,9227541783,17757052308,77,186,200,698031258,In > Out
Apr 2020,213,66,517,7865835753,20820116668,28685952421,360,347,123,12954280915,In > Out
Apr 2020,213,67,135,4971001053,7568491980,12539493033,90,69,120,2597490927,In > Out
Apr 2020,213,68,162,4619680045,6609442268,11229122313,87,144,145,1989762223,In > Out
Apr 2020,213,69,102,2533429574,4112597670,6646027244,57,51,97,1579168096,In > Out
Apr 2020,213,7,147,3127880889,3695232513,6823113402,50,46,127,567351624,In > Out
Apr 2020,213,70,95,3755994182,4007855842,7763850024,78,84,84,251861660,In > Out
Apr 2020,213,71,597,5121657841,6247098181,11368756022,406,564,569,1125440340,In > Out
Apr 2020,213,72,95,1820639712,3116453103,4937092815,54,55,75,1295813391,In > Out
Apr 2020,213,73,112,4406953614,3716480607,8123434221,79,48,82,690473007,Out > In
Apr 2020,213,74,3286,2864249600,14901147447,17765397047,2850,3090,199,12036897847,In > Out
Apr 2020,213,75,150,4418025338,4512100902,8930126240,53,56,56,94075564,In > Out
Apr 2020,213,76,48,3216079739,8510764534,11726844273,32,38,42,5294684795,In > Out
Apr 2020,213,77,71,2271799704,3224531482,5496331186,52,45,62,952731778,In > Out
Apr 2020,213,78,195,4671699897,3482139835,8153839732,138,84,110,1189560062,Out > In
Apr 2020,213,79,97,1919694342,4092665443,6012359785,47,48,89,2172971101,In > Out
Apr 2020,213,8,81,3611361176,9250821199,12862182375,62,54,76,5639460023,In > Out
Apr 2020,213,80,123,1867051617,4806133754,6673185371,78,101,81,2939082137,In > Out
Apr 2020,213,81,35,1522097095,4465067977,5987165072,27,31,33,2942970882,In > Out
Apr 2020,213,82,445,1938921008,31867426632,33806347640,409,425,92,29928505624,In > Out
Apr 2020,213,83,231,4177706218,5206869185,9384575403,200,195,101,1029162967,In > Out
Apr 2020,213,84,105,5803831244,6581032726,12384863970,56,61,75,777201482,In > Out
Apr 2020,213,85,899,3955317107,8336681641,12291998748,778,717,180,4381364534,In > Out
Apr 2020,213,86,74,4199919801,6022650020,10222569821,45,61,54,1822730219,In > Out
Apr 2020,213,87,94,3667249046,5490199885,9157448931,69,55,68,1822950839,In > Out
Apr 2020,213,88,83,1885109359,2471847255,4356956614,74,69,73,586737896,In > Out
Apr 2020,213,89,127,6658338731,60454890143,67113228874,86,59,87,53796551412,In > Out
Apr 2020,213,9,96,6694577581,13089846884,19784424465,69,64,82,6395269303,In > Out
Apr 2020,213,90,69,2181229711,4063680440,6244910151,47,51,50,1882450729,In > Out
Apr 2020,213,91,64,4034337864,4475381533,8509719397,49,51,51,441043669,In > Out
Apr 2020,213,92,140,2075221315,4181553596,6256774911,111,111,79,2106332281,In > Out
Apr 2020,213,93,186,3259069547,6238561941,9497631488,115,130,156,2979492394,In > Out
Apr 2020,213,94,362,4124870708,6287820929,10412691637,236,268,338,2162950221,In > Out
Apr 2020,213,95,364,5649970550,7996592308,13646562858,296,302,197,2346621758,In > Out
Apr 2020,213,96,207,8132894412,7506942602,15639837014,144,69,87,625951810,Out > In
Apr 2020,213,97,126,2744500674,3741265137,6485765811,101,96,99,996764463,In > Out
Apr 2020,213,98,112,2663590463,42392629934,45056220397,73,89,87,39729039471,In > Out
Apr 2020,213,99,90,11876504983,11112040853,22988545836,64,58,83,764464130,Out > In
Apr 2020,215,113,32620,88631583842,3566212923,92197796765,6298,15184,1,85065370919,Out > In
Apr 2020,215,157,2,47076738,48998819,96075557,1,1,2,1922081,In > Out
Apr 2020,215,215,5,193305257,314871078,508176335,4,4,5,121565821,In > Out
Apr 2020,221,119,1,261986389,2460952,264447341,1,1,1,259525437,Out > In
Apr 2020,221,128,2,52722527,157287207,210009734,1,1,2,104564680,In > Out
Apr 2020,221,15,109,29433320,3581306,33014626,56,51,2,25852014,Out > In
Apr 2020,221,168,4,225173559,266463564,491637123,4,3,4,41290005,In > Out
Apr 2020,221,184,306,640286198,47670033,687956231,52,295,1,592616165,Out > In
Apr 2020,221,198,8534,5851165174,903733446,6754898620,1229,6289,1,4947431728,Out > In
Apr 2020,221,55,183,50800631,15602896,66403527,27,22,2,35197735,Out > In
Apr 2020,221,62,31,7754151,1250210,9004361,21,15,1,6503941,Out > In
Apr 2020,221,66,1099,5333051394,216207639,5549259033,90,1067,1,5116843755,Out > In
Apr 2020,222,130,2,237523,51827,289350,1,2,1,185696,Out > In
Apr 2020,222,226,3,855156,141808,996964,1,3,1,713348,Out > In
Apr 2020,225,120,5194,4410106253,479724130,4889830383,192,2759,1,3930382123,Out > In
Apr 2020,225,176,1,28752,590360,619112,1,1,1,561608,In > Out
Apr 2020,225,21,1,97347,6988,104335,1,1,1,90359,Out > In
Apr 2020,225,210,4,4216942,1092402,5309344,1,4,4,3124540,Out > In
Apr 2020,225,218,158,411857954,7815026,419672980,93,157,2,404042928,Out > In
Apr 2020,225,232,4,33228277,4452357,37680634,1,4,1,28775920,Out > In
Apr 2020,225,8,26,560054295,22213670,582267965,3,23,14,537840625,Out > In
Apr 2020,225,86,3,34643593,9000737,43644330,1,3,3,25642856,Out > In
Apr 2020,228,105,19,158307,17965566,18123873,19,17,1,17807259,In > Out
Apr 2020,228,116,30,40875401,73715474,114590875,28,12,30,32840073,In > Out
Apr 2020,228,124,1,16176169,17480592,33656761,1,1,1,1304423,In > Out
Apr 2020,228,127,1,55802,53942,109744,1,1,1,1860,Out > In
Apr 2020,228,128,1,152340624,4019865,156360489,1,1,1,148320759,Out > In
Apr 2020,228,135,7,10475242,26813638,37288880,6,2,7,16338396,In > Out
Apr 2020,228,145,1,1547484,1356774,2904258,1,1,1,190710,Out > In
Apr 2020,228,15,4,139870120,71558001,211428121,3,2,4,68312119,Out > In
Apr 2020,228,153,4,298722949,181276701,479999650,2,4,4,117446248,Out > In
Apr 2020,228,16,2,354003882,358577256,712581138,2,2,2,4573374,In > Out
Apr 2020,228,161,4,252052592,251980512,504033104,2,2,4,72080,Out > In
Apr 2020,228,164,1,17425563,58670256,76095819,1,1,1,41244693,In > Out
Apr 2020,228,171,2,1130265,2962898,4093163,2,2,2,1832633,In > Out
Apr 2020,228,175,1,139581,38776,178357,1,1,1,100805,Out > In
Apr 2020,228,178,6,2394879,4387096,6781975,3,5,6,1992217,In > Out
Apr 2020,228,18,5,52415582,52357912,104773494,1,5,5,57670,Out > In
Apr 2020,228,191,2,826618,4697950,5524568,2,2,2,3871332,In > Out
Apr 2020,228,193,1,895783320,309164513,1204947833,1,1,1,586618807,Out > In
Apr 2020,228,195,4,9553619,64453400,74007019,3,3,4,54899781,In > Out
Apr 2020,228,200,22,175564844,283381015,458945859,9,19,22,107816171,In > Out
Apr 2020,228,202,14,61193768,136223119,197416887,12,12,12,75029351,In > Out
Apr 2020,228,204,6,86209994,721548756,807758750,4,1,6,635338762,In > Out
Apr 2020,228,208,1,69155,88933,158088,1,1,1,19778,In > Out
Apr 2020,228,215,1,5313361,5014964,10328325,1,1,1,298397,Out > In
Apr 2020,228,221,2,308499,8262034,8570533,2,2,2,7953535,In > Out
Apr 2020,228,24,1,60308,171753,232061,1,1,1,111445,In > Out
Apr 2020,228,27,1,840,127529,128369,1,1,1,126689,In > Out
Apr 2020,228,32,1,546186,574766,1120952,1,1,1,28580,In > Out
Apr 2020,228,35,451,176408877,2137222913,2313631790,439,431,10,1960814036,In > Out
Apr 2020,228,37,4,21203371,35709338,56912709,2,2,4,14505967,In > Out
Apr 2020,228,41,2,22792524,32997481,55790005,2,2,2,10204957,In > Out
Apr 2020,228,42,1,20402557,29536859,49939416,1,1,1,9134302,In > Out
Apr 2020,228,43,6,2401843,75593736,77995579,1,1,6,73191893,In > Out
Apr 2020,228,44,2,593733,2015098,2608831,2,2,2,1421365,In > Out
Apr 2020,228,45,1,692303602,662503395,1354806997,1,1,1,29800207,Out > In
Apr 2020,228,48,2,17953312,13840874,31794186,2,2,1,4112438,Out > In
Apr 2020,228,51,2,2329153,398721612,401050765,1,1,2,396392459,In > Out
Apr 2020,228,55,16,224296301,320297870,544594171,13,13,9,96001569,In > Out
Apr 2020,228,58,12,268249688,1431223384,1699473072,9,9,12,1162973696,In > Out
Apr 2020,228,61,5,188084418,195284749,383369167,3,3,5,7200331,In > Out
Apr 2020,228,67,1,247861,280182,528043,1,1,1,32321,In > Out
Apr 2020,228,68,1,39917360,46680363,86597723,1,1,1,6763003,In > Out
Apr 2020,228,71,2,12971289,14560810,27532099,2,2,2,1589521,In > Out
Apr 2020,228,74,2,6573500,13404845,19978345,2,2,2,6831345,In > Out
Apr 2020,228,81,12,998703821,1371337879,2370041700,9,7,9,372634058,In > Out
Apr 2020,228,85,7,31140136,55201652,86341788,3,5,7,24061516,In > Out
Apr 2020,228,9,2,97633081,293828653,391461734,1,1,2,196195572,In > Out
Apr 2020,228,92,2,463545,76339,539884,2,1,2,387206,Out > In
Apr 2020,228,95,636,3793417277,1575505170,5368922447,433,598,10,2217912107,Out > In
Apr 2020,228,97,69,109981265,120253042,230234307,37,37,57,10271777,In > Out
Apr 2020,229,103,3,192245132,463703695,655948827,1,3,3,271458563,In > Out
Apr 2020,229,107,1,232350,255545,487895,1,1,1,23195,In > Out
Apr 2020,229,109,6,4614720,12886990,17501710,4,5,6,8272270,In > Out
Apr 2020,229,110,1,617971843,626631338,1244603181,1,1,1,8659495,In > Out
Apr 2020,229,111,2,4576002,8165124,12741126,2,2,2,3589122,In > Out
Apr 2020,229,115,1,1436892,47692003,49128895,1,1,1,46255111,In > Out
Apr 2020,229,118,10,399517898,271173332,670691230,5,7,10,128344566,Out > In
Apr 2020,229,124,2,50720214,48943407,99663621,2,2,2,1776807,Out > In
Apr 2020,229,125,16,200179424,269789231,469968655,16,16,4,69609807,In > Out
Apr 2020,229,127,4,4544793,7474461,12019254,2,4,4,2929668,In > Out
Apr 2020,229,129,47,52186700,145089749,197276449,14,30,44,92903049,In > Out
Apr 2020,229,130,2,395470225,642727449,1038197674,2,2,2,247257224,In > Out
Apr 2020,229,132,1,400938,355627,756565,1,1,1,45311,Out > In
Apr 2020,229,133,2,9211503,19227810,28439313,2,2,2,10016307,In > Out
Apr 2020,229,134,5,356284176,343063948,699348124,2,5,4,13220228,Out > In
Apr 2020,229,136,2,173045,364709,537754,2,1,2,191664,In > Out
Apr 2020,229,137,3,63907526,146309877,210217403,3,3,3,82402351,In > Out
Apr 2020,229,138,4,7953122,19225008,27178130,3,4,3,11271886,In > Out
Apr 2020,229,143,1,79776,155465,235241,1,1,1,75689,In > Out
Apr 2020,229,150,6,498880786,750407999,1249288785,6,5,4,251527213,In > Out
Apr 2020,229,151,5,68175202,122846001,191021203,4,5,5,54670799,In > Out
Apr 2020,229,153,3,7278084,105897362,113175446,2,3,3,98619278,In > Out
Apr 2020,229,154,9,530415756,22761039508,23291455264,3,9,4,22230623752,In > Out
Apr 2020,229,157,5,82324469,878691942,961016411,3,1,5,796367473,In > Out
Apr 2020,229,159,5,5508340,21659743,27168083,4,5,4,16151403,In > Out
Apr 2020,229,170,3,152327909,310151669,462479578,2,3,3,157823760,In > Out
Apr 2020,229,18,11,259244153,2865408593,3124652746,11,6,11,2606164440,In > Out
Apr 2020,229,184,1,2503855,2841089,5344944,1,1,1,337234,In > Out
Apr 2020,229,189,4,44554817,234513107,279067924,3,3,3,189958290,In > Out
Apr 2020,229,193,8,313587292,246992383,560579675,8,8,8,66594909,Out > In
Apr 2020,229,194,1,301137,31480,332617,1,1,1,269657,Out > In
Apr 2020,229,20,1,451198272,266452375,717650647,1,1,1,184745897,Out > In
Apr 2020,229,211,7,414584909,1052816953,1467401862,5,7,7,638232044,In > Out
Apr 2020,229,214,1,266632,341021,607653,1,1,1,74389,In > Out
Apr 2020,229,218,2,640531,5019448,5659979,1,2,2,4378917,In > Out
Apr 2020,229,219,4,23333852,19823283,43157135,3,3,4,3510569,Out > In
Apr 2020,229,23,1,14394270,17210681,31604951,1,1,1,2816411,In > Out
Apr 2020,229,26,1,71703274,205688,71908962,1,1,1,71497586,Out > In
Apr 2020,229,27,1,575082595,700623797,1275706392,1,1,1,125541202,In > Out
Apr 2020,229,38,536,19543834,681978392,701522226,513,505,76,662434558,In > Out
Apr 2020,229,42,1,32860,83049,115909,1,1,1,50189,In > Out
Apr 2020,229,43,2,3319600,8141813,11461413,2,2,2,4822213,In > Out
Apr 2020,229,44,4,300639911,625310894,925950805,4,4,4,324670983,In > Out
Apr 2020,229,45,6,1429104392,1004896557,2434000949,5,6,6,424207835,Out > In
Apr 2020,229,53,9,102440526,208368595,310809121,9,8,4,105928069,In > Out
Apr 2020,229,64,10,41309987,257918898,299228885,9,9,10,216608911,In > Out
Apr 2020,229,67,1,31667921,112054899,143722820,1,1,1,80386978,In > Out
Apr 2020,229,70,17,76629269,70241883,146871152,10,17,9,6387386,Out > In
Apr 2020,229,71,1,219961,672242,892203,1,1,1,452281,In > Out
Apr 2020,229,76,36,1722906,15727402,17450308,36,36,5,14004496,In > Out
Apr 2020,229,78,3,192664600,246168017,438832617,1,2,3,53503417,In > Out
Apr 2020,229,83,5,574317332,568647724,1142965056,5,4,4,5669608,Out > In
Apr 2020,229,89,4,25886765,42447879,68334644,3,4,2,16561114,In > Out
Apr 2020,229,92,4,33751337,36967871,70719208,2,2,4,3216534,In > Out
Apr 2020,229,94,22,67976720,161705514,229682234,15,17,20,93728794,In > Out
Apr 2020,229,96,5,67050915,93471808,160522723,4,5,4,26420893,In > Out
Apr 2020,230,171,198,176805269,4599540,181404809,12,197,1,172205729,Out > In
Apr 2020,234,116,549,908800208,300290742,1209090950,331,238,13,608509466,Out > In
Apr 2020,234,134,2,403834,70894788,71298622,1,1,2,70490954,In > Out
Apr 2020,234,151,7,105881085,9317759,115198844,1,7,7,96563326,Out > In
Apr 2020,234,200,1,6655832,1394972,8050804,1,1,1,5260860,Out > In
Apr 2020,234,201,112,25181532,13173849,38355381,18,19,3,12007683,Out > In
Apr 2020,234,228,1,72773,64277,137050,1,1,1,8496,Out > In
Apr 2020,234,23,1,6960,546552,553512,1,1,1,539592,In > Out
Apr 2020,234,29,7,46649349,5299844,51949193,1,7,7,41349505,Out > In
Apr 2020,234,46,1,32225717,285551,32511268,1,1,1,31940166,Out > In
Apr 2020,234,56,1,760161,31230883,31991044,1,1,1,30470722,In > Out
Apr 2020,234,66,18,42042247,23357316,65399563,1,18,1,18684931,Out > In
Apr 2020,234,76,22,2535517577,51727019,2587244596,6,22,14,2483790558,Out > In
Apr 2020,234,78,11,3816720,140384,3957104,6,11,1,3676336,Out > In
Apr 2020,235,212,349,262819101,3534959,266354060,11,346,2,259284142,Out > In
Apr 2020,235,223,914368,479118117861,15523757775,494641875636,13502,52963,2,463594360086,Out > In
Apr 2020,236,253,6,239668502,715454517,955123019,3,3,6,475786015,In > Out
Apr 2020,241,181,1,88834,96147,184981,1,1,1,7313,In > Out
Apr 2020,241,182,1,14504735,2552079,17056814,1,1,1,11952656,Out > In
Apr 2020,241,199,1,4577079,332309407,336886486,1,1,1,327732328,In > Out
Apr 2020,242,103,4,3775189,80905,3856094,2,4,1,3694284,Out > In
Apr 2020,242,104,2,2905037,67600,2972637,1,2,1,2837437,Out > In
Apr 2020,242,105,4,5983695,116968,6100663,2,4,1,5866727,Out > In
Apr 2020,242,106,2,904612,28022,932634,1,2,1,876590,Out > In
Apr 2020,242,110,8,5557139,251818,5808957,3,8,2,5305321,Out > In
Apr 2020,242,169,2,2979136,74919,3054055,1,2,1,2904217,Out > In
Apr 2020,242,174,2,819712,26968,846680,1,2,1,792744,Out > In
Apr 2020,242,178,14,643478,1493340,2136818,1,14,1,849862,In > Out
Apr 2020,242,39,28,1176165,3020679,4196844,1,28,1,1844514,In > Out
Apr 2020,242,40,7,231290,679588,910878,2,7,2,448298,In > Out
Apr 2020,242,41,2,2844819,56473,2901292,1,2,1,2788346,Out > In
Apr 2020,242,44,4,999727,343907,1343634,2,4,1,655820,Out > In
Apr 2020,242,45,2,2814630,56062,2870692,1,2,1,2758568,Out > In
Apr 2020,25,22,38,33991864,1238954,35230818,21,38,1,32752910,Out > In
Apr 2020,250,15,2,850212,749512,1599724,2,1,1,100700,Out > In
Apr 2020,250,3,12,27820764,39394140,67214904,6,12,2,11573376,In > Out
Apr 2020,250,39,4,10667063,360804,11027867,1,4,1,10306259,Out > In
Apr 2020,250,41,45,7590085,129222,7719307,30,45,1,7460863,Out > In
Apr 2020,256,103,2,398164,184402,582566,1,2,1,213762,Out > In
Apr 2020,256,104,71,65775770,1487948,67263718,34,71,1,64287822,Out > In
Apr 2020,256,107,2,364918,170514,535432,1,2,1,194404,Out > In
Apr 2020,256,11,663,1992447961,359177219,2351625180,65,654,6,1633270742,Out > In
Apr 2020,256,12,268,59218546,4387526,63606072,94,267,3,54831020,Out > In
Apr 2020,256,15,599,54056513,830636046,884692559,417,597,2,776579533,In > Out
Apr 2020,256,248,164,1820544347,2610363065,4430907412,91,93,141,789818718,In > Out
Apr 2020,256,249,290,5107740770,9295921048,14403661818,173,161,237,4188180278,In > Out
Apr 2020,256,250,282,4404961320,6008906140,10413867460,228,164,176,1603944820,In > Out
Apr 2020,256,251,378,2783336904,8050121301,10833458205,113,115,361,5266784397,In > Out
Apr 2020,256,252,366,3389925763,10656602799,14046528562,218,222,251,7266677036,In > Out
Apr 2020,256,253,219,2854091204,3733619926,6587711130,161,117,146,879528722,In > Out
Apr 2020,256,254,392,3096268232,13373805934,16470074166,321,224,132,10277537702,In > Out
Apr 2020,26,2,11,340581,1381619,1722200,1,11,1,1041038,In > Out
Apr 2020,29,52,164,127867442,39396943,167264385,26,78,13,88470499,Out > In
Apr 2020,35,111,3,1107975,34827,1142802,1,3,1,1073148,Out > In
Apr 2020,35,112,12,10996055,14680595,25676650,5,12,2,3684540,In > Out
Apr 2020,35,116,276,66602564,2840814,69443378,70,275,2,63761750,Out > In
Apr 2020,35,118,1651,602076313,147278076,749354389,204,1539,1,454798237,Out > In
Apr 2020,35,16,7,1225644,270419,1496063,2,5,1,955225,Out > In
Apr 2020,35,164,21,7810722,136648,7947370,3,21,2,7674074,Out > In
Apr 2020,35,168,2,292736,234232,526968,1,1,1,58504,Out > In
Apr 2020,35,182,843,759924357,12888484,772812841,86,832,2,747035873,Out > In
Apr 2020,35,191,363,104262713,12044439,116307152,71,362,2,92218274,Out > In
Apr 2020,35,192,200,87820896,9121134,96942030,53,200,2,78699762,Out > In
Apr 2020,35,193,63,119167308,2812110,121979418,35,63,1,116355198,Out > In
Apr 2020,35,195,52543,31107164617,2247862354,33355026971,4241,27624,2,28859302263,Out > In
Apr 2020,35,202,344,78415158,2380508,80795666,35,342,2,76034650,Out > In
Apr 2020,35,208,2,925497,13100,938597,1,2,1,912397,Out > In
Apr 2020,35,212,2296,10319606331,9210457515,19530063846,447,2126,2,1109148816,Out > In
Apr 2020,35,251,19,18520558,628173,19148731,5,19,1,17892385,Out > In
Apr 2020,35,253,8,573652,346252,919904,1,8,1,227400,Out > In
Apr 2020,35,254,1478,3045636397,417978445,3463614842,97,1424,1,2627657952,Out > In
Apr 2020,35,35,24,36279631,2137877,38417508,5,24,1,34141754,Out > In
Apr 2020,35,60,127,417849939,167589383,585439322,27,127,1,250260556,Out > In
Apr 2020,35,61,15,1950397,325170,2275567,10,15,1,1625227,Out > In
Apr 2020,35,98,43,34942719,6723745,41666464,9,43,1,28218974,Out > In
Apr 2020,37,76,13142,103427128196,2589345547,106016473743,3675,10085,1,100837782649,Out > In
Apr 2020,38,17,2,136198,188144,324342,2,2,1,51946,In > Out
Apr 2020,38,18,2,450628,19691,470319,1,2,1,430937,Out > In
Apr 2020,38,20,1,62722,104331,167053,1,1,1,41609,In > Out
Apr 2020,38,21,1,41963,76964,118927,1,1,1,35001,In > Out
Apr 2020,38,27,1,59971,91164,151135,1,1,1,31193,In > Out
Apr 2020,38,30,2,104913,172265,277178,2,2,1,67352,In > Out
Apr 2020,38,40,6,155923,918780,1074703,6,6,1,762857,In > Out
Apr 2020,38,41,480284,215427249182,82806082932,298233332114,40052,49180,1,132621166250,Out > In
Apr 2020,38,42,13451,7079368513,3689775604,10769144117,1211,9877,2,3389592909,Out > In
Apr 2020,38,43,27498,9090936622,2770434786,11861371408,4278,14878,1,6320501836,Out > In
Apr 2020,38,44,127336,51733482847,10312789755,62046272602,19226,31102,2,41420693092,Out > In
Apr 2020,38,45,10553,11672004367,1433236834,13105241201,1649,8136,1,10238767533,Out > In
Apr 2020,38,47,3,86370,427058,513428,3,3,2,340688,In > Out
Apr 2020,38,49,25676,7076486411,654483193,7730969604,3,12015,2,6422003218,Out > In
Apr 2020,38,50,2,92149,151142,243291,1,2,1,58993,In > Out
Apr 2020,38,51,3,269673,362203,631876,2,3,1,92530,In > Out
Apr 2020,38,53,1,58191,100375,158566,1,1,1,42184,In > Out
Apr 2020,38,54,1,58536,83269,141805,1,1,1,24733,In > Out
Apr 2020,38,55,11,1164192,265653,1429845,7,11,2,898539,Out > In
Apr 2020,38,56,14,1253231,529146,1782377,5,14,1,724085,Out > In
Apr 2020,4,105,11,4920989,184401,5105390,5,11,1,4736588,Out > In
Apr 2020,4,106,74,2274073293,123764051,2397837344,23,72,20,2150309242,Out > In
Apr 2020,4,11,2,240827,10821487,11062314,1,2,1,10580660,In > Out
Apr 2020,4,14,6,4485561,103824501,108310062,4,2,6,99338940,In > Out
Apr 2020,4,15,10,121074429,5877390,126951819,2,7,5,115197039,Out > In
Apr 2020,4,17,1,500968,8599889,9100857,1,1,1,8098921,In > Out
Apr 2020,43,4,30,28365488,2334273,30699761,3,30,1,26031215,Out > In
Apr 2020,44,26,13,30608268,6954150505,6984758773,6,6,6,6923542237,In > Out
Apr 2020,45,161,271,3873071589,6094102101,9967173690,230,211,39,2221030512,In > Out
Apr 2020,46,12,5,43665129,76428846,120093975,5,5,2,32763717,In > Out
Apr 2020,46,151,9,65463804,105480598,170944402,9,8,9,40016794,In > Out
Apr 2020,46,215,45,1106495296,5897699357,7004194653,38,30,45,4791204061,In > Out
Apr 2020,46,22,8,6740744,9440677,16181421,8,4,5,2699933,In > Out
Apr 2020,46,220,6,198313652,518457277,716770929,6,6,6,320143625,In > Out
Apr 2020,46,34,377,3108936784,521704013,3630640797,315,335,18,2587232771,Out > In
Apr 2020,46,44,66,1526672050,84261783100,85788455150,19,66,20,82735111050,In > Out
Apr 2020,46,79,4,13556514,19179456,32735970,4,4,3,5622942,In > Out
Apr 2020,48,171,72,32580564,28579646,61160210,15,11,2,4000918,Out > In
Apr 2020,49,113,61,735289400,2758250988,3493540388,10,4,53,2022961588,In > Out
Apr 2020,49,114,44,14400975,124921836,139322811,7,6,42,110520861,In > Out
Apr 2020,49,115,35,10216584,1761278,11977862,3,1,34,8455306,Out > In
Apr 2020,49,116,16,787055270,16862532,803917802,4,9,16,770192738,Out > In
Apr 2020,49,117,52,60164167,305517397,365681564,4,3,46,245353230,In > Out
Apr 2020,49,118,41,50410222,183108844,233519066,6,4,40,132698622,In > Out
Apr 2020,49,119,38,6753902,26453259,33207161,3,2,32,19699357,In > Out
Apr 2020,49,120,139,1626829173,901483688,2528312861,9,6,139,725345485,Out > In
Apr 2020,49,121,61,30122211,228925938,259048149,4,3,60,198803727,In > Out
Apr 2020,49,122,34,1117373201,1870816251,2988189452,13,4,34,753443050,In > Out
Apr 2020,49,123,53,449907210,1318161882,1768069092,9,4,51,868254672,In > Out
Apr 2020,49,124,66,1449539591,410390633,1859930224,10,22,65,1039148958,Out > In
Apr 2020,49,212,9,2041691653,1104735865,3146427518,7,9,1,936955788,Out > In
Apr 2020,49,244,3,539040,176148,715188,1,1,1,362892,Out > In
Apr 2020,5,103,48,137274779,40271989,177546768,2,48,1,97002790,Out > In
Apr 2020,5,16,1378,4984186117,2666683961,7650870078,193,1322,1,2317502156,Out > In
Apr 2020,5,17,4,4811591,762623,5574214,3,4,1,4048968,Out > In
Apr 2020,5,19,359,309543633,633745675,943289308,72,352,1,324202042,In > Out
Apr 2020,5,22,97,10657338416,2786712505,13444050921,5,97,1,7870625911,Out > In
Apr 2020,5,23,1,114347,74612,188959,1,1,1,39735,Out > In
Apr 2020,5,25,20,11152905,4364253,15517158,5,18,1,6788652,Out > In
Apr 2020,5,27,59,76770619,68375731,145146350,18,56,1,8394888,Out > In
Apr 2020,50,52,6,111499261,60542999,172042260,3,6,1,50956262,Out > In
Apr 2020,51,10,37,3279068,5374560,8653628,7,37,1,2095492,In > Out
Apr 2020,51,103,1,2400,145143,147543,1,1,1,142743,In > Out
Apr 2020,51,151,12,1694220906,22878105,1717099011,2,12,12,1671342801,Out > In
Apr 2020,51,152,4,468896475,191641582,660538057,3,2,4,277254893,Out > In
Apr 2020,51,154,12,4273364,988749796,993023160,1,12,12,984476432,In > Out
Apr 2020,51,182,715,3197894228,75109195,3273003423,239,710,14,3122785033,Out > In
Apr 2020,51,202,2,478002,10052996,10530998,1,2,1,9574994,In > Out
Apr 2020,51,211,10,182408641,24246616,206655257,1,7,7,158162025,Out > In
Apr 2020,51,232,17,196099,3066783,3262882,17,17,1,2870684,In > Out
Apr 2020,52,10,2764,4097079599,504175806,4601255405,1765,2640,6,3592903793,Out > In
Apr 2020,52,113,14,2920433,640945,3561378,2,14,2,2279488,Out > In
Apr 2020,52,118,9,7958346,1740090,9698436,2,9,2,6218256,Out > In
Apr 2020,52,119,1,68776,66082,134858,1,1,1,2694,Out > In
Apr 2020,52,12,2524,30824338423,1183260293,32007598716,23,2386,2,29641078130,Out > In
Apr 2020,52,120,1,165659172,4429515930,4595175102,1,1,1,4263856758,In > Out
Apr 2020,52,137,1,6377774680,8654960,6386429640,1,1,1,6369119720,Out > In
Apr 2020,52,149,55,1843668,7357716,9201384,2,25,1,5514048,In > Out
Apr 2020,52,15,2568,983754041,376036974,1359791015,51,2233,2,607717067,Out > In
Apr 2020,52,16,2457,753567892,290189496,1043757388,49,2053,2,463378396,Out > In
Apr 2020,52,163,288,69606649,33011941,102618590,36,27,2,36594708,Out > In
Apr 2020,52,172,2776,999614522,348944378,1348558900,54,2229,2,650670144,Out > In
Apr 2020,52,183,1,4046673,8339616,12386289,1,1,1,4292943,In > Out
Apr 2020,52,191,3,26037197,42076468,68113665,2,3,3,16039271,In > Out
Apr 2020,52,192,3,16959226,25559470,42518696,2,3,3,8600244,In > Out
Apr 2020,52,22,6,727919,256505,984424,3,6,2,471414,Out > In
Apr 2020,52,235,2,200607,8650,209257,1,2,1,191957,Out > In
Apr 2020,52,236,2,204006,8793,212799,2,2,1,195213,Out > In
Apr 2020,52,237,3,305983,9993,315976,3,3,1,295990,Out > In
Apr 2020,52,238,6,623337,26127,649464,5,6,1,597210,Out > In
Apr 2020,52,239,6,618265,25068,643333,5,6,1,593197,Out > In
Apr 2020,52,24,41,9094348,412726,9507074,9,41,2,8681622,Out > In
Apr 2020,52,241,2,205014,8274,213288,2,2,1,196740,Out > In
Apr 2020,52,251,7,1923260,35898,1959158,4,7,1,1887362,Out > In
Apr 2020,52,252,16,4518292,81501,4599793,9,16,1,4436791,Out > In
Apr 2020,52,253,11,1697128,61645,1758773,6,11,1,1635483,Out > In
Apr 2020,52,29,4832,26005811064,509304988,26515116052,368,4571,2,25496506076,Out > In
Apr 2020,52,35,4,6698068,807454352,814152420,1,4,4,800756284,In > Out
Apr 2020,52,36,2,2264080,268957012,271221092,1,2,2,266692932,In > Out
Apr 2020,52,4,2,291030,96309,387339,1,2,1,194721,Out > In
Apr 2020,52,8,1,100792,4053,104845,1,1,1,96739,Out > In
Apr 2020,52,9,1,98236,4589,102825,1,1,1,93647,Out > In
Apr 2020,52,97,5,2056291601,22031476,2078323077,1,5,1,2034260125,Out > In
Apr 2020,53,169,15,1768699,679681,2448380,4,15,3,1089018,Out > In
Apr 2020,53,184,1,72678,43517,116195,1,1,1,29161,Out > In
Apr 2020,53,28,29,7429825,122123811,129553636,3,29,2,114693986,In > Out
Apr 2020,54,12,76,101124623,1316082,102440705,27,76,2,99808541,Out > In
Apr 2020,55,130,5972,12813840066,152029468,12965869534,1209,5430,1,12661810598,Out > In
Apr 2020,55,137,6,818759,374983,1193742,3,6,1,443776,Out > In
Apr 2020,55,143,4,686371,344654,1031025,2,4,1,341717,Out > In
Apr 2020,55,72,1,12146963,6460296,18607259,1,1,1,5686667,Out > In
Apr 2020,55,9,7,1254743,276832,1531575,3,7,1,977911,Out > In
Apr 2020,55,96,11,63000315,1239352,64239667,1,11,1,61760963,Out > In
Apr 2020,56,152,1,107780,13713,121493,1,1,1,94067,Out > In
Apr 2020,56,154,1,51964,70380,122344,1,1,1,18416,In > Out
Apr 2020,57,129,932,919179233,62041622,981220855,202,284,1,857137611,Out > In
Apr 2020,57,131,5164,5213436959,141158673,5354595632,156,4405,2,5072278286,Out > In
Apr 2020,57,152,30,3165711,115143,3280854,5,30,1,3050568,Out > In
Apr 2020,57,153,6,670528,27389,697917,2,6,1,643139,Out > In
Apr 2020,57,166,152,46931556,2930233,49861789,1,152,1,44001323,Out > In
Apr 2020,57,180,10,123126956,2157660,125284616,1,2,10,120969296,Out > In
Apr 2020,59,16,10909,8059628093,3312084811,11371712904,1840,9018,2,4747543282,Out > In
Apr 2020,59,18,1156,66938158768,65099227418,132037386186,444,1102,268,1838931350,Out > In
Apr 2020,59,19,10399,5199074348,2137862374,7336936722,2016,8326,2,3061211974,Out > In
Apr 2020,59,21,1197,63177935987,57783441683,120961377670,419,1137,242,5394494304,Out > In
Apr 2020,60,16,13,958296,1333876,2292172,1,13,1,375580,In > Out
Apr 2020,60,17,1,52964,81582,134546,1,1,1,28618,In > Out
Apr 2020,60,18,1,58946,86500,145446,1,1,1,27554,In > Out
Apr 2020,60,24,8165,1993840776,1154280091,3148120867,1139,6701,1,839560685,Out > In
Apr 2020,60,27,347,133929625,23920532,157850157,56,346,2,110009093,Out > In
Apr 2020,60,31,4462,1447883923,109236240,1557120163,1641,4063,1,1338647683,Out > In
Apr 2020,60,35,13768,5032946041,2670873083,7703819124,1247,10533,1,2362072958,Out > In
Apr 2020,60,38,16,22753068,398416,23151484,4,16,2,22354652,Out > In
Apr 2020,60,43,111,16293759,541622,16835381,64,111,2,15752137,Out > In
Apr 2020,60,44,15336,19083100036,786578153,19869678189,1383,11452,2,18296521883,Out > In
Apr 2020,60,45,5,526748,63534,590282,5,5,1,463214,Out > In
Apr 2020,60,47,3,202887,303447,506334,3,3,1,100560,In > Out
Apr 2020,60,48,1,56348,87051,143399,1,1,1,30703,In > Out
Apr 2020,60,49,201,77074431,93138369,170212800,1,199,2,16063938,In > Out
Apr 2020,60,51,1,58188,87765,145953,1,1,1,29577,In > Out
Apr 2020,60,53,2,136893,244086,380979,1,2,1,107193,In > Out
Apr 2020,60,54,92,22867621,8818100,31685721,20,89,2,14049521,Out > In
Apr 2020,60,56,12,863109569,1938009,865047578,7,12,2,861171560,Out > In
Apr 2020,60,59,2,102909,149655,252564,2,2,1,46746,In > Out
Apr 2020,60,60,63,124612111,1797773,126409884,29,63,1,122814338,Out > In
Apr 2020,60,66,111,32687199,26305570,58992769,26,111,2,6381629,Out > In
Apr 2020,60,69,119,923905547,7703184,931608731,12,119,1,916202363,Out > In
Apr 2020,60,70,13,4638374,126857,4765231,8,13,1,4511517,Out > In
Apr 2020,60,72,1,50813,85034,135847,1,1,1,34221,In > Out
Apr 2020,60,76,1958,3281466855,342365796,3623832651,222,1843,2,2939101059,Out > In
Apr 2020,60,77,2768,13110397079,425814557,13536211636,44,2648,1,12684582522,Out > In
Apr 2020,60,79,183,203387839,2856139,206243978,27,183,1,200531700,Out > In
Apr 2020,60,80,1,42002,63211,105213,1,1,1,21209,In > Out
Apr 2020,60,83,92,66439020,25585220,92024240,31,92,2,40853800,Out > In
Apr 2020,60,84,2,503912,212735,716647,1,2,1,291177,Out > In
Apr 2020,60,87,47231,34631342815,1207357200,35838700015,8697,19776,2,33423985615,Out > In
Apr 2020,60,89,440,123791266,4641616,128432882,339,435,2,119149650,Out > In
Apr 2020,60,90,258,211381918,146834064,358215982,113,257,1,64547854,Out > In
Apr 2020,60,91,9,6445388,85761,6531149,7,9,1,6359627,Out > In
Apr 2020,60,93,1,83348,113176,196524,1,1,1,29828,In > Out
Apr 2020,60,95,84,122258346,4945616,127203962,1,84,1,117312730,Out > In
Apr 2020,7,107,5,3087798,544542,3632340,4,5,3,2543256,Out > In
Apr 2020,7,108,276,18095201,254356725,272451926,30,275,1,236261524,In > Out
Apr 2020,7,11,16,18523156,2935899,21459055,3,16,6,15587257,Out > In
Apr 2020,7,119,2,956501209,14943555,971444764,1,2,2,941557654,Out > In
Apr 2020,7,12,18,2279361122,2355630377,4634991499,12,10,18,76269255,In > Out
Apr 2020,7,129,298,250299674,118140980,368440654,50,294,3,132158694,Out > In
Apr 2020,7,15,14,726417004,11354028,737771032,5,11,14,715062976,Out > In
Apr 2020,7,165,2,254029,93791,347820,1,2,1,160238,Out > In
Apr 2020,7,172,160,90803257,102013806,192817063,2,160,1,11210549,In > Out
Apr 2020,7,186,19,7635224,149834,7785058,19,19,3,7485390,Out > In
Apr 2020,7,213,5,1936929,7253915,9190844,1,5,2,5316986,In > Out
Apr 2020,7,26,305,591486208,144552344,736038552,166,232,1,446933864,Out > In
Apr 2020,7,35,16,14099076,364256,14463332,8,16,1,13734820,Out > In
Apr 2020,7,42,1,160856,2616,163472,1,1,1,158240,Out > In
Apr 2020,7,50,1155,358093884,131269118,489363002,18,948,1,226824766,Out > In
Apr 2020,7,56,2,48947558,130289997,179237555,2,2,2,81342439,In > Out
Apr 2020,7,69,389,917473438,9665625,927139063,180,381,1,907807813,Out > In
Apr 2020,7,77,251,208828082,16300565,225128647,94,230,3,192527517,Out > In
Apr 2020,7,84,4,104214454,5034587,109249041,2,4,4,99179867,Out > In
Apr 2020,7,90,2,62065,25838589,25900654,1,1,2,25776524,In > Out
Apr 2020,7,91,6,964233,150527,1114760,4,6,1,813706,Out > In
Apr 2020,70,10,1,107210235,56122496,163332731,1,1,1,51087739,Out > In
Apr 2020,70,101,1,3640163,2450598,6090761,1,1,1,1189565,Out > In
Apr 2020,70,103,1,51052088,53088165,104140253,1,1,1,2036077,In > Out
Apr 2020,70,104,8,4201366594,3236284641,7437651235,1,8,8,965081953,Out > In
Apr 2020,70,108,1,16145112,244669280,260814392,1,1,1,228524168,In > Out
Apr 2020,70,115,1,19440,157224,176664,1,1,1,137784,In > Out
Apr 2020,70,121,4,34165361,36456045,70621406,4,4,2,2290684,In > Out
Apr 2020,70,124,8,652591658,1006761594,1659353252,5,8,6,354169936,In > Out
Apr 2020,70,128,1,92096,226092,318188,1,1,1,133996,In > Out
Apr 2020,70,13,14,108797618,370069925,478867543,14,14,2,261272307,In > Out
Apr 2020,70,136,1,10442680,28351436,38794116,1,1,1,17908756,In > Out
Apr 2020,70,138,1,16618353,423874922,440493275,1,1,1,407256569,In > Out
Apr 2020,70,14,1,805880,58293,864173,1,1,1,747587,Out > In
Apr 2020,70,140,5,235631191,265776389,501407580,4,5,5,30145198,In > Out
Apr 2020,70,148,3,7907419,25499965,33407384,2,1,3,17592546,In > Out
Apr 2020,70,149,8,11292144,106535972,117828116,3,8,6,95243828,In > Out
Apr 2020,70,151,2,263617,1876598,2140215,2,2,2,1612981,In > Out
Apr 2020,70,158,3,245582,34945009,35190591,1,1,3,34699427,In > Out
Apr 2020,70,165,2,87669611,74657983,162327594,2,2,2,13011628,Out > In
Apr 2020,70,166,7,533484929,443580260,977065189,4,5,7,89904669,Out > In
Apr 2020,70,169,2,18363592,2418426,20782018,2,1,2,15945166,Out > In
Apr 2020,70,174,2,291100321,269489547,560589868,2,2,2,21610774,Out > In
Apr 2020,70,177,12,224356,5101906,5326262,1,1,12,4877550,In > Out
Apr 2020,70,18,1,73398292,364769785,438168077,1,1,1,291371493,In > Out
Apr 2020,70,183,1,451126,11171399,11622525,1,1,1,10720273,In > Out
Apr 2020,70,188,1,95688,82681,178369,1,1,1,13007,Out > In
Apr 2020,70,189,22,189621921,93124378,282746299,22,17,2,96497543,Out > In
Apr 2020,70,19,2,114408735,153928262,268336997,1,1,2,39519527,In > Out
Apr 2020,70,193,1,3373453,16349604,19723057,1,1,1,12976151,In > Out
Apr 2020,70,197,5,34669240,37892515,72561755,5,5,4,3223275,In > Out
Apr 2020,70,20,2,206167,404164,610331,1,1,2,197997,In > Out
Apr 2020,70,200,1,343924,353243,697167,1,1,1,9319,In > Out
Apr 2020,70,201,18,94898918,2165183756,2260082674,9,9,1,2070284838,In > Out
Apr 2020,70,204,2,446367473,424932967,871300440,1,2,2,21434506,Out > In
Apr 2020,70,207,2,116614202,209718720,326332922,2,2,2,93104518,In > Out
Apr 2020,70,210,1,102948,413868,516816,1,1,1,310920,In > Out
Apr 2020,70,211,2,8338087,20605995,28944082,2,2,2,12267908,In > Out
Apr 2020,70,214,7,276664485,153672015,430336500,6,7,7,122992470,Out > In
Apr 2020,70,217,1,372802,38030,410832,1,1,1,334772,Out > In
Apr 2020,70,25,6,157204893,570327532,727532425,4,3,6,413122639,In > Out
Apr 2020,70,27,5,765103948,792771350,1557875298,4,5,5,27667402,In > Out
Apr 2020,70,30,3,297976,3605635,3903611,2,2,3,3307659,In > Out
Apr 2020,70,32,4,1420737589,2416968264,3837705853,4,4,4,996230675,In > Out
Apr 2020,70,34,59,601521,97509975,98111496,58,59,11,96908454,In > Out
Apr 2020,70,37,8,923011182,717258827,1640270009,7,8,7,205752355,Out > In
Apr 2020,70,44,3,158036,800412,958448,1,1,1,642376,In > Out
Apr 2020,70,47,3,725283685,730116886,1455400571,3,3,3,4833201,In > Out
Apr 2020,70,51,10,3217893571,2757678070,5975571641,7,6,4,460215501,Out > In
Apr 2020,70,54,1,380464,8027678,8408142,1,1,1,7647214,In > Out
Apr 2020,70,59,2,64603,4099429,4164032,1,1,2,4034826,In > Out
Apr 2020,70,66,5,580224,5531783,6112007,4,4,4,4951559,In > Out
Apr 2020,70,7,1,150841,6252903,6403744,1,1,1,6102062,In > Out
Apr 2020,70,72,3,4881874,7297336,12179210,3,3,3,2415462,In > Out
Apr 2020,70,83,1,32172,102264,134436,1,1,1,70092,In > Out
Apr 2020,70,89,1,39787,112008,151795,1,1,1,72221,In > Out
Apr 2020,70,91,5,62358804,77670347,140029151,3,5,3,15311543,In > Out
Apr 2020,70,92,1,250460,240000,490460,1,1,1,10460,Out > In
Apr 2020,70,94,3,3676561,14781047,18457608,3,3,2,11104486,In > Out
Apr 2020,70,96,3,45856831,41669766,87526597,2,3,3,4187065,Out > In
Apr 2020,72,101,3,127424,221836,349260,3,3,1,94412,In > Out
Apr 2020,72,123,213,28424082,11712147,40136229,30,212,2,16711935,Out > In
Apr 2020,72,125,1,109758,5331,115089,1,1,1,104427,Out > In
Apr 2020,72,133,2,492701,9822,502523,2,2,1,482879,Out > In
Apr 2020,72,138,3,676595,26416,703011,2,3,1,650179,Out > In
Apr 2020,72,142,1,544992,8429,553421,1,1,1,536563,Out > In
Apr 2020,72,143,1,93952,37476,131428,1,1,1,56476,Out > In
Apr 2020,72,148,28,3682370,155741,3838111,9,28,1,3526629,Out > In
Apr 2020,72,162,1,49561,95803,145364,1,1,1,46242,In > Out
Apr 2020,72,184,2,117192,183821,301013,2,2,1,66629,In > Out
Apr 2020,72,20,2,204285,17444,221729,2,2,1,186841,Out > In
Apr 2020,72,22,1,108478,5436,113914,1,1,1,103042,Out > In
Apr 2020,72,23,4,266149,353832,619981,3,4,1,87683,In > Out
Apr 2020,72,24,5,750056,26250,776306,3,5,1,723806,Out > In
Apr 2020,72,30,1,62091,124656,186747,1,1,1,62565,In > Out
Apr 2020,72,55,5,2322388,153087,2475475,4,5,2,2169301,Out > In
Apr 2020,72,56,6,477757,320931,798688,5,6,2,156826,Out > In
Apr 2020,72,57,3,1838949,23586,1862535,2,3,2,1815363,Out > In
Apr 2020,72,59,1,57641,95142,152783,1,1,1,37501,In > Out
Apr 2020,72,63,2,389654,94390,484044,2,2,2,295264,Out > In
Apr 2020,72,67,3,502909,133172,636081,3,3,2,369737,Out > In
Apr 2020,72,70,2,247925,13747,261672,2,2,1,234178,Out > In
Apr 2020,72,83,1,53193,77331,130524,1,1,1,24138,In > Out
Apr 2020,72,97,15,1835445,88800,1924245,7,15,1,1746645,Out > In
Apr 2020,72,98,2,111046,174686,285732,2,2,1,63640,In > Out
Apr 2020,73,10,16604,19349184215,507367331,19856551546,3601,12906,2,18841816884,Out > In
Apr 2020,73,121,1,55157773,36659412,91817185,1,1,1,18498361,Out > In
Apr 2020,73,137,6,159285808,195634272,354920080,1,1,6,36348464,In > Out
Apr 2020,73,14,541,840233907,20671108,860905015,173,536,1,819562799,Out > In
Apr 2020,73,148,2701,918211040,308672091,1226883131,57,2195,3,609538949,Out > In
Apr 2020,73,149,14,2401175,744983,3146158,6,14,2,1656192,Out > In
Apr 2020,73,157,3067,1012694494,378664451,1391358945,101,2428,4,634030043,Out > In
Apr 2020,73,166,90,202465466,3764655,206230121,72,87,2,198700811,Out > In
Apr 2020,73,167,6,702180,328035,1030215,3,6,1,374145,Out > In
Apr 2020,73,181,23,2780440184,526935369,3307375553,12,17,14,2253504815,Out > In
Apr 2020,73,195,1,119687,33195,152882,1,1,1,86492,Out > In
Apr 2020,73,2,1,182966,16223,199189,1,1,1,166743,Out > In
Apr 2020,73,217,83,38561962,10374723,48936685,27,83,1,28187239,Out > In
Apr 2020,73,237,35751,274800998832,4396829060,279197827892,5985,10346,2,270404169772,Out > In
Apr 2020,73,24,127,64219177,6464833,70684010,55,126,1,57754344,Out > In
Apr 2020,73,29,2,409272,118805,528077,1,2,1,290467,Out > In
Apr 2020,73,31,170,1617626864,372251504,1989878368,142,133,1,1245375360,Out > In
Apr 2020,73,32,169,1642348600,375125691,2017474291,139,131,1,1267222909,Out > In
Apr 2020,73,4,803,2468153829,26260041,2494413870,6,782,2,2441893788,Out > In
Apr 2020,73,46,26,7225384,252158,7477542,11,26,1,6973226,Out > In
Apr 2020,73,57,1,89826,16493,106319,1,1,1,73333,Out > In
Apr 2020,73,66,9,1874751,358011,2232762,5,9,1,1516740,Out > In
Apr 2020,73,7,1,524306,12294,536600,1,1,1,512012,Out > In
Apr 2020,73,74,1,212683,20472,233155,1,1,1,192211,Out > In
Apr 2020,73,8,40,7259674,507332,7767006,33,40,1,6752342,Out > In
Apr 2020,73,9,3,1029223,1096381,2125604,2,3,1,67158,In > Out
Apr 2020,74,10,1,111491,43814636,43926127,1,1,1,43703145,In > Out
Apr 2020,74,104,2,70937892,1295436,72233328,1,2,2,69642456,Out > In
Apr 2020,74,114,3,112538,3353852,3466390,1,1,3,3241314,In > Out
Apr 2020,74,12,5,952618,370312,1322930,3,5,1,582306,Out > In
Apr 2020,74,145,1,107750,60776,168526,1,1,1,46974,Out > In
Apr 2020,74,152,2399,848270797,253289619,1101560416,52,2176,3,594981178,Out > In
Apr 2020,74,154,2419,751550696,276771322,1028322018,42,2068,1,474779374,Out > In
Apr 2020,74,155,2995,1215974979,346103376,1562078355,67,2339,2,869871603,Out > In
Apr 2020,74,170,7,445031889,1425196155,1870228044,5,4,7,980164266,In > Out
Apr 2020,74,208,1,3504,203000,206504,1,1,1,199496,In > Out
Apr 2020,74,21,4,20984753,146318370,167303123,2,2,4,125333617,In > Out
Apr 2020,74,230,2643,931752016,354433582,1286185598,62,2177,2,577318434,Out > In
Apr 2020,74,39,4,153262711,191841124,345103835,3,2,4,38578413,In > Out
Apr 2020,74,45,3003,1429528735,388010533,1817539268,72,2484,4,1041518202,Out > In
Apr 2020,74,52,916,1079219852,260794838,1340014690,494,390,1,818425014,Out > In
Apr 2020,74,58,1,4241469,169308592,173550061,1,1,1,165067123,In > Out
Apr 2020,74,8,5,1503880,128105,1631985,5,5,2,1375775,Out > In
Apr 2020,77,120,3,441938,76969,518907,2,3,1,364969,Out > In
Apr 2020,77,122,302,33847668,22885700,56733368,4,11,1,10961968,Out > In
Apr 2020,77,231,1,598115,581571,1179686,1,1,1,16544,Out > In
Apr 2020,79,10,1,8561376,392516,8953892,1,1,1,8168860,Out > In
Apr 2020,79,11,1,3932154,152384294276,152388226430,1,1,1,152380362122,In > Out
Apr 2020,79,12,20,21732057,3365234725,3386966782,5,20,1,3343502668,In > Out
Apr 2020,79,14,9,142107018,20382222509,20524329527,2,7,9,20240115491,In > Out
Apr 2020,79,9,140,27525589,8044884,35570473,63,114,2,19480705,Out > In
Apr 2020,80,51,3,194164,218688,412852,1,3,3,24524,In > Out
Apr 2020,81,140,148744,221162280911,39962621776,261124902687,2680,21197,1,181199659135,Out > In
Apr 2020,82,103,8,1034064,588670,1622734,7,8,1,445394,Out > In
Apr 2020,82,142,1008,7289007488,332849416,7621856904,161,378,1,6956158072,Out > In
Apr 2020,82,151,1,34263,692039,726302,1,1,1,657776,In > Out
Apr 2020,82,167,42,483216659,12182214,495398873,1,42,1,471034445,Out > In
Apr 2020,82,204,312,67595008,32894184,100489192,30,17,1,34700824,Out > In
Apr 2020,82,239,2486,907785910,347708216,1255494126,48,2171,3,560077694,Out > In
Apr 2020,82,92,2,18303,708180,726483,2,1,2,689877,In > Out
Apr 2020,83,107,5,3971338,2277018,6248356,1,5,5,1694320,Out > In
Apr 2020,83,112,2,236737,263035,499772,1,2,2,26298,In > Out
Apr 2020,83,149,1,367271,12320074,12687345,1,1,1,11952803,In > Out
Apr 2020,83,153,1,133037,619044,752081,1,1,1,486007,In > Out
Apr 2020,84,36,7,437237573,24285191,461522764,4,7,6,412952382,Out > In
Apr 2020,85,104,1,34647,623335,657982,1,1,1,588688,In > Out
Apr 2020,85,107,2,6581566,28051562,34633128,1,1,2,21469996,In > Out
Apr 2020,85,110,1,5275834,23296338,28572172,1,1,1,18020504,In > Out
Apr 2020,85,112,4,81505980,45181625,126687605,3,2,4,36324355,Out > In
Apr 2020,85,114,6,142158604,423729139,565887743,4,3,6,281570535,In > Out
Apr 2020,85,118,6,316566000,473403131,789969131,4,4,6,156837131,In > Out
Apr 2020,85,119,1,44600725,235962578,280563303,1,1,1,191361853,In > Out
Apr 2020,85,123,1,55322400,39984343,95306743,1,1,1,15338057,Out > In
Apr 2020,85,124,3,1065753188,1269375567,2335128755,2,2,3,203622379,In > Out
Apr 2020,85,126,6,1017349,301674932,302692281,2,1,6,300657583,In > Out
Apr 2020,85,127,8,620997729,1108437420,1729435149,3,1,8,487439691,In > Out
Apr 2020,85,131,8,191548324,574675320,766223644,4,1,8,383126996,In > Out
Apr 2020,85,132,6,430366492,890720541,1321087033,5,1,6,460354049,In > Out
Apr 2020,85,133,10,205043441,954523454,1159566895,4,1,10,749480013,In > Out
Apr 2020,85,139,3,347990767,1886419730,2234410497,2,2,3,1538428963,In > Out
Apr 2020,85,16,132,24435122100,5136734264,29571856364,39,4,1,19298387836,Out > In
Apr 2020,85,2,3203,3920807169,101520432,4022327601,286,69,1,3819286737,Out > In
Apr 2020,86,175,82,77755126,805219,78560345,62,82,2,76949907,Out > In
Apr 2020,86,66,33389,11944738208,381044075,12325782283,11765,19572,2,11563694133,Out > In
Apr 2020,89,111,1,97343086,2337951,99681037,1,1,1,95005135,Out > In
Apr 2020,89,52,1,2343225,29280,2372505,1,1,1,2313945,Out > In
Apr 2020,89,82,4,3685017,867570050,871255067,2,1,4,863885033,In > Out
Apr 2020,9,155,6,242370,1148654,1391024,3,1,6,906284,In > Out
Apr 2020,9,51,2,2491746,90520798,93012544,1,1,2,88029052,In > Out
Apr 2020,9,56,5,12443883,10765465,23209348,3,4,5,1678418,Out > In
Apr 2020,90,126,1,14835052,233447,15068499,1,1,1,14601605,Out > In
Apr 2020,90,235,13334,64017261014,2561105355,66578366369,662,8023,6,61456155659,Out > In
Apr 2020,90,236,921,294974892,2327937333,2622912225,391,511,1,2032962441,In > Out
Apr 2020,90,253,37,2229985722,61702509,2291688231,11,26,37,2168283213,Out > In
Apr 2020,90,29,5,6713656967,62904168,6776561135,2,5,5,6650752799,Out > In
Apr 2020,90,43,12,592656982,23433677,616090659,3,12,12,569223305,Out > In
Apr 2020,90,5,4,185074081,183452408,368526489,4,1,4,1621673,Out > In
Apr 2020,90,7,2,156448548,3168825,159617373,1,2,2,153279723,Out > In
Apr 2020,91,20,4,22479467,2461382,24940849,4,2,4,20018085,Out > In
Apr 2020,91,225,10,1724471862,166831329,1891303191,4,10,1,1557640533,Out > In
Apr 2020,91,227,1,260984,249660,510644,1,1,1,11324,Out > In
Apr 2020,91,228,3,369247399,131405430,500652829,2,3,1,237841969,Out > In
Apr 2020,91,239,9601,48651039856,813748675,49464788531,1805,8600,3,47837291181,Out > In
Apr 2020,91,58,3,14066404,2022522,16088926,1,3,3,12043882,Out > In
Apr 2020,92,228,5609,11737662690,307274432,12044937122,461,221,1,11430388258,Out > In
Apr 2020,92,250,2,335028,10043,345071,1,2,1,324985,Out > In
Apr 2020,92,37,1,76766385,2492758,79259143,1,1,1,74273627,Out > In
Apr 2020,92,6,24,1359992671,56780501,1416773172,2,24,24,1303212170,Out > In
Apr 2020,94,22,3773,4370330338,557609932,4927940270,566,3172,17,3812720406,Out > In
Apr 2020,94,29,583,5741965302,5818971391,11560936693,61,43,477,77006089,In > Out
Apr 2020,94,51,98,127454699,2590106,130044805,2,98,98,124864593,Out > In
Apr 2020,96,1,3273,2971945081,81347967,3053293048,1302,3084,2,2890597114,Out > In
Apr 2020,96,10,353,508392271,24247304,532639575,54,353,1,484144967,Out > In
Apr 2020,96,119,12,2911204,76705,2987909,6,12,1,2834499,Out > In
Apr 2020,96,12,1,100569,4296,104865,1,1,1,96273,Out > In
Apr 2020,96,125,1801285,1398073002663,86978463562,1485051466225,154673,64507,2,1311094539101,Out > In
Apr 2020,96,135,2,143094,118035,261129,2,2,2,25059,Out > In
Apr 2020,96,136,354,980584445,32141183,1012725628,38,347,2,948443262,Out > In
Apr 2020,96,141,4,247142,329806,576948,3,4,2,82664,In > Out
Apr 2020,96,142,3,264346,76067,340413,3,3,2,188279,Out > In
Apr 2020,96,144,378372,164241393116,7727069422,171968462538,54031,54150,2,156514323694,Out > In
Apr 2020,96,148,20,11965061,545110,12510171,3,20,2,11419951,Out > In
Apr 2020,96,149,689,213218981,12288792,225507773,351,635,1,200930189,Out > In
Apr 2020,96,150,6,7075990,205267,7281257,4,6,2,6870723,Out > In
Apr 2020,96,151,2,98436,148845,247281,2,2,1,50409,In > Out
Apr 2020,96,152,35,13678076,12424073,26102149,22,35,2,1254003,Out > In
Apr 2020,96,163,77,23522755,9676335,33199090,12,77,2,13846420,Out > In
Apr 2020,96,17,3,272050,186516,458566,3,3,1,85534,Out > In
Apr 2020,96,180,1,107607,5115,112722,1,1,1,102492,Out > In
Apr 2020,96,190,1412,3074155156,598427041,3672582197,140,1353,2,2475728115,Out > In
Apr 2020,96,24,172,384408146,5880179,390288325,50,172,2,378527967,Out > In
Apr 2020,96,25,27190,4495635783,210914558,4706550341,13594,18249,2,4284721225,Out > In
Apr 2020,96,26,4402,2110831505,45641199,2156472704,1334,4109,2,2065190306,Out > In
Apr 2020,96,30,606,516753776,69818858,586572634,53,597,2,446934918,Out > In
Apr 2020,96,31,426,41335538,29797661,71133199,339,421,2,11537877,Out > In
Apr 2020,96,33,117,72027133,7076786,79103919,11,117,1,64950347,Out > In
Apr 2020,96,34,3,490738,124637,615375,2,3,2,366101,Out > In
Apr 2020,96,39,3373,1670899092,175340600,1846239692,423,3085,1,1495558492,Out > In
Apr 2020,96,41,12,4231352,352064,4583416,8,12,2,3879288,Out > In
Apr 2020,96,5,146,56158846,1783889,57942735,119,136,2,54374957,Out > In
Apr 2020,96,51,218420,44754474172,4863858143,49618332315,39769,37271,2,39890616029,Out > In
Apr 2020,96,53,894,289367641,20752836,310120477,9,873,2,268614805,Out > In
Apr 2020,96,58,143,61585719,17393415,78979134,17,143,2,44192304,Out > In
Apr 2020,96,60,127,1384972097,436318847,1821290944,52,125,3,948653250,Out > In
Apr 2020,96,61,2,430520,12751,443271,1,2,1,417769,Out > In
Apr 2020,96,62,703,214368556,25747412,240115968,75,696,1,188621144,Out > In
Apr 2020,96,73,2,370016,115028,485044,2,2,2,254988,Out > In
Apr 2020,96,74,1,66124,95439,161563,1,1,1,29315,In > Out
Apr 2020,96,78,371,7099506132,125647979,7225154111,23,366,2,6973858153,Out > In
Apr 2020,96,79,3,445430,23485,468915,1,3,1,421945,Out > In
Apr 2020,96,80,2,140900,132582,273482,2,2,2,8318,Out > In
Apr 2020,96,81,14070,13390328097,2912245614,16302573711,1172,9801,1,10478082483,Out > In
Apr 2020,96,82,2,301228,41494,342722,2,2,1,259734,Out > In
Apr 2020,96,85,4207,612571820,490649579,1103221399,359,3659,2,121922241,Out > In
Apr 2020,96,88,1150,565033952,20072475,585106427,435,1126,1,544961477,Out > In
Apr 2020,96,94,6,2526911,155624,2682535,1,6,1,2371287,Out > In
Apr 2020,96,95,23190,4452393254,810427246,5262820500,301,13164,2,3641966008,Out > In
Apr 2020,96,96,77120,18753695048,1744622303,20498317351,2501,20294,2,17009072745,Out > In
Apr 2020,96,98,1,58958,88796,147754,1,1,1,29838,In > Out
Apr 2020,98,103,9,92530911,297343570,389874481,8,8,9,204812659,In > Out
Apr 2020,98,108,11,95954723,152908948,248863671,9,10,11,56954225,In > Out
Apr 2020,98,113,4,476996177,491731956,968728133,3,4,3,14735779,In > Out
Apr 2020,98,124,3,517604350,826959061,1344563411,3,3,3,309354711,In > Out
Apr 2020,98,125,627,10240240042,1149452655,11389692697,355,272,1,9090787387,Out > In
Apr 2020,98,126,3,76274134,105571743,181845877,3,3,3,29297609,In > Out
Apr 2020,98,130,34,5211024498,5937072672,11148097170,14,34,24,726048174,In > Out
Apr 2020,98,133,6,305128041,281641736,586769777,5,5,6,23486305,Out > In
Apr 2020,98,134,1,2000994,737744,2738738,1,1,1,1263250,Out > In
Apr 2020,98,137,4,81367412,52058639,133426051,4,4,4,29308773,Out > In
Apr 2020,98,138,2,16270087,36817585,53087672,2,2,1,20547498,In > Out
Apr 2020,98,139,2,368731,81886218,82254949,1,1,2,81517487,In > Out
Apr 2020,98,14,1,28512,167040,195552,1,1,1,138528,In > Out
Apr 2020,98,140,2,3812755,5712000,9524755,2,2,2,1899245,In > Out
Apr 2020,98,142,2,5228524,4995569,10224093,2,2,2,232955,Out > In
Apr 2020,98,146,2,14136973,12779911,26916884,2,2,2,1357062,Out > In
Apr 2020,98,15,4,742232359,18634100,760866459,1,4,1,723598259,Out > In
Apr 2020,98,150,1,3261,4403629,4406890,1,1,1,4400368,In > Out
Apr 2020,98,157,2,303576929,265822423,569399352,1,2,2,37754506,Out > In
Apr 2020,98,16,1,1588481,1154416,2742897,1,1,1,434065,Out > In
Apr 2020,98,168,36,43395581,306384117,349779698,11,28,36,262988536,In > Out
Apr 2020,98,170,3,383376,703688,1087064,1,1,1,320312,In > Out
Apr 2020,98,172,54,1569619,56622988,58192607,54,54,7,55053369,In > Out
Apr 2020,98,173,1,4157945,3531472,7689417,1,1,1,626473,Out > In
Apr 2020,98,179,12,157017779,289503423,446521202,12,12,8,132485644,In > Out
Apr 2020,98,18,3,83579875,259569991,343149866,3,3,3,175990116,In > Out
Apr 2020,98,182,1,14492443,11644711,26137154,1,1,1,2847732,Out > In
Apr 2020,98,186,6,43153030,130514219,173667249,6,6,6,87361189,In > Out
Apr 2020,98,196,140,201225393,208313416,409538809,107,140,135,7088023,In > Out
Apr 2020,98,199,2,1241652,7770163,9011815,2,2,2,6528511,In > Out
Apr 2020,98,204,2,2157828,4364236,6522064,2,1,2,2206408,In > Out
Apr 2020,98,206,1,44193600,29509107,73702707,1,1,1,14684493,Out > In
Apr 2020,98,208,1,95408,66154,161562,1,1,1,29254,Out > In
Apr 2020,98,222,1,91474,6942098,7033572,1,1,1,6850624,In > Out
Apr 2020,98,23,2,34679423,38872421,73551844,2,2,2,4192998,In > Out
Apr 2020,98,28,9,109360123,144619357,253979480,1,9,8,35259234,In > Out
Apr 2020,98,29,2,310341656,629018351,939360007,1,1,2,318676695,In > Out
Apr 2020,98,30,1,21641,182486,204127,1,1,1,160845,In > Out
Apr 2020,98,4,1,5822671,10309326,16131997,1,1,1,4486655,In > Out
Apr 2020,98,44,8,427787,8949014,9376801,7,7,3,8521227,In > Out
Apr 2020,98,46,2,636585,65198382,65834967,1,1,2,64561797,In > Out
Apr 2020,98,51,699,18315831,656754110,675069941,680,672,57,638438279,In > Out
Apr 2020,98,57,34,97234805,422994356,520229161,30,30,13,325759551,In > Out
Apr 2020,98,60,8,28994972,37040844,66035816,7,8,6,8045872,In > Out
Apr 2020,98,64,1,7788339,54573904,62362243,1,1,1,46785565,In > Out
Apr 2020,98,70,3,20222164,18805463,39027627,1,3,3,1416701,Out > In
Apr 2020,98,72,1,283727,354053,637780,1,1,1,70326,In > Out
Apr 2020,98,76,788,306220491,4407989779,4714210270,694,724,19,4101769288,In > Out
Apr 2020,98,8,3,15194986,23922622,39117608,2,2,3,8727636,In > Out
Apr 2020,98,80,3,2088568,19414562,21503130,1,2,3,17325994,In > Out
Apr 2020,98,90,4,89747257,91322667,181069924,4,3,3,1575410,In > Out
Apr 2020,98,93,6,605736215,189247249,794983464,3,1,6,416488966,Out > In
Apr 2020,98,94,7,59874595,163578524,223453119,6,6,7,103703929,In > Out
Apr 2020,98,96,37,276945127,552949301,829894428,32,35,3,276004174,In > Out
Apr 2020,99,121,1,2924800,55587189,58511989,1,1,1,52662389,In > Out
Apr 2020,99,123,1031,284761230,142192669,426953899,404,552,1,142568561,Out > In
Apr 2020,99,130,7,7043445560,5169180648,12212626208,2,2,4,1874264912,Out > In
Apr 2020,99,131,3,7803754,1656600,9460354,1,3,1,6147154,Out > In
Apr 2020,99,162,111,693415481,3539085,696954566,43,111,3,689876396,Out > In
Apr 2020,99,167,3,45429364,2411510,47840874,3,3,2,43017854,Out > In
Apr 2020,99,168,19,384608138,39880955,424489093,2,19,19,344727183,Out > In
Apr 2020,99,182,3114,1506534651,397441661,1903976312,63,2417,2,1109092990,Out > In
Apr 2020,99,248,8,20447673,5880129,26327802,1,8,8,14567544,Out > In
Apr 2020,99,51,2,300035690,4758894,304794584,1,2,2,295276796,Out > In
Apr 2020,99,75,1,3868545,1678340,5546885,1,1,1,2190205,Out > In
Apr 2020,99,92,14,28160574,9665099,37825673,1,14,14,18495475,Out > In
Sept 2020,1,21,22,1310940,1304462,2615402,1,5,1,6478,Out > In
Sept 2020,100,132,359,101556656,41607774,143164430,336,311,3,59948882,Out > In
Sept 2020,100,147,8,1179381,57586,1236967,7,8,2,1121795,Out > In
Sept 2020,100,80,3,11429470,6497792,17927262,1,1,1,4931678,Out > In
Sept 2020,101,102,1,117643739,14586714,132230453,1,1,1,103057025,Out > In
Sept 2020,101,160,261,2435984877,85215103,2521199980,241,245,2,2350769774,Out > In
Sept 2020,101,175,11,10151975,5008652,15160627,2,11,1,5143323,Out > In
Sept 2020,101,177,3,1614505221,15130954,1629636175,2,3,2,1599374267,Out > In
Sept 2020,101,208,7,37140825025,16808137858,53948962883,3,7,1,20332687167,Out > In
Sept 2020,101,223,9,127768874,7965991,135734865,1,9,1,119802883,Out > In
Sept 2020,101,229,6,288343525,84346529,372690054,1,6,1,203996996,Out > In
Sept 2020,101,69,310,2446755696,19384864,2466140560,131,309,1,2427370832,Out > In
Sept 2020,102,102,68,1088541284,220725926,1309267210,44,68,1,867815358,Out > In
Sept 2020,103,233,1286,36684628423,2502365269,39186993692,273,1005,4,34182263154,Out > In
Sept 2020,104,116,1,4472183,35511195,39983378,1,1,1,31039012,In > Out
Sept 2020,104,150,48,4696976696,157286222,4854262918,1,48,1,4539690474,Out > In
Sept 2020,104,167,2,270858,40608,311466,1,1,1,230250,Out > In
Sept 2020,104,172,8,885223334,3713551587,4598774921,7,5,8,2828328253,In > Out
Sept 2020,104,187,58,2569600806,193916461,2763517267,11,51,12,2375684345,Out > In
Sept 2020,104,232,14,90140884,4983526,95124410,1,14,11,85157358,Out > In
Sept 2020,104,237,6,1327133436,20473529,1347606965,2,6,6,1306659907,Out > In
Sept 2020,104,238,6,3103365,151025643,154129008,4,3,6,147922278,In > Out
Sept 2020,104,250,2,49180,1650460,1699640,2,2,1,1601280,In > Out
Sept 2020,104,57,6,8313117,467611185,475924302,3,3,5,459298068,In > Out
Sept 2020,104,96,2,67888311,1202902,69091213,2,2,2,66685409,Out > In
Sept 2020,110,212,1,18220,243180,261400,1,1,1,224960,In > Out
Sept 2020,111,5,218,235505039,107048977,342554016,55,167,20,128456062,Out > In
Sept 2020,112,10,2,1651502123,1975134298,3626636421,2,2,1,323632175,In > Out
Sept 2020,112,102,9,25877864,11262399,37140263,2,4,9,14615465,Out > In
Sept 2020,112,107,5,2256795745,1840959097,4097754842,4,5,3,415836648,Out > In
Sept 2020,112,109,33,3205838,26715475,29921313,33,33,8,23509637,In > Out
Sept 2020,112,111,1,22205371,5199629,27405000,1,1,1,17005742,Out > In
Sept 2020,112,112,3,5779840,36229462,42009302,2,1,3,30449622,In > Out
Sept 2020,112,115,3,572564,55213569,55786133,2,2,3,54641005,In > Out
Sept 2020,112,119,2,951005257,560365465,1511370722,2,2,2,390639792,Out > In
Sept 2020,112,125,1,133922,32233,166155,1,1,1,101689,Out > In
Sept 2020,112,126,1,113072332,87038411,200110743,1,1,1,26033921,Out > In
Sept 2020,112,127,7,12564067,206540497,219104564,3,1,7,193976430,In > Out
Sept 2020,112,129,1,115911,417113,533024,1,1,1,301202,In > Out
Sept 2020,112,131,2,103210735,89161109,192371844,2,2,2,14049626,Out > In
Sept 2020,112,132,742,18057830038,1154317875,19212147913,397,721,1,16903512163,Out > In
Sept 2020,112,133,2,25446518,23869602,49316120,2,2,2,1576916,Out > In
Sept 2020,112,135,2,300649975,336924919,637574894,1,2,2,36274944,In > Out
Sept 2020,112,136,3,2310305571,1658887403,3969192974,3,3,3,651418168,Out > In
Sept 2020,112,141,2,2687760,215763176,218450936,1,1,2,213075416,In > Out
Sept 2020,112,142,2,583220184,580952006,1164172190,2,2,2,2268178,Out > In
Sept 2020,112,144,1,36989273,636064,37625337,1,1,1,36353209,Out > In
Sept 2020,112,146,2,3733573,4588361,8321934,1,2,1,854788,In > Out
Sept 2020,112,148,1,2102460,1415484,3517944,1,1,1,686976,Out > In
Sept 2020,112,149,7,149038335,303969991,453008326,2,3,7,154931656,In > Out
Sept 2020,112,152,4,1502306704,1432839575,2935146279,3,4,4,69467129,Out > In
Sept 2020,112,153,7,12750321,343523701,356274022,6,1,7,330773380,In > Out
Sept 2020,112,154,2,176530984,56469354,233000338,2,2,2,120061630,Out > In
Sept 2020,112,155,1,202428,157969,360397,1,1,1,44459,Out > In
Sept 2020,112,156,1,32980,292286,325266,1,1,1,259306,In > Out
Sept 2020,112,157,3,123029285,217134629,340163914,3,3,3,94105344,In > Out
Sept 2020,112,164,1,1755180633,2170142828,3925323461,1,1,1,414962195,In > Out
Sept 2020,112,169,4,6694866,4222557,10917423,4,4,3,2472309,Out > In
Sept 2020,112,174,6,50231172,24807033,75038205,4,4,6,25424139,Out > In
Sept 2020,112,175,1,119583108,276700824,396283932,1,1,1,157117716,In > Out
Sept 2020,112,177,2,614765,6832681,7447446,2,1,2,6217916,In > Out
Sept 2020,112,179,5,142672758,676353547,819026305,2,5,1,533680789,In > Out
Sept 2020,112,183,2,815897,674362,1490259,2,2,2,141535,Out > In
Sept 2020,112,185,1,69170150,271439632,340609782,1,1,1,202269482,In > Out
Sept 2020,112,186,3,1658063675,2775650592,4433714267,2,2,2,1117586917,In > Out
Sept 2020,112,190,12,111782436,365488690,477271126,6,4,12,253706254,In > Out
Sept 2020,112,193,1,63989,985020,1049009,1,1,1,921031,In > Out
Sept 2020,112,202,4,304843074,221877332,526720406,4,4,3,82965742,Out > In
Sept 2020,112,207,668,7861968841,3809140548,11671109389,218,657,2,4052828293,Out > In
Sept 2020,112,208,1,693961,662560,1356521,1,1,1,31401,Out > In
Sept 2020,112,213,1,455698,618495,1074193,1,1,1,162797,In > Out
Sept 2020,112,216,4,26007884,25802205,51810089,2,3,3,205679,Out > In
Sept 2020,112,220,1,462534,1243240,1705774,1,1,1,780706,In > Out
Sept 2020,112,223,3,688795,11495448,12184243,3,2,3,10806653,In > Out
Sept 2020,112,31,1,1677113309,1697757205,3374870514,1,1,1,20643896,In > Out
Sept 2020,112,33,3,1419587,209389083,210808670,1,1,3,207969496,In > Out
Sept 2020,112,40,1,134896028,1444437536,1579333564,1,1,1,1309541508,In > Out
Sept 2020,112,45,12,1931966206,1645510971,3577477177,7,12,12,286455235,Out > In
Sept 2020,112,6,3,160982595,233338687,394321282,2,3,3,72356092,In > Out
Sept 2020,112,64,2,158813645,160964576,319778221,1,2,2,2150931,In > Out
Sept 2020,112,68,1,120595,78133,198728,1,1,1,42462,Out > In
Sept 2020,112,74,1,42090,4810601,4852691,1,1,1,4768511,In > Out
Sept 2020,112,84,2,7728245,403992819,411721064,2,1,2,396264574,In > Out
Sept 2020,112,88,9,635958736,1208966193,1844924929,7,5,9,573007457,In > Out
Sept 2020,112,9,3,804493164,702535517,1507028681,3,3,1,101957647,Out > In
Sept 2020,112,90,1,25952707,45397249,71349956,1,1,1,19444542,In > Out
Sept 2020,112,94,1,8251202,24738512,32989714,1,1,1,16487310,In > Out
Sept 2020,112,99,1,1298599991,581363761,1879963752,1,1,1,717236230,Out > In
Sept 2020,115,95,1,26792,551149,577941,1,1,1,524357,In > Out
Sept 2020,117,150,519,145757371,54425664,200183035,7,512,1,91331707,Out > In
Sept 2020,117,16,44,109650981,11389525,121040506,3,44,1,98261456,Out > In
Sept 2020,117,208,2,73427744,357231,73784975,1,2,1,73070513,Out > In
Sept 2020,117,209,4,214597533,294319429,508916962,4,3,4,79721896,In > Out
Sept 2020,117,236,123,41404688,3258925,44663613,29,123,2,38145763,Out > In
Sept 2020,117,254,4294,19047056688,603138186,19650194874,466,3860,1,18443918502,Out > In
Sept 2020,117,50,166,743385833,20983912,764369745,1,2,164,722401921,Out > In
Sept 2020,117,76,2,4110056,2584112,6694168,1,1,1,1525944,Out > In
Sept 2020,118,108,3,636886319,3193154330,3830040649,3,3,3,2556268011,In > Out
Sept 2020,118,119,1,19380,175480,194860,1,1,1,156100,In > Out
Sept 2020,118,124,3,1071993694,14281092,1086274786,1,3,3,1057712602,Out > In
Sept 2020,118,143,154,5218016,44476368,49694384,3,1,1,39258352,In > Out
Sept 2020,118,144,3,1261271844,15055989,1276327833,1,3,3,1246215855,Out > In
Sept 2020,118,164,131,911400,19855670,20767070,108,131,1,18944270,In > Out
Sept 2020,118,179,11,987347033,37022150,1024369183,2,9,9,950324883,Out > In
Sept 2020,118,182,24,14689356,8249837,22939193,9,5,1,6439519,Out > In
Sept 2020,118,207,1,26071,112311,138382,1,1,1,86240,In > Out
Sept 2020,118,225,1,8416692,640327,9057019,1,1,1,7776365,Out > In
Sept 2020,118,226,1,122459,1970,124429,1,1,1,120489,Out > In
Sept 2020,118,239,11,33103090,185196182,218299272,9,7,8,152093092,In > Out
Sept 2020,118,240,1,4040,196028,200068,1,1,1,191988,In > Out
Sept 2020,118,247,1,129769,1970,131739,1,1,1,127799,Out > In
Sept 2020,118,46,31,461234288,16822729,478057017,5,31,31,444411559,Out > In
Sept 2020,118,47,1,135767,81872,217639,1,1,1,53895,Out > In
Sept 2020,118,63,5,494760,502464,997224,1,1,1,7704,In > Out
Sept 2020,119,102,11,99166341,23372728,122539069,2,11,1,75793613,Out > In
Sept 2020,119,114,8,2318153544,1018515301,3336668845,1,8,1,1299638243,Out > In
Sept 2020,119,120,1,17008,709968,726976,1,1,1,692960,In > Out
Sept 2020,119,141,1,26392,655530,681922,1,1,1,629138,In > Out
Sept 2020,119,16,22,12739165,191735,12930900,1,22,2,12547430,Out > In
Sept 2020,119,168,1353,1340718434,416214614,1756933048,153,1252,4,924503820,Out > In
Sept 2020,119,169,1020,8871644066,265829642,9137473708,3,999,2,8605814424,Out > In
Sept 2020,119,185,1,93879,97440,191319,1,1,1,3561,In > Out
Sept 2020,119,188,2,23062528,676220256,699282784,2,2,1,653157728,In > Out
Sept 2020,119,42,16,4562264,201553,4763817,3,16,1,4360711,Out > In
Sept 2020,119,91,1,16372,198092,214464,1,1,1,181720,In > Out
Sept 2020,120,71,165,18377904694,11858995001,30236899695,14,165,3,6518909693,Out > In
Sept 2020,122,103,1,7540,875996,883536,1,1,1,868456,In > Out
Sept 2020,122,117,1,5613,103962,109575,1,1,1,98349,In > Out
Sept 2020,122,165,26,431929829,37083365,469013194,4,26,1,394846464,Out > In
Sept 2020,122,183,5285,505578699360,534009314390,1039588013750,1644,4370,269,28430615030,In > Out
Sept 2020,122,214,1345,1318462801,409725348,1728188149,146,1240,2,908737453,Out > In
Sept 2020,122,232,141,21748443,361095,22109538,65,141,1,21387348,Out > In
Sept 2020,122,237,1488,22157093187,62971084154,85128177341,278,599,8,40813990967,In > Out
Sept 2020,122,76,68,24559210,296498,24855708,2,68,1,24262712,Out > In
Sept 2020,123,101,2,464282934,328266631,792549565,1,2,1,136016303,Out > In
Sept 2020,123,103,76,168897897,964087265,1132985162,56,52,1,795189368,In > Out
Sept 2020,123,104,1,217678,1290712,1508390,1,1,1,1073034,In > Out
Sept 2020,123,105,1,6015090,19109112,25124202,1,1,1,13094022,In > Out
Sept 2020,123,107,1,75178,231457,306635,1,1,1,156279,In > Out
Sept 2020,123,111,3051,33107611507,5047977504,38155589011,1612,2869,3,28059634003,Out > In
Sept 2020,123,128,5,848809251,874527381,1723336632,2,5,5,25718130,In > Out
Sept 2020,123,129,1,61888,60268,122156,1,1,1,1620,Out > In
Sept 2020,123,130,1,621048958,1813327133,2434376091,1,1,1,1192278175,In > Out
Sept 2020,123,131,3,216364846,259595346,475960192,2,3,3,43230500,In > Out
Sept 2020,123,133,8,838991711,964233004,1803224715,5,6,5,125241293,In > Out
Sept 2020,123,134,6,473608141,71980487,545588628,3,2,6,401627654,Out > In
Sept 2020,123,137,5,936301160,1397926026,2334227186,3,3,2,461624866,In > Out
Sept 2020,123,139,1,122344,184368,306712,1,1,1,62024,In > Out
Sept 2020,123,141,1,67257390,69183075,136440465,1,1,1,1925685,In > Out
Sept 2020,123,146,1,52467243,40960608,93427851,1,1,1,11506635,Out > In
Sept 2020,123,148,1,188200,182564,370764,1,1,1,5636,Out > In
Sept 2020,123,150,12,5833899802,5904578601,11738478403,9,8,4,70678799,In > Out
Sept 2020,123,151,3,3014715,93198099,96212814,1,1,3,90183384,In > Out
Sept 2020,123,153,2,2472538,37069597,39542135,2,2,2,34597059,In > Out
Sept 2020,123,157,1,123139885,123164410,246304295,1,1,1,24525,In > Out
Sept 2020,123,158,3,58866556,1529517213,1588383769,3,2,3,1470650657,In > Out
Sept 2020,123,16,3,123033295,148342368,271375663,3,3,3,25309073,In > Out
Sept 2020,123,164,9,462694218,366000956,828695174,9,9,7,96693262,Out > In
Sept 2020,123,169,1,50578148,58189158,108767306,1,1,1,7611010,In > Out
Sept 2020,123,170,1,54272,65616,119888,1,1,1,11344,In > Out
Sept 2020,123,177,1,183924181,208131902,392056083,1,1,1,24207721,In > Out
Sept 2020,123,183,3,2015416,243197452,245212868,3,1,3,241182036,In > Out
Sept 2020,123,189,3,6229520,244583708,250813228,2,1,3,238354188,In > Out
Sept 2020,123,204,1,62223083,70885245,133108328,1,1,1,8662162,In > Out
Sept 2020,123,216,2,3384959,219729143,223114102,1,1,2,216344184,In > Out
Sept 2020,123,217,1,831961401,864443962,1696405363,1,1,1,32482561,In > Out
Sept 2020,123,219,10,616562176,308891076,925453252,6,5,3,307671100,Out > In
Sept 2020,123,222,2,743582047,608161991,1351744038,2,2,2,135420056,Out > In
Sept 2020,123,223,2,92625994,150595229,243221223,2,2,2,57969235,In > Out
Sept 2020,123,23,1,3723181,125752143,129475324,1,1,1,122028962,In > Out
Sept 2020,123,28,5,510482105,352981371,863463476,4,3,2,157500734,Out > In
Sept 2020,123,33,1,2152917,1682620,3835537,1,1,1,470297,Out > In
Sept 2020,123,4,2,1570354,1827118,3397472,2,2,2,256764,In > Out
Sept 2020,123,45,4,17032295,397469415,414501710,2,1,4,380437120,In > Out
Sept 2020,123,53,3,331296,331197,662493,1,1,1,99,Out > In
Sept 2020,123,54,5,512511,1193601,1706112,5,5,2,681090,In > Out
Sept 2020,123,55,2,698211,187012910,187711121,2,1,2,186314699,In > Out
Sept 2020,123,58,1,48147222,52851338,100998560,1,1,1,4704116,In > Out
Sept 2020,123,61,2,1401349777,1254255409,2655605186,2,2,2,147094368,Out > In
Sept 2020,123,62,1,35322341,48138708,83461049,1,1,1,12816367,In > Out
Sept 2020,123,63,9,3640185347,3740668269,7380853616,2,8,3,100482922,In > Out
Sept 2020,123,74,4,102661398,1921529198,2024190596,4,2,4,1818867800,In > Out
Sept 2020,123,75,5,1509712917,1767214713,3276927630,2,4,1,257501796,In > Out
Sept 2020,123,77,1,63052,45864,108916,1,1,1,17188,Out > In
Sept 2020,123,87,1,100602,74800,175402,1,1,1,25802,Out > In
Sept 2020,123,89,1,837574006,1163490798,2001064804,1,1,1,325916792,In > Out
Sept 2020,123,92,5,109131873,263077637,372209510,2,2,4,153945764,In > Out
Sept 2020,123,93,1,104416635,65125002,169541637,1,1,1,39291633,Out > In
Sept 2020,123,96,1,13706908,15532581,29239489,1,1,1,1825673,In > Out
Sept 2020,123,98,9,343173799,466050294,809224093,6,6,3,122876495,In > Out
Sept 2020,123,99,1,155861,168243,324104,1,1,1,12382,In > Out
Sept 2020,124,100,2,83322842,70530704,153853546,2,2,2,12792138,Out > In
Sept 2020,124,105,3,7782704,229566698,237349402,1,1,3,221783994,In > Out
Sept 2020,124,106,2,57761010,87408916,145169926,1,1,1,29647906,In > Out
Sept 2020,124,108,2,2059278,2119679,4178957,2,2,2,60401,In > Out
Sept 2020,124,113,1,3335766898,843609011,4179375909,1,1,1,2492157887,Out > In
Sept 2020,124,116,1,793506,55075599,55869105,1,1,1,54282093,In > Out
Sept 2020,124,117,1,139588499,540231721,679820220,1,1,1,400643222,In > Out
Sept 2020,124,120,3,30015562,110886802,140902364,3,3,3,80871240,In > Out
Sept 2020,124,125,1,1765476170,808044149,2573520319,1,1,1,957432021,Out > In
Sept 2020,124,129,3,513847044,687728186,1201575230,3,3,2,173881142,In > Out
Sept 2020,124,131,1,1030221,5905936,6936157,1,1,1,4875715,In > Out
Sept 2020,124,132,1,170840,84136,254976,1,1,1,86704,Out > In
Sept 2020,124,133,1,196570,3978827,4175397,1,1,1,3782257,In > Out
Sept 2020,124,135,1,541708,22944091,23485799,1,1,1,22402383,In > Out
Sept 2020,124,136,1,32518640,8968056,41486696,1,1,1,23550584,Out > In
Sept 2020,124,140,2,704294181,709184102,1413478283,2,2,2,4889921,In > Out
Sept 2020,124,141,2,345591,851148,1196739,1,1,2,505557,In > Out
Sept 2020,124,142,1,54864,69360,124224,1,1,1,14496,In > Out
Sept 2020,124,144,3,16193158,144527686,160720844,2,2,3,128334528,In > Out
Sept 2020,124,147,8,767602070,736141796,1503743866,7,7,1,31460274,Out > In
Sept 2020,124,154,1,123823,1003871,1127694,1,1,1,880048,In > Out
Sept 2020,124,156,7,7529703,40278172,47807875,3,3,7,32748469,In > Out
Sept 2020,124,157,1,86148,83888,170036,1,1,1,2260,Out > In
Sept 2020,124,160,1,252124,476691,728815,1,1,1,224567,In > Out
Sept 2020,124,166,6,62147862,109620257,171768119,5,6,3,47472395,In > Out
Sept 2020,124,167,1,163482,95989,259471,1,1,1,67493,Out > In
Sept 2020,124,17,1,314905610,3849550469,4164456079,1,1,1,3534644859,In > Out
Sept 2020,124,170,1,204516,108741,313257,1,1,1,95775,Out > In
Sept 2020,124,171,2,215452842,209013668,424466510,2,2,1,6439174,Out > In
Sept 2020,124,172,6,43593676,421879084,465472760,5,4,6,378285408,In > Out
Sept 2020,124,177,3,35354336,34151674,69506010,1,2,2,1202662,Out > In
Sept 2020,124,182,1,5152186,248598867,253751053,1,1,1,243446681,In > Out
Sept 2020,124,183,4,36611959,672368544,708980503,4,3,4,635756585,In > Out
Sept 2020,124,185,14,329465905,603429074,932894979,6,7,9,273963169,In > Out
Sept 2020,124,186,1,1807095,50117628,51924723,1,1,1,48310533,In > Out
Sept 2020,124,188,1,113158528,121646237,234804765,1,1,1,8487709,In > Out
Sept 2020,124,189,2,772962,3813734,4586696,2,2,2,3040772,In > Out
Sept 2020,124,190,1,995811652,1142353673,2138165325,1,1,1,146542021,In > Out
Sept 2020,124,192,1,831261678,816152370,1647414048,1,1,1,15109308,Out > In
Sept 2020,124,193,4,1519862,78298897,79818759,1,1,4,76779035,In > Out
Sept 2020,124,200,2,13801376,16952874,30754250,2,1,2,3151498,In > Out
Sept 2020,124,201,2,28387416,148417400,176804816,2,2,2,120029984,In > Out
Sept 2020,124,203,1,424768,226833,651601,1,1,1,197935,Out > In
Sept 2020,124,205,1,29955350,30202369,60157719,1,1,1,247019,In > Out
Sept 2020,124,206,1,189020475,131448992,320469467,1,1,1,57571483,Out > In
Sept 2020,124,207,2,3791775,53959526,57751301,2,1,2,50167751,In > Out
Sept 2020,124,21,3,2768996411,2923988115,5692984526,3,3,1,154991704,In > Out
Sept 2020,124,212,8,25135394,10983495,36118889,8,8,6,14151899,Out > In
Sept 2020,124,214,2,504505259,510316632,1014821891,1,2,2,5811373,In > Out
Sept 2020,124,215,1,2670367,3314102,5984469,1,1,1,643735,In > Out
Sept 2020,124,216,3,2175139096,2210954293,4386093389,2,2,1,35815197,In > Out
Sept 2020,124,219,1,472167386,795245646,1267413032,1,1,1,323078260,In > Out
Sept 2020,124,22,4,1887796879,1885229205,3773026084,4,2,1,2567674,Out > In
Sept 2020,124,223,4,1347546,1546611,2894157,1,4,4,199065,In > Out
Sept 2020,124,23,2,18111385,18825526,36936911,1,2,2,714141,In > Out
Sept 2020,124,25,3,896598,599258,1495856,1,1,3,297340,Out > In
Sept 2020,124,27,3,405156,13073758,13478914,2,2,3,12668602,In > Out
Sept 2020,124,32,7,189797695,158839904,348637599,5,5,2,30957791,Out > In
Sept 2020,124,36,1,10815639,10745046,21560685,1,1,1,70593,Out > In
Sept 2020,124,37,1,307938,1659258,1967196,1,1,1,1351320,In > Out
Sept 2020,124,43,1,7047605,6869125,13916730,1,1,1,178480,Out > In
Sept 2020,124,44,3,5685077,4817083,10502160,3,3,2,867994,Out > In
Sept 2020,124,45,2,1924179,428585366,430509545,1,1,2,426661187,In > Out
Sept 2020,124,5,1,116849220,311383927,428233147,1,1,1,194534707,In > Out
Sept 2020,124,56,22,3453360,1450012,4903372,12,11,1,2003348,Out > In
Sept 2020,124,58,1,74988,124369,199357,1,1,1,49381,In > Out
Sept 2020,124,64,1,93615,108496,202111,1,1,1,14881,In > Out
Sept 2020,124,65,8,36278026,512871944,549149970,3,1,8,476593918,In > Out
Sept 2020,124,68,3,607527639,496060103,1103587742,3,2,2,111467536,Out > In
Sept 2020,124,69,4,100888844,165290957,266179801,3,2,4,64402113,In > Out
Sept 2020,124,71,1,71624,270918,342542,1,1,1,199294,In > Out
Sept 2020,124,78,5,2393828914,2863249311,5257078225,2,4,1,469420397,In > Out
Sept 2020,124,82,26,13543217,88533057,102076274,26,26,3,74989840,In > Out
Sept 2020,124,9,2,3539561,3145532,6685093,2,2,2,394029,Out > In
Sept 2020,124,96,7,734411466,938678445,1673089911,6,4,6,204266979,In > Out
Sept 2020,124,97,6,294343,2596022,2890365,2,2,6,2301679,In > Out
Sept 2020,125,43,1,132694,71691,204385,1,1,1,61003,Out > In
Sept 2020,126,25,182,66261722,2639866,68901588,1,181,1,63621856,Out > In
Sept 2020,127,111,2,3432468,155497173,158929641,1,1,2,152064705,In > Out
Sept 2020,127,114,1,2104925,8313136,10418061,1,1,1,6208211,In > Out
Sept 2020,127,117,2268,2259312174,1406348140,3665660314,187,2124,3,852964034,Out > In
Sept 2020,127,119,6,280742907,290411808,571154715,4,6,6,9668901,In > Out
Sept 2020,127,123,8,6045306317,6378926793,12424233110,5,7,2,333620476,In > Out
Sept 2020,127,124,13,30721194,50242093,80963287,4,11,2,19520899,In > Out
Sept 2020,127,126,2,206534245,135601765,342136010,1,2,2,70932480,Out > In
Sept 2020,127,129,1,344431923,335843054,680274977,1,1,1,8588869,Out > In
Sept 2020,127,133,1,2262334,2153616,4415950,1,1,1,108718,Out > In
Sept 2020,127,135,1,7341012,8208183,15549195,1,1,1,867171,In > Out
Sept 2020,127,139,30,259863410,23925167,283788577,30,30,1,235938243,Out > In
Sept 2020,127,142,2,454293946,482170546,936464492,2,2,1,27876600,In > Out
Sept 2020,127,151,1,12036224,1008897,13045121,1,1,1,11027327,Out > In
Sept 2020,127,158,1,39243086,43064645,82307731,1,1,1,3821559,In > Out
Sept 2020,127,159,1,413124,92747583,93160707,1,1,1,92334459,In > Out
Sept 2020,127,161,1,102083,1148479,1250562,1,1,1,1046396,In > Out
Sept 2020,127,17,3,5021070,323631600,328652670,1,1,3,318610530,In > Out
Sept 2020,127,174,2,993262,3675231,4668493,2,2,2,2681969,In > Out
Sept 2020,127,177,8,150242233,128821961,279064194,7,8,7,21420272,Out > In
Sept 2020,127,181,1,75844247,80950729,156794976,1,1,1,5106482,In > Out
Sept 2020,127,184,1,34364382,121747497,156111879,1,1,1,87383115,In > Out
Sept 2020,127,187,1,75277,187939630,188014907,1,1,1,187864353,In > Out
Sept 2020,127,188,2,849058485,887969875,1737028360,2,2,1,38911390,In > Out
Sept 2020,127,190,18,401058642,1456860216,1857918858,11,9,18,1055801574,In > Out
Sept 2020,127,196,2,142435698,129231504,271667202,1,2,2,13204194,Out > In
Sept 2020,127,197,4,4144073,2864679,7008752,1,4,4,1279394,Out > In
Sept 2020,127,198,4,619167234,1086311803,1705479037,3,3,4,467144569,In > Out
Sept 2020,127,205,1,126840,133850,260690,1,1,1,7010,In > Out
Sept 2020,127,206,3,1541020619,1100453265,2641473884,3,3,2,440567354,Out > In
Sept 2020,127,207,8,139986037,93082104,233068141,8,5,8,46903933,Out > In
Sept 2020,127,21,2,474799141,217457657,692256798,2,2,1,257341484,Out > In
Sept 2020,127,210,1,76045,42113,118158,1,1,1,33932,Out > In
Sept 2020,127,211,18,249619503,3354170768,3603790271,6,6,14,3104551265,In > Out
Sept 2020,127,214,16,1483392,52018928,53502320,12,12,1,50535536,In > Out
Sept 2020,127,215,1,42590540,50839547,93430087,1,1,1,8249007,In > Out
Sept 2020,127,216,5,4018251359,4078030651,8096282010,2,3,1,59779292,In > Out
Sept 2020,127,218,1,71886,664443,736329,1,1,1,592557,In > Out
Sept 2020,127,222,6,183711316,354667958,538379274,6,3,6,170956642,In > Out
Sept 2020,127,223,1,21043783,23323572,44367355,1,1,1,2279789,In > Out
Sept 2020,127,24,1,2233389878,2193865531,4427255409,1,1,1,39524347,Out > In
Sept 2020,127,28,4,387656837,459533394,847190231,2,2,4,71876557,In > Out
Sept 2020,127,31,1,411358,4280737,4692095,1,1,1,3869379,In > Out
Sept 2020,127,32,1,463218190,527426892,990645082,1,1,1,64208702,In > Out
Sept 2020,127,35,1,14522,90797,105319,1,1,1,76275,In > Out
Sept 2020,127,37,1,214031761,219032335,433064096,1,1,1,5000574,In > Out
Sept 2020,127,39,1,57290,81182,138472,1,1,1,23892,In > Out
Sept 2020,127,40,1,90789726,80874224,171663950,1,1,1,9915502,Out > In
Sept 2020,127,41,1,5517270,6059165,11576435,1,1,1,541895,In > Out
Sept 2020,127,48,4,19040670,232216318,251256988,2,1,4,213175648,In > Out
Sept 2020,127,5,1,32792270,30626663,63418933,1,1,1,2165607,Out > In
Sept 2020,127,50,1,614495,5729018,6343513,1,1,1,5114523,In > Out
Sept 2020,127,59,1,887156,1009328,1896484,1,1,1,122172,In > Out
Sept 2020,127,65,1,1926104177,1965550003,3891654180,1,1,1,39445826,In > Out
Sept 2020,127,66,3,70118381,62934823,133053204,3,3,3,7183558,Out > In
Sept 2020,127,7,2,371700070,128017427,499717497,2,2,1,243682643,Out > In
Sept 2020,127,74,3,42404398,69029382,111433780,2,1,3,26624984,In > Out
Sept 2020,127,76,2,940726696,974167472,1914894168,2,2,1,33440776,In > Out
Sept 2020,127,77,8,1582678948,1569304063,3151983011,3,3,2,13374885,Out > In
Sept 2020,127,80,7,2709451,29242868,31952319,6,4,7,26533417,In > Out
Sept 2020,127,82,2,12631894,13720142,26352036,1,1,2,1088248,In > Out
Sept 2020,127,84,1,216361596,180426542,396788138,1,1,1,35935054,Out > In
Sept 2020,127,90,1,160864870,181451243,342316113,1,1,1,20586373,In > Out
Sept 2020,127,94,4,14150652,137106220,151256872,2,2,4,122955568,In > Out
Sept 2020,127,99,13,4497710702,5166147004,9663857706,12,5,13,668436302,In > Out
Sept 2020,128,105,1,30977,426967,457944,1,1,1,395990,In > Out
Sept 2020,128,110,2,320645993,151832380,472478373,2,2,2,168813613,Out > In
Sept 2020,128,112,1,32120,158508,190628,1,1,1,126388,In > Out
Sept 2020,128,118,11,301189188,540973640,842162828,4,10,1,239784452,In > Out
Sept 2020,128,12,4,1159521872,1201972437,2361494309,3,3,4,42450565,In > Out
Sept 2020,128,120,7,48190571,89429935,137620506,4,6,7,41239364,In > Out
Sept 2020,128,121,1,128989,185096,314085,1,1,1,56107,In > Out
Sept 2020,128,124,7,35982915,18526280,54509195,6,7,1,17456635,Out > In
Sept 2020,128,125,6,26660509,60768480,87428989,4,2,6,34107971,In > Out
Sept 2020,128,127,3,889249804,909619473,1798869277,2,3,3,20369669,In > Out
Sept 2020,128,129,2,453435885,379075231,832511116,2,2,2,74360654,Out > In
Sept 2020,128,13,5,22271033,27778785,50049818,2,2,5,5507752,In > Out
Sept 2020,128,132,8,25902823,507160952,533063775,6,2,8,481258129,In > Out
Sept 2020,128,135,11,279058989,716814738,995873727,9,6,11,437755749,In > Out
Sept 2020,128,14,2,38827,816772,855599,2,1,2,777945,In > Out
Sept 2020,128,142,3,256284075,192030559,448314634,2,3,1,64253516,Out > In
Sept 2020,128,146,4,705586823,795698888,1501285711,4,4,4,90112065,In > Out
Sept 2020,128,149,2,342963268,7511401,350474669,2,2,2,335451867,Out > In
Sept 2020,128,151,2,1909244,6834537,8743781,2,1,2,4925293,In > Out
Sept 2020,128,152,5,10937680,519623977,530561657,5,4,5,508686297,In > Out
Sept 2020,128,153,1,1544700673,1664159555,3208860228,1,1,1,119458882,In > Out
Sept 2020,128,155,1,63958726,314326788,378285514,1,1,1,250368062,In > Out
Sept 2020,128,156,6,688406956,452089261,1140496217,5,4,6,236317695,Out > In
Sept 2020,128,157,1,5182578,475795355,480977933,1,1,1,470612777,In > Out
Sept 2020,128,178,1,840609902,650997023,1491606925,1,1,1,189612879,Out > In
Sept 2020,128,18,1,817038,13140636,13957674,1,1,1,12323598,In > Out
Sept 2020,128,182,4,86483587,83158817,169642404,4,4,3,3324770,Out > In
Sept 2020,128,186,2,2184598,216327982,218512580,2,1,2,214143384,In > Out
Sept 2020,128,19,1,14752708,44435375,59188083,1,1,1,29682667,In > Out
Sept 2020,128,191,4,21510703,153496388,175007091,3,3,4,131985685,In > Out
Sept 2020,128,194,11,2269722391,1591060596,3860782987,5,6,1,678661795,Out > In
Sept 2020,128,195,2,15683063,87428350,103111413,2,2,2,71745287,In > Out
Sept 2020,128,197,4,122430784,978318086,1100748870,2,1,4,855887302,In > Out
Sept 2020,128,202,4,124494988,139349989,263844977,3,3,4,14855001,In > Out
Sept 2020,128,206,1,84129,175238,259367,1,1,1,91109,In > Out
Sept 2020,128,21,1,2756369,5581598,8337967,1,1,1,2825229,In > Out
Sept 2020,128,210,2,25740,23403238,23428978,1,1,2,23377498,In > Out
Sept 2020,128,211,3,72534330,107127163,179661493,2,2,1,34592833,In > Out
Sept 2020,128,215,5,97945027,128676803,226621830,2,4,5,30731776,In > Out
Sept 2020,128,216,4,6184357921,6780026869,12964384790,4,4,2,595668948,In > Out
Sept 2020,128,219,1,121766,147127809,147249575,1,1,1,147006043,In > Out
Sept 2020,128,220,2,220638752,270398814,491037566,2,2,2,49760062,In > Out
Sept 2020,128,223,2,301013268,341720163,642733431,2,1,2,40706895,In > Out
Sept 2020,128,27,60,4768962,170356863,175125825,60,59,9,165587901,In > Out
Sept 2020,128,31,4,94847041,133645649,228492690,3,2,4,38798608,In > Out
Sept 2020,128,36,1,124380082,2551382279,2675762361,1,1,1,2427002197,In > Out
Sept 2020,128,37,3,67423396,882805634,950229030,2,2,3,815382238,In > Out
Sept 2020,128,38,1,1609375,10565789,12175164,1,1,1,8956414,In > Out
Sept 2020,128,4,10,1594678740,1562965704,3157644444,5,9,8,31713036,Out > In
Sept 2020,128,45,1,53712,57449466,57503178,1,1,1,57395754,In > Out
Sept 2020,128,54,1,397677041,437808343,835485384,1,1,1,40131302,In > Out
Sept 2020,128,60,6,438947665,545481706,984429371,3,4,6,106534041,In > Out
Sept 2020,128,65,3,1682568,51805986,53488554,1,1,3,50123418,In > Out
Sept 2020,128,69,8,5510607979,7197988599,12708596578,7,3,4,1687380620,In > Out
Sept 2020,128,70,1,83778,49758,133536,1,1,1,34020,Out > In
Sept 2020,128,76,3,1889702686,1884988125,3774690811,2,2,1,4714561,Out > In
Sept 2020,128,77,1,3683801,118878488,122562289,1,1,1,115194687,In > Out
Sept 2020,128,79,4,331507572,936037280,1267544852,2,2,4,604529708,In > Out
Sept 2020,128,8,3,12956738,14294537,27251275,3,3,1,1337799,In > Out
Sept 2020,128,80,6,6471679620,6519925729,12991605349,5,6,5,48246109,In > Out
Sept 2020,128,84,1,213,473523,473736,1,1,1,473310,In > Out
Sept 2020,128,87,15,5118657454,5610093109,10728750563,5,5,2,491435655,In > Out
Sept 2020,128,96,8,330768478,356139188,686907666,5,6,5,25370710,In > Out
Sept 2020,129,10,7,1059900,38084,1097984,2,7,1,1021816,Out > In
Sept 2020,129,134,2,6031562,6571252,12602814,1,2,2,539690,In > Out
Sept 2020,129,160,1825,320819098,16897854,337716952,314,1773,1,303921244,Out > In
Sept 2020,129,186,1,230,230065,230295,1,1,1,229835,In > Out
Sept 2020,129,189,77,14121573,422256,14543829,53,77,2,13699317,Out > In
Sept 2020,129,218,1,158381,7644,166025,1,1,1,150737,Out > In
Sept 2020,129,229,1,2777144,2764552,5541696,1,1,1,12592,Out > In
Sept 2020,129,230,400,460037721,37696541,497734262,238,76,1,422341180,Out > In
Sept 2020,129,242,15,3282351,1277925,4560276,5,2,1,2004426,Out > In
Sept 2020,129,243,2,8943575,3958632,12902207,1,1,1,4984943,Out > In
Sept 2020,129,31,5,847583,9456,857039,4,5,1,838127,Out > In
Sept 2020,129,51,21,5147996,1818693,6966689,8,7,1,3329303,Out > In
Sept 2020,129,52,4,1017882,387538,1405420,2,4,1,630344,Out > In
Sept 2020,129,80,1,207979,132402,340381,1,1,1,75577,Out > In
Sept 2020,129,97,83,50354469,1710953349,1761307818,83,58,1,1660598880,In > Out
Sept 2020,130,107,3,151206,1353320,1504526,3,1,3,1202114,In > Out
Sept 2020,130,58,1,5393368,651188696,656582064,1,1,1,645795328,In > Out
Sept 2020,130,63,1,65113,91048,156161,1,1,1,25935,In > Out
Sept 2020,130,79,2,130697165,246092447,376789612,2,2,2,115395282,In > Out
Sept 2020,131,100,1,2492586,1737900,4230486,1,1,1,754686,Out > In
Sept 2020,131,102,1,132292205,126446481,258738686,1,1,1,5845724,Out > In
Sept 2020,131,105,5,970502344,945922244,1916424588,5,3,2,24580100,Out > In
Sept 2020,131,108,4,147853665,106609691,254463356,4,4,3,41243974,Out > In
Sept 2020,131,110,2,984256272,976174379,1960430651,2,2,2,8081893,Out > In
Sept 2020,131,113,1,45768791,45731211,91500002,1,1,1,37580,Out > In
Sept 2020,131,114,3,83612844,116990362,200603206,1,1,3,33377518,In > Out
Sept 2020,131,12,2,287272450,146119761,433392211,2,2,1,141152689,Out > In
Sept 2020,131,124,3,1858295154,848350931,2706646085,3,3,2,1009944223,Out > In
Sept 2020,131,125,742,1109200612,2153392364,3262592976,587,569,1,1044191752,In > Out
Sept 2020,131,128,3,723066193,781990905,1505057098,3,3,2,58924712,In > Out
Sept 2020,131,130,3,58445548,662071022,720516570,3,1,3,603625474,In > Out
Sept 2020,131,136,1,1018408389,919146327,1937554716,1,1,1,99262062,Out > In
Sept 2020,131,138,3,886461,546543,1433004,3,2,2,339918,Out > In
Sept 2020,131,139,1,1304551,1227950,2532501,1,1,1,76601,Out > In
Sept 2020,131,140,3,17209681,517058703,534268384,1,1,3,499849022,In > Out
Sept 2020,131,142,2,159038233,180618257,339656490,2,2,2,21580024,In > Out
Sept 2020,131,150,7,427911250,403884918,831796168,1,7,4,24026332,Out > In
Sept 2020,131,152,6,5164794,62793640,67958434,4,2,6,57628846,In > Out
Sept 2020,131,154,1,197437976,211940511,409378487,1,1,1,14502535,In > Out
Sept 2020,131,163,2,4644393,199104449,203748842,1,1,2,194460056,In > Out
Sept 2020,131,167,1,35463473,67639758,103103231,1,1,1,32176285,In > Out
Sept 2020,131,171,1,1385507,4556,1390063,1,1,1,1380951,Out > In
Sept 2020,131,172,5,9160171,10611375,19771546,3,5,5,1451204,In > Out
Sept 2020,131,175,2,63928169,157941863,221870032,1,1,2,94013694,In > Out
Sept 2020,131,178,1,66045557,86687919,152733476,1,1,1,20642362,In > Out
Sept 2020,131,179,1,269920141,281970503,551890644,1,1,1,12050362,In > Out
Sept 2020,131,18,4,50256,1796112,1846368,4,4,1,1745856,In > Out
Sept 2020,131,184,1,2791378450,2783604332,5574982782,1,1,1,7774118,Out > In
Sept 2020,131,185,1,6224415,8640800,14865215,1,1,1,2416385,In > Out
Sept 2020,131,188,1,200865329,13056538,213921867,1,1,1,187808791,Out > In
Sept 2020,131,189,1,1875243,40926557,42801800,1,1,1,39051314,In > Out
Sept 2020,131,196,63,264560448,100857778,365418226,27,63,61,163702670,Out > In
Sept 2020,131,197,16,182653015,186407876,369060891,6,2,16,3754861,In > Out
Sept 2020,131,199,1,8141086586,7521059552,15662146138,1,1,1,620027034,Out > In
Sept 2020,131,20,1,247457285,236802361,484259646,1,1,1,10654924,Out > In
Sept 2020,131,205,1,239133482,75574188,314707670,1,1,1,163559294,Out > In
Sept 2020,131,208,1,1699846,8249643,9949489,1,1,1,6549797,In > Out
Sept 2020,131,21,5,10296145,385989030,396285175,2,1,5,375692885,In > Out
Sept 2020,131,214,6,134598219,166936120,301534339,4,5,6,32337901,In > Out
Sept 2020,131,218,2,193144523,143301987,336446510,2,2,1,49842536,Out > In
Sept 2020,131,219,1,85836,143264,229100,1,1,1,57428,In > Out
Sept 2020,131,220,8,538082699,1017183058,1555265757,5,2,8,479100359,In > Out
Sept 2020,131,222,1,951514,1850755,2802269,1,1,1,899241,In > Out
Sept 2020,131,24,2,8901376,15897011,24798387,2,2,2,6995635,In > Out
Sept 2020,131,28,3,673318066,530488610,1203806676,2,2,1,142829456,Out > In
Sept 2020,131,29,1,96432,39928,136360,1,1,1,56504,Out > In
Sept 2020,131,33,4,11118156,2008523139,2019641295,1,4,4,1997404983,In > Out
Sept 2020,131,34,1,24817922,11175381,35993303,1,1,1,13642541,Out > In
Sept 2020,131,35,20,2208808173,2331237437,4540045610,7,11,8,122429264,In > Out
Sept 2020,131,36,2,1931012,185576987,187507999,1,1,2,183645975,In > Out
Sept 2020,131,42,2,75571258,96627648,172198906,1,1,2,21056390,In > Out
Sept 2020,131,46,1,71269624,184039306,255308930,1,1,1,112769682,In > Out
Sept 2020,131,49,875,3209121948,6646629332,9855751280,343,416,50,3437507384,In > Out
Sept 2020,131,54,4,1192227656,277845398,1470073054,2,4,4,914382258,Out > In
Sept 2020,131,55,7,85215918,140841249,226057167,4,6,7,55625331,In > Out
Sept 2020,131,61,1,45820,173712,219532,1,1,1,127892,In > Out
Sept 2020,131,67,6,10505605888,13556674511,24062280399,6,6,6,3051068623,In > Out
Sept 2020,131,72,4,23253966,362820438,386074404,4,4,4,339566472,In > Out
Sept 2020,131,74,27,3720434723,4060646048,7781080771,15,26,21,340211325,In > Out
Sept 2020,131,85,4,470470908,513929665,984400573,4,4,1,43458757,In > Out
Sept 2020,131,87,2,44783704,43965649,88749353,2,2,2,818055,Out > In
Sept 2020,131,98,1,2123565,2551875,4675440,1,1,1,428310,In > Out
Sept 2020,132,10,3,1053502,235182781,236236283,1,1,3,234129279,In > Out
Sept 2020,132,105,1657,1500560116,565068557,2065628673,301,458,9,935491559,Out > In
Sept 2020,132,108,1,87513,98725,186238,1,1,1,11212,In > Out
Sept 2020,132,117,3,221927025,199871232,421798257,2,3,3,22055793,Out > In
Sept 2020,132,118,2,80206140,62863699,143069839,1,2,2,17342441,Out > In
Sept 2020,132,12,1,94152,88817,182969,1,1,1,5335,Out > In
Sept 2020,132,120,6,13499126,75251190,88750316,4,3,5,61752064,In > Out
Sept 2020,132,122,1,10096149,10538607,20634756,1,1,1,442458,In > Out
Sept 2020,132,127,1,59447,55796,115243,1,1,1,3651,Out > In
Sept 2020,132,129,1,2538838,2059823,4598661,1,1,1,479015,Out > In
Sept 2020,132,132,2,165090326,122970874,288061200,1,2,2,42119452,Out > In
Sept 2020,132,135,2,27184556,19847853,47032409,1,1,1,7336703,Out > In
Sept 2020,132,137,9,4870772775,2116716444,6987489219,6,7,1,2754056331,Out > In
Sept 2020,132,139,8,101212514,367685507,468898021,7,7,8,266472993,In > Out
Sept 2020,132,14,3,1694452,1673028,3367480,1,3,3,21424,Out > In
Sept 2020,132,143,3,2838459,8269467,11107926,3,3,1,5431008,In > Out
Sept 2020,132,150,3,5259012,207105824,212364836,2,1,3,201846812,In > Out
Sept 2020,132,155,1,2696672537,2012755134,4709427671,1,1,1,683917403,Out > In
Sept 2020,132,158,2,1795795,1626998,3422793,2,2,2,168797,Out > In
Sept 2020,132,166,1,298972883,295182191,594155074,1,1,1,3790692,Out > In
Sept 2020,132,169,1,176355,259235,435590,1,1,1,82880,In > Out
Sept 2020,132,171,3,1117398640,828280661,1945679301,3,3,3,289117979,Out > In
Sept 2020,132,173,2,2364264,22902609,25266873,2,2,2,20538345,In > Out
Sept 2020,132,174,1,2109954,5738958,7848912,1,1,1,3629004,In > Out
Sept 2020,132,175,1,29469958,49558433,79028391,1,1,1,20088475,In > Out
Sept 2020,132,178,1,2245045354,5794621653,8039667007,1,1,1,3549576299,In > Out
Sept 2020,132,18,1,6232656,176189,6408845,1,1,1,6056467,Out > In
Sept 2020,132,181,6,75619541,3413464,79033005,2,6,2,72206077,Out > In
Sept 2020,132,183,1,4115189,7204516,11319705,1,1,1,3089327,In > Out
Sept 2020,132,186,1,76299,354820,431119,1,1,1,278521,In > Out
Sept 2020,132,190,6,135198158,1534473019,1669671177,6,5,6,1399274861,In > Out
Sept 2020,132,191,1,97965575,1035125632,1133091207,1,1,1,937160057,In > Out
Sept 2020,132,193,1,13590,430578,444168,1,1,1,416988,In > Out
Sept 2020,132,197,2,114632487,94105041,208737528,2,2,2,20527446,Out > In
Sept 2020,132,20,1,2585510,49024172,51609682,1,1,1,46438662,In > Out
Sept 2020,132,202,1,105072,389760,494832,1,1,1,284688,In > Out
Sept 2020,132,203,1,299385950,283589798,582975748,1,1,1,15796152,Out > In
Sept 2020,132,204,1,6056144,311561036,317617180,1,1,1,305504892,In > Out
Sept 2020,132,206,4,32129995,114084787,146214782,2,2,4,81954792,In > Out
Sept 2020,132,219,4,34439849,391581306,426021155,3,2,4,357141457,In > Out
Sept 2020,132,223,2,16880367,15085831,31966198,1,1,2,1794536,Out > In
Sept 2020,132,23,2,2149445,1830144,3979589,2,2,2,319301,Out > In
Sept 2020,132,25,1,1507279,30579843,32087122,1,1,1,29072564,In > Out
Sept 2020,132,27,1,22984583,127307338,150291921,1,1,1,104322755,In > Out
Sept 2020,132,30,1,102581,3461,106042,1,1,1,99120,Out > In
Sept 2020,132,31,1,518073,6544649,7062722,1,1,1,6026576,In > Out
Sept 2020,132,34,3,60375711,114350516,174726227,3,3,3,53974805,In > Out
Sept 2020,132,35,5,16700047,88861698,105561745,3,3,5,72161651,In > Out
Sept 2020,132,36,1,5694120,9858753,15552873,1,1,1,4164633,In > Out
Sept 2020,132,4,2,92123,435246,527369,2,1,2,343123,In > Out
Sept 2020,132,40,1,438832938,688487050,1127319988,1,1,1,249654112,In > Out
Sept 2020,132,44,2,11621343,9172698,20794041,2,2,2,2448645,Out > In
Sept 2020,132,48,2,3871773883,1303468278,5175242161,2,2,2,2568305605,Out > In
Sept 2020,132,5,1,327347701,330923992,658271693,1,1,1,3576291,In > Out
Sept 2020,132,50,3,238894543,291290479,530185022,3,3,3,52395936,In > Out
Sept 2020,132,51,1,1421445,421867,1843312,1,1,1,999578,Out > In
Sept 2020,132,54,1,48769,415082,463851,1,1,1,366313,In > Out
Sept 2020,132,57,4,448809654,640306308,1089115962,3,2,4,191496654,In > Out
Sept 2020,132,61,1,138837,161375,300212,1,1,1,22538,In > Out
Sept 2020,132,62,3,1128220608,1102582340,2230802948,3,2,1,25638268,Out > In
Sept 2020,132,63,1,296546,33353938,33650484,1,1,1,33057392,In > Out
Sept 2020,132,66,2,537046974,3187265938,3724312912,1,1,2,2650218964,In > Out
Sept 2020,132,70,2,557065191,1275699900,1832765091,2,2,2,718634709,In > Out
Sept 2020,132,71,1,339199515,318254659,657454174,1,1,1,20944856,Out > In
Sept 2020,132,75,2,181239,774919,956158,2,1,2,593680,In > Out
Sept 2020,132,78,3,233222,675055,908277,3,2,3,441833,In > Out
Sept 2020,132,79,1,17330550,77008381,94338931,1,1,1,59677831,In > Out
Sept 2020,132,80,4,52748707,173723995,226472702,2,1,4,120975288,In > Out
Sept 2020,132,83,1,7693065,7779644,15472709,1,1,1,86579,In > Out
Sept 2020,132,88,1,36199930,12653023,48852953,1,1,1,23546907,Out > In
Sept 2020,132,9,1,8533861,5186721,13720582,1,1,1,3347140,Out > In
Sept 2020,132,93,4,614966312,1147061784,1762028096,3,3,1,532095472,In > Out
Sept 2020,132,97,1,98065,99961,198026,1,1,1,1896,In > Out
Sept 2020,133,100,3,781608462,1301280460,2082888922,3,3,2,519671998,In > Out
Sept 2020,133,106,1,925770,16459664,17385434,1,1,1,15533894,In > Out
Sept 2020,133,107,1,215,226791,227006,1,1,1,226576,In > Out
Sept 2020,133,11,5,704200788,681588139,1385788927,3,5,5,22612649,Out > In
Sept 2020,133,114,1,39537,236424,275961,1,1,1,196887,In > Out
Sept 2020,133,119,3,536052227,399552258,935604485,3,2,1,136499969,Out > In
Sept 2020,133,120,1,5274635,34339179,39613814,1,1,1,29064544,In > Out
Sept 2020,133,121,1,5162636,59716746,64879382,1,1,1,54554110,In > Out
Sept 2020,133,123,2,4565126831,888944949,5454071780,1,2,2,3676181882,Out > In
Sept 2020,133,125,1,148779180,65586037,214365217,1,1,1,83193143,Out > In
Sept 2020,133,126,5,2875676,59697497,62573173,2,2,5,56821821,In > Out
Sept 2020,133,129,11,213621019,674972725,888593744,9,7,10,461351706,In > Out
Sept 2020,133,131,9,814790022,1788986201,2603776223,6,2,9,974196179,In > Out
Sept 2020,133,132,207,70392796,70473163,140865959,61,67,2,80367,In > Out
Sept 2020,133,135,8,5036281,95512868,100549149,7,3,8,90476587,In > Out
Sept 2020,133,139,4,247302980,775935681,1023238661,3,3,3,528632701,In > Out
Sept 2020,133,142,373,859694200,4241518624,5101212824,310,346,7,3381824424,In > Out
Sept 2020,133,149,10,977512578,417233977,1394746555,10,10,3,560278601,Out > In
Sept 2020,133,150,7,239014183,229635076,468649259,6,7,7,9379107,Out > In
Sept 2020,133,157,3,2214857560,259919005,2474776565,2,3,3,1954938555,Out > In
Sept 2020,133,159,5,45765700,53365567,99131267,5,5,2,7599867,In > Out
Sept 2020,133,164,3,2607076,55468790,58075866,3,2,3,52861714,In > Out
Sept 2020,133,168,2,176871969,221859128,398731097,2,2,1,44987159,In > Out
Sept 2020,133,171,8,103223420,96136052,199359472,7,8,8,7087368,Out > In
Sept 2020,133,172,3,10737779,359682475,370420254,2,2,3,348944696,In > Out
Sept 2020,133,177,1,295572795,171692783,467265578,1,1,1,123880012,Out > In
Sept 2020,133,179,4,135247016,134946918,270193934,3,4,4,300098,Out > In
Sept 2020,133,183,3,61255820,374974585,436230405,3,2,3,313718765,In > Out
Sept 2020,133,189,3,3044192,35512702,38556894,2,1,3,32468510,In > Out
Sept 2020,133,193,9,893911241,769340763,1663252004,6,7,2,124570478,Out > In
Sept 2020,133,194,3,20868240,165728763,186597003,3,3,3,144860523,In > Out
Sept 2020,133,198,1,9192972,11531638,20724610,1,1,1,2338666,In > Out
Sept 2020,133,203,4,2413938260,4929579947,7343518207,4,3,1,2515641687,In > Out
Sept 2020,133,204,4,4389312,156432211,160821523,3,3,4,152042899,In > Out
Sept 2020,133,21,3,62228590,49445944,111674534,2,3,3,12782646,Out > In
Sept 2020,133,213,1,70109337,79652645,149761982,1,1,1,9543308,In > Out
Sept 2020,133,218,3,541867,122286997,122828864,2,2,3,121745130,In > Out
Sept 2020,133,220,4,29383412,169594242,198977654,3,2,4,140210830,In > Out
Sept 2020,133,221,1,1493829,1543905,3037734,1,1,1,50076,In > Out
Sept 2020,133,223,1,15499,19335214,19350713,1,1,1,19319715,In > Out
Sept 2020,133,27,2,2210440330,1099621094,3310061424,2,2,2,1110819236,Out > In
Sept 2020,133,28,1,212505540,268558913,481064453,1,1,1,56053373,In > Out
Sept 2020,133,30,9,34313275,127024210,161337485,6,3,8,92710935,In > Out
Sept 2020,133,31,3,10614015,219488334,230102349,3,2,3,208874319,In > Out
Sept 2020,133,33,1,85485,368018,453503,1,1,1,282533,In > Out
Sept 2020,133,36,2,452098326,306309838,758408164,2,2,2,145788488,Out > In
Sept 2020,133,37,1,156839,77391,234230,1,1,1,79448,Out > In
Sept 2020,133,4,1,11635200,14861781,26496981,1,1,1,3226581,In > Out
Sept 2020,133,46,25,1063386237,1069548927,2132935164,11,23,14,6162690,In > Out
Sept 2020,133,54,3,228544311,50208892,278753203,2,3,1,178335419,Out > In
Sept 2020,133,56,1,41286,71529,112815,1,1,1,30243,In > Out
Sept 2020,133,57,1,116128,167207431,167323559,1,1,1,167091303,In > Out
Sept 2020,133,59,7,13012945,240837983,253850928,5,3,7,227825038,In > Out
Sept 2020,133,62,1,102633,2895,105528,1,1,1,99738,Out > In
Sept 2020,133,63,88,246814663,325719155,572533818,86,86,8,78904492,In > Out
Sept 2020,133,65,1,6756531,7308866,14065397,1,1,1,552335,In > Out
Sept 2020,133,69,5,144899773,286163047,431062820,4,1,5,141263274,In > Out
Sept 2020,133,70,2,25407949,23128249,48536198,2,2,2,2279700,Out > In
Sept 2020,133,74,3,5506414,253561592,259068006,1,1,3,248055178,In > Out
Sept 2020,133,81,3,44546532,54976866,99523398,3,3,3,10430334,In > Out
Sept 2020,133,86,1,48923,70002412,70051335,1,1,1,69953489,In > Out
Sept 2020,133,93,3,19331163,12357582,31688745,2,2,1,6973581,Out > In
Sept 2020,133,95,6,2208174423,3076175758,5284350181,4,4,3,868001335,In > Out
Sept 2020,134,103,2,326906,14382040,14708946,1,1,2,14055134,In > Out
Sept 2020,134,113,1,409927,826481,1236408,1,1,1,416554,In > Out
Sept 2020,134,116,4,3128704,187178738,190307442,3,3,4,184050034,In > Out
Sept 2020,134,12,2,592726068,682051687,1274777755,1,1,1,89325619,In > Out
Sept 2020,134,123,5,12942306,46428761,59371067,4,5,3,33486455,In > Out
Sept 2020,134,125,1,23106252,488008,23594260,1,1,1,22618244,Out > In
Sept 2020,134,126,7,107350728,252042766,359393494,5,6,7,144692038,In > Out
Sept 2020,134,128,2,448113526,839937350,1288050876,2,2,2,391823824,In > Out
Sept 2020,134,130,2,69041675,75994922,145036597,1,2,2,6953247,In > Out
Sept 2020,134,131,2,8982292,34217092,43199384,2,2,2,25234800,In > Out
Sept 2020,134,135,1,227857,119909,347766,1,1,1,107948,Out > In
Sept 2020,134,141,2,207453314,53418170,260871484,2,2,1,154035144,Out > In
Sept 2020,134,142,4,4816256,252672399,257488655,3,2,4,247856143,In > Out
Sept 2020,134,143,2,4288439,5894122,10182561,2,2,2,1605683,In > Out
Sept 2020,134,144,2,899933,830845,1730778,1,2,2,69088,Out > In
Sept 2020,134,150,2,2358403246,2460658559,4819061805,2,2,1,102255313,In > Out
Sept 2020,134,153,2,50278965,369521015,419799980,1,2,2,319242050,In > Out
Sept 2020,134,156,6,702309749,686116479,1388426228,3,6,6,16193270,Out > In
Sept 2020,134,158,3,1345193488,1243131065,2588324553,3,2,1,102062423,Out > In
Sept 2020,134,167,1,55382,70473031,70528413,1,1,1,70417649,In > Out
Sept 2020,134,174,1,335772,36281028,36616800,1,1,1,35945256,In > Out
Sept 2020,134,175,1,28864,201798,230662,1,1,1,172934,In > Out
Sept 2020,134,181,5,527734147,188942105,716676252,3,4,2,338792042,Out > In
Sept 2020,134,185,1,82023,45169,127192,1,1,1,36854,Out > In
Sept 2020,134,187,1,590406269,584592348,1174998617,1,1,1,5813921,Out > In
Sept 2020,134,188,7,328528789,281650751,610179540,2,7,1,46878038,Out > In
Sept 2020,134,190,4,850702733,279596103,1130298836,3,4,3,571106630,Out > In
Sept 2020,134,192,2,1798886,140471467,142270353,1,1,2,138672581,In > Out
Sept 2020,134,198,1,145944256,292398900,438343156,1,1,1,146454644,In > Out
Sept 2020,134,201,2,18825891,24402270,43228161,2,2,2,5576379,In > Out
Sept 2020,134,205,1,46986,109280132,109327118,1,1,1,109233146,In > Out
Sept 2020,134,209,1,88560,38288,126848,1,1,1,50272,Out > In
Sept 2020,134,220,4,401836070,409332321,811168391,2,3,1,7496251,In > Out
Sept 2020,134,223,5,4288558661,5110408343,9398967004,3,4,5,821849682,In > Out
Sept 2020,134,24,3,8080990,233104635,241185625,2,1,3,225023645,In > Out
Sept 2020,134,28,15,204312287,228435799,432748086,14,15,4,24123512,In > Out
Sept 2020,134,32,2,43925889,110142097,154067986,1,1,2,66216208,In > Out
Sept 2020,134,33,1,106379886,214259361,320639247,1,1,1,107879475,In > Out
Sept 2020,134,38,2,8559147,7958050,16517197,2,2,1,601097,Out > In
Sept 2020,134,39,1,126470429,158771690,285242119,1,1,1,32301261,In > Out
Sept 2020,134,43,3,4657587,14758145,19415732,2,3,3,10100558,In > Out
Sept 2020,134,47,66,103890666,11926673,115817339,22,25,6,91963993,Out > In
Sept 2020,134,48,2,25278497,27637495,52915992,1,1,2,2358998,In > Out
Sept 2020,134,5,3,39931953,25190560,65122513,2,2,3,14741393,Out > In
Sept 2020,134,53,1,61704,84482,146186,1,1,1,22778,In > Out
Sept 2020,134,54,11,46949406,73024848,119974254,3,3,11,26075442,In > Out
Sept 2020,134,61,1,58678748,79423831,138102579,1,1,1,20745083,In > Out
Sept 2020,134,63,1,89947,50022,139969,1,1,1,39925,Out > In
Sept 2020,134,64,1,56057,27111091,27167148,1,1,1,27055034,In > Out
Sept 2020,134,67,1,164062927,170585235,334648162,1,1,1,6522308,In > Out
Sept 2020,134,71,23,8117022,798788761,806905783,21,19,3,790671739,In > Out
Sept 2020,134,74,1,1874267,10171688,12045955,1,1,1,8297421,In > Out
Sept 2020,134,75,5,283552685,356063340,639616025,5,5,3,72510655,In > Out
Sept 2020,134,76,1,135260,27956071,28091331,1,1,1,27820811,In > Out
Sept 2020,134,88,1,11716520,8266770,19983290,1,1,1,3449750,Out > In
Sept 2020,134,90,8,139818029,555599432,695417461,3,2,8,415781403,In > Out
Sept 2020,134,95,5,4898263,224488383,229386646,3,2,5,219590120,In > Out
Sept 2020,134,98,7,41392302,202491727,243884029,3,2,7,161099425,In > Out
Sept 2020,14,12,20,32306775,4902190,37208965,3,20,3,27404585,Out > In
Sept 2020,14,16,1,117560,16584,134144,1,1,1,100976,Out > In
Sept 2020,141,131,4,57220268,240611699,297831967,2,1,4,183391431,In > Out
Sept 2020,142,10,4,1253251,8710,1261961,2,4,1,1244541,Out > In
Sept 2020,142,101,60,8016102,2570985,10587087,3,60,2,5445117,Out > In
Sept 2020,142,104,2,4809222,51392,4860614,1,2,1,4757830,Out > In
Sept 2020,142,105,6,754864,24677,779541,4,6,1,730187,Out > In
Sept 2020,142,106,39,7392174,347566,7739740,2,39,1,7044608,Out > In
Sept 2020,142,11,5774,813624528,33576154,847200682,11,4709,1,780048374,Out > In
Sept 2020,142,121,4,1226733,162288,1389021,4,4,1,1064445,Out > In
Sept 2020,142,14,5,62296,8778775,8841071,1,5,5,8716479,In > Out
Sept 2020,142,16,73,14586482,391538,14978020,21,73,1,14194944,Out > In
Sept 2020,142,17,1069,3628653,123078900,126707553,17,1048,3,119450247,In > Out
Sept 2020,142,18,90,46424560,1201483,47626043,21,90,2,45223077,Out > In
Sept 2020,142,19,52,29553405,725920,30279325,16,52,1,28827485,Out > In
Sept 2020,142,22,673081,505447446693,7081351523,512528798216,2989,56630,2,498366095170,Out > In
Sept 2020,142,24,22,17738315,417770,18156085,15,22,2,17320545,Out > In
Sept 2020,142,27,2,510134,193413,703547,1,2,1,316721,Out > In
Sept 2020,142,30,3,751507,233427,984934,1,3,1,518080,Out > In
Sept 2020,142,33,10,5064392,43938,5108330,5,10,2,5020454,Out > In
Sept 2020,142,35,282,266562939,5542427,272105366,83,282,2,261020512,Out > In
Sept 2020,142,36,1448,537108817,44510603,581619420,81,1402,1145,492598214,Out > In
Sept 2020,142,38,1,302576,3824,306400,1,1,1,298752,Out > In
Sept 2020,142,43,5744,782740228,21174971,803915199,433,5293,1,761565257,Out > In
Sept 2020,142,46,123,61139755,1289963,62429718,39,122,1,59849792,Out > In
Sept 2020,142,48,2,402510,15538,418048,2,2,1,386972,Out > In
Sept 2020,142,49,13,2912641,37405,2950046,6,13,1,2875236,Out > In
Sept 2020,142,50,1,2034345531,115509717954,117544063485,1,1,1,113475372423,In > Out
Sept 2020,142,53,414,559260635,8283064,567543699,118,412,1,550977571,Out > In
Sept 2020,142,54,365191,1241308821869,11179814310,1252488636179,1247,16820,372,1230129007559,Out > In
Sept 2020,142,55,2,276065,180366,456431,1,2,1,95699,Out > In
Sept 2020,142,56,13968,42761926542,391831078,43153757620,92,8959,11016,42370095464,Out > In
Sept 2020,142,57,5548,22610843457,257639854,22868483311,108,5068,784,22353203603,Out > In
Sept 2020,142,58,16155,29841936923,349364496,30191301419,104,11142,10404,29492572427,Out > In
Sept 2020,142,59,13735,50445598515,467810778,50913409293,86,9219,9299,49977787737,Out > In
Sept 2020,142,61,4,646080,366963,1013043,2,4,1,279117,Out > In
Sept 2020,142,63,14,11059972,718921,11778893,5,14,2,10341051,Out > In
Sept 2020,142,66,1106,564365718,12148179,576513897,13,1093,1,552217539,Out > In
Sept 2020,142,68,5,33275,931505,964780,3,1,5,898230,In > Out
Sept 2020,142,69,1,34153,1550654,1584807,1,1,1,1516501,In > Out
Sept 2020,142,70,129,716917,16028211,16745128,1,1,128,15311294,In > Out
Sept 2020,142,71,1227,10579630,325260610,335840240,7,8,1168,314680980,In > Out
Sept 2020,142,73,734,229791168,4500582,234291750,81,727,1,225290586,Out > In
Sept 2020,142,74,77,48438382,939238,49377620,31,75,1,47499144,Out > In
Sept 2020,142,79,21,438830,17628557,18067387,11,2,21,17189727,In > Out
Sept 2020,142,86,2216,4197982,273924951,278122933,4,2144,2,269726969,In > Out
Sept 2020,142,89,1,101769,3962,105731,1,1,1,97807,Out > In
Sept 2020,142,9,21,20979295,530863,21510158,8,21,1,20448432,Out > In
Sept 2020,142,90,14,7870337,39980508,47850845,2,14,1,32110171,In > Out
Sept 2020,142,91,4,414225,254558,668783,2,4,1,159667,Out > In
Sept 2020,142,92,3,543363,230401,773764,1,3,1,312962,Out > In
Sept 2020,142,93,5,603135,46000,649135,5,5,1,557135,Out > In
Sept 2020,142,96,79,29485191,3345054,32830245,7,79,2,26140137,Out > In
Sept 2020,143,137,5,737219083,1518809717,2256028800,5,4,5,781590634,In > Out
Sept 2020,143,148,1,34311226,1335625,35646851,1,1,1,32975601,Out > In
Sept 2020,143,149,5,56287684,1893376803,1949664487,3,3,5,1837089119,In > Out
Sept 2020,143,152,22,2449149014,2792419160,5241568174,15,17,20,343270146,In > Out
Sept 2020,143,2,2,6615483,432100486,438715969,2,1,2,425485003,In > Out
Sept 2020,143,205,1,4834621,99908744,104743365,1,1,1,95074123,In > Out
Sept 2020,144,142,19,3441862,249008,3690870,9,19,2,3192854,Out > In
Sept 2020,146,132,12,673440,4699004,5372444,11,1,12,4025564,In > Out
Sept 2020,146,152,1,5354685,3678611,9033296,1,1,1,1676074,Out > In
Sept 2020,149,160,947,1571898504,412197133,1984095637,528,498,1,1159701371,Out > In
Sept 2020,149,181,1,72403,940066,1012469,1,1,1,867663,In > Out
Sept 2020,149,187,7,15148561,7865470,23014031,2,2,2,7283091,Out > In
Sept 2020,149,189,1,30432,326140,356572,1,1,1,295708,In > Out
Sept 2020,149,193,2,64107,156454,220561,2,1,2,92347,In > Out
Sept 2020,150,171,2,121473612,84373401,205847013,2,1,2,37100211,Out > In
Sept 2020,150,57,1,101787200,107805200,209592400,1,1,1,6018000,In > Out
Sept 2020,151,51,1,74184,41884,116068,1,1,1,32300,Out > In
Sept 2020,154,100,2,2418215,33856,2452071,1,2,1,2384359,Out > In
Sept 2020,154,162,2,1656497081,2038146772,3694643853,2,2,2,381649691,In > Out
Sept 2020,154,66,1,19608,164540,184148,1,1,1,144932,In > Out
Sept 2020,154,95,1,29392,331900,361292,1,1,1,302508,In > Out
Sept 2020,155,106,3,586530,342768,929298,3,3,1,243762,Out > In
Sept 2020,155,135,2764,17751131186,188882527,17940013713,377,2666,61,17562248659,Out > In
Sept 2020,155,136,149,996595542,10564098,1007159640,19,148,2,986031444,Out > In
Sept 2020,155,137,1993,6257418114,79724802,6337142916,164,1916,2,6177693312,Out > In
Sept 2020,155,142,32338,7737268952,162476600,7899745552,319,20610,4,7574792352,Out > In
Sept 2020,155,143,258,172768188,5946353,178714541,92,209,2,166821835,Out > In
Sept 2020,155,145,1,2465995,739712,3205707,1,1,1,1726283,Out > In
Sept 2020,155,146,11,1381487,299227,1680714,8,11,2,1082260,Out > In
Sept 2020,155,148,5,4372555,118894,4491449,2,5,2,4253661,Out > In
Sept 2020,155,149,521467,178238196258,3961908595,182200104853,6782,50052,4,174276287663,Out > In
Sept 2020,155,150,4338,1200730856,42318091,1243048947,525,4100,2,1158412765,Out > In
Sept 2020,155,151,907,31342349131,226463678,31568812809,199,871,14,31115885453,Out > In
Sept 2020,155,153,277,756133029,4144426,760277455,13,196,3,751988603,Out > In
Sept 2020,155,154,582,185461126,6189908,191651034,102,574,2,179271218,Out > In
Sept 2020,155,167,4617,81768386366,3852551264,85620937630,948,3605,3,77915835102,Out > In
Sept 2020,155,169,1234,4312118817,2623419685,6935538502,726,567,2,1688699132,Out > In
Sept 2020,155,170,1408,3286849500,685398286,3972247786,856,554,1,2601451214,Out > In
Sept 2020,155,198,216,99294694,1911082,101205776,108,214,2,97383612,Out > In
Sept 2020,155,199,161,1633831849,17124760,1650956609,92,161,2,1616707089,Out > In
Sept 2020,155,201,412,1091198057,14914818,1106112875,42,409,2,1076283239,Out > In
Sept 2020,155,202,1184,748425219,14278348,762703567,261,1165,1,734146871,Out > In
Sept 2020,155,205,75963,16190653464,517187536,16707841000,1237,31371,3,15673465928,Out > In
Sept 2020,155,74,4,7812474,226584,8039058,2,4,1,7585890,Out > In
Sept 2020,156,138,239,35945130,55350517,91295647,162,91,1,19405387,In > Out
Sept 2020,156,149,4,20757,930314,951071,4,4,1,909557,In > Out
Sept 2020,156,250,90,614127349,1659755348,2273882697,12,5,90,1045627999,In > Out
Sept 2020,159,248,7,451719442,162236296,613955738,7,4,6,289483146,Out > In
Sept 2020,16,10,20,405709624,12261967,417971591,1,20,20,393447657,Out > In
Sept 2020,16,12,1,8758813,25124880,33883693,1,1,1,16366067,In > Out
Sept 2020,16,14,32,5678231164,365121995,6043353159,13,17,22,5313109169,Out > In
Sept 2020,16,16,12,2606513,11155486,13761999,1,1,12,8548973,In > Out
Sept 2020,16,20,58,3932753650,113275825,4046029475,8,8,2,3819477825,Out > In
Sept 2020,16,240,3,39740575,174591303,214331878,2,2,3,134850728,In > Out
Sept 2020,160,109,6,3503771,6099199,9602970,1,1,6,2595428,In > Out
Sept 2020,160,121,414,22238995044,32673023467,54912018511,323,247,274,10434028423,In > Out
Sept 2020,160,122,755,25232934211,38120854876,63353789087,652,542,692,12887920665,In > Out
Sept 2020,160,123,309,25400764178,31143094103,56543858281,189,92,266,5742329925,In > Out
Sept 2020,160,124,296,16886786901,20910036445,37796823346,153,49,274,4023249544,In > Out
Sept 2020,160,125,266,24942616914,22039800848,46982417762,179,134,245,2902816066,Out > In
Sept 2020,160,126,277,17031816177,32887795435,49919611612,195,78,233,15855979258,In > Out
Sept 2020,160,127,349,20956801862,41417392701,62374194563,197,123,327,20460590839,In > Out
Sept 2020,160,128,120,11997759572,15906472167,27904231739,96,21,118,3908712595,In > Out
Sept 2020,160,132,14,577485471,668307421,1245792892,8,2,14,90821950,In > Out
Sept 2020,160,152,6,20817127,66650422,87467549,4,4,6,45833295,In > Out
Sept 2020,160,153,3,20276397,66988092,87264489,3,3,3,46711695,In > Out
Sept 2020,160,154,7,35691182,108958933,144650115,7,7,7,73267751,In > Out
Sept 2020,160,155,8,56839304,180498453,237337757,7,8,8,123659149,In > Out
Sept 2020,160,156,6,44772211,143736476,188508687,6,6,6,98964265,In > Out
Sept 2020,160,157,11,75287220,272731289,348018509,11,11,11,197444069,In > Out
Sept 2020,160,16,2,1286254,1367012,2653266,1,1,2,80758,In > Out
Sept 2020,160,196,1418,123098142706,201501311509,324599454215,984,408,1067,78403168803,In > Out
Sept 2020,160,197,1374,99422494408,161727399667,261149894075,937,287,998,62304905259,In > Out
Sept 2020,160,198,2059,107116337942,167816052496,274932390438,1286,980,1651,60699714554,In > Out
Sept 2020,160,199,1306,97631618355,166565505859,264197124214,921,271,972,68933887504,In > Out
Sept 2020,160,200,1004,27268754551,45858410940,73127165491,632,497,672,18589656389,In > Out
Sept 2020,160,201,651,23097279174,132032221024,155129500198,413,208,347,108934941850,In > Out
Sept 2020,160,202,897,28155748793,45405162712,73560911505,567,390,584,17249413919,In > Out
Sept 2020,160,203,657,34687193302,57207919467,91895112769,452,126,295,22520726165,In > Out
Sept 2020,160,239,21,2968369342,2883093734,5851463076,16,4,21,85275608,Out > In
Sept 2020,160,240,49,5442547630,5193859218,10636406848,31,13,43,248688412,Out > In
Sept 2020,160,241,17,403284824,949397506,1352682330,14,9,17,546112682,In > Out
Sept 2020,160,242,65,1872339633,1427636856,3299976489,41,23,54,444702777,Out > In
Sept 2020,160,243,47,2709455505,3538750048,6248205553,28,16,43,829294543,In > Out
Sept 2020,160,244,48,19722071356,12277669635,31999740991,33,20,48,7444401721,Out > In
Sept 2020,160,245,33,1370692900,749372319,2120065219,17,22,27,621320581,Out > In
Sept 2020,160,246,34,577562461,1757631629,2335194090,25,5,34,1180069168,In > Out
Sept 2020,160,247,59,1612436268,10977853175,12590289443,21,45,57,9365416907,In > Out
Sept 2020,160,34,8,690183,122928085,123618268,1,1,8,122237902,In > Out
Sept 2020,160,36,116,25184381,6911292,32095673,13,1,114,18273089,Out > In
Sept 2020,160,37,3,5226786,286170093,291396879,2,1,3,280943307,In > Out
Sept 2020,160,38,3,9416832,435784760,445201592,2,2,3,426367928,In > Out
Sept 2020,160,39,114,32995650,9866544,42862194,14,1,110,23129106,Out > In
Sept 2020,160,40,1,3255,165786,169041,1,1,1,162531,In > Out
Sept 2020,160,57,2,385474,412092,797566,2,2,2,26618,In > Out
Sept 2020,160,59,3,1169746,1543684,2713430,3,2,3,373938,In > Out
Sept 2020,160,60,3,23854654,164902076,188756730,3,3,3,141047422,In > Out
Sept 2020,160,62,9,486254763,482245338,968500101,7,6,9,4009425,Out > In
Sept 2020,160,63,11,2578494542,210904166,2789398708,3,11,11,2367590376,Out > In
Sept 2020,160,65,9,134135385,446554206,580689591,6,2,9,312418821,In > Out
Sept 2020,160,66,103,3420829462,8246300503,11667129965,44,60,102,4825471041,In > Out
Sept 2020,160,67,62,4834079435,6602509088,11436588523,34,36,62,1768429653,In > Out
Sept 2020,160,68,27,16863927464,755506047,17619433511,19,12,27,16108421417,Out > In
Sept 2020,160,69,55,2505737601,1363691396,3869428997,24,26,54,1142046205,Out > In
Sept 2020,160,70,11,408264118,1107111706,1515375824,7,5,11,698847588,In > Out
Sept 2020,160,71,14,616328684,1539953261,2156281945,9,11,14,923624577,In > Out
Sept 2020,160,72,307,14387390797,5691164430,20078555227,202,284,268,8696226367,Out > In
Sept 2020,160,73,2,78882,99041341,99120223,2,1,2,98962459,In > Out
Sept 2020,160,75,2,73904638,6273032,80177670,1,1,2,67631606,Out > In
Sept 2020,160,76,1,6137,114249,120386,1,1,1,108112,In > Out
Sept 2020,160,77,5,1501562,62378401,63879963,3,2,5,60876839,In > Out
Sept 2020,160,79,2,2307182,39291922,41599104,1,1,2,36984740,In > Out
Sept 2020,160,80,1,391471,2569864,2961335,1,1,1,2178393,In > Out
Sept 2020,160,81,2,1363375,1583019,2946394,2,2,2,219644,In > Out
Sept 2020,161,10,3,266288122,265793709,532081831,2,3,3,494413,Out > In
Sept 2020,161,100,3,384405672,854681019,1239086691,2,3,2,470275347,In > Out
Sept 2020,161,109,1,47430454,135381773,182812227,1,1,1,87951319,In > Out
Sept 2020,161,110,4,560287581,622586247,1182873828,4,3,4,62298666,In > Out
Sept 2020,161,111,2,1494789,1632522,3127311,1,1,2,137733,In > Out
Sept 2020,161,115,4,7667935,172264590,179932525,3,2,4,164596655,In > Out
Sept 2020,161,118,2,1026787,133617107,134643894,1,1,2,132590320,In > Out
Sept 2020,161,119,1,811907928,242487329,1054395257,1,1,1,569420599,Out > In
Sept 2020,161,124,2,26094845,402052,26496897,2,2,2,25692793,Out > In
Sept 2020,161,130,396,916375850,2660079931,3576455781,364,368,21,1743704081,In > Out
Sept 2020,161,132,2,859252838,1037920594,1897173432,2,2,1,178667756,In > Out
Sept 2020,161,133,2,16067586,20211259,36278845,2,2,2,4143673,In > Out
Sept 2020,161,138,2,1536235979,1481280086,3017516065,2,2,1,54955893,Out > In
Sept 2020,161,139,2,2006387,197193096,199199483,1,1,2,195186709,In > Out
Sept 2020,161,14,2,3208210,2814443,6022653,1,1,2,393767,Out > In
Sept 2020,161,141,3,634579622,643564231,1278143853,3,3,2,8984609,In > Out
Sept 2020,161,142,4,13274473,81303073,94577546,4,2,4,68028600,In > Out
Sept 2020,161,144,2,644798,3450571,4095369,2,2,2,2805773,In > Out
Sept 2020,161,145,2,1021062865,845554944,1866617809,1,2,2,175507921,Out > In
Sept 2020,161,151,5,888850286,918375951,1807226237,4,5,3,29525665,In > Out
Sept 2020,161,153,7,463618790,457057456,920676246,5,7,5,6561334,Out > In
Sept 2020,161,161,1,992035,53753838,54745873,1,1,1,52761803,In > Out
Sept 2020,161,162,5,6490186,262574757,269064943,4,1,5,256084571,In > Out
Sept 2020,161,165,6,9083025,160966146,170049171,4,1,6,151883121,In > Out
Sept 2020,161,166,1,211352,193821,405173,1,1,1,17531,Out > In
Sept 2020,161,169,2,880887,9811879,10692766,1,1,2,8930992,In > Out
Sept 2020,161,171,2,73578528,76722017,150300545,2,2,1,3143489,In > Out
Sept 2020,161,176,2,1370293,69707202,71077495,1,1,2,68336909,In > Out
Sept 2020,161,178,1,59171,45215,104386,1,1,1,13956,Out > In
Sept 2020,161,181,7,932605815,900617393,1833223208,5,7,6,31988422,Out > In
Sept 2020,161,182,10,187528238,177143018,364671256,3,7,7,10385220,Out > In
Sept 2020,161,184,1,1027011,1130678,2157689,1,1,1,103667,In > Out
Sept 2020,161,186,3,47217056,1685537449,1732754505,2,2,2,1638320393,In > Out
Sept 2020,161,190,3,82635797,225315737,307951534,2,2,3,142679940,In > Out
Sept 2020,161,192,1,467488,171358,638846,1,1,1,296130,Out > In
Sept 2020,161,197,1,127544061,140483914,268027975,1,1,1,12939853,In > Out
Sept 2020,161,202,2,911741,964227,1875968,2,2,2,52486,In > Out
Sept 2020,161,208,1,185745,572412,758157,1,1,1,386667,In > Out
Sept 2020,161,21,1,35385588,30311420,65697008,1,1,1,5074168,Out > In
Sept 2020,161,211,2,3572983,413089,3986072,2,2,2,3159894,Out > In
Sept 2020,161,212,8,115953365,120356250,236309615,5,7,4,4402885,In > Out
Sept 2020,161,215,1,62831267,18146335,80977602,1,1,1,44684932,Out > In
Sept 2020,161,220,1,841242,11542823,12384065,1,1,1,10701581,In > Out
Sept 2020,161,26,1,167351,189581,356932,1,1,1,22230,In > Out
Sept 2020,161,27,1,9026190,5436211,14462401,1,1,1,3589979,Out > In
Sept 2020,161,28,1,97777939,321438202,419216141,1,1,1,223660263,In > Out
Sept 2020,161,34,5,96348873,90665743,187014616,1,3,2,5683130,Out > In
Sept 2020,161,35,5,109738561,162002497,271741058,5,4,5,52263936,In > Out
Sept 2020,161,38,6,17881855,223993638,241875493,4,1,6,206111783,In > Out
Sept 2020,161,39,3,2572021,63933563,66505584,2,2,3,61361542,In > Out
Sept 2020,161,40,18,367641247,478436775,846078022,3,5,6,110795528,In > Out
Sept 2020,161,46,5,218627670,199113086,417740756,3,5,2,19514584,Out > In
Sept 2020,161,47,15,19801258,21844028,41645286,5,13,6,2042770,In > Out
Sept 2020,161,49,2,9781770,8105188,17886958,2,2,2,1676582,Out > In
Sept 2020,161,50,1,364205536,548953773,913159309,1,1,1,184748237,In > Out
Sept 2020,161,51,5,390483011,363086289,753569300,4,5,2,27396722,Out > In
Sept 2020,161,56,1,1843588,14181613,16025201,1,1,1,12338025,In > Out
Sept 2020,161,57,1,463753340,456728720,920482060,1,1,1,7024620,Out > In
Sept 2020,161,58,8,28479345,1926382270,1954861615,5,3,8,1897902925,In > Out
Sept 2020,161,6,1,357602,334517,692119,1,1,1,23085,Out > In
Sept 2020,161,65,1,502469,327547,830016,1,1,1,174922,Out > In
Sept 2020,161,67,1,70309748,100155330,170465078,1,1,1,29845582,In > Out
Sept 2020,161,68,1,1230583198,3195784385,4426367583,1,1,1,1965201187,In > Out
Sept 2020,161,72,1,306204,71631615,71937819,1,1,1,71325411,In > Out
Sept 2020,161,75,1,11989,231263,243252,1,1,1,219274,In > Out
Sept 2020,161,76,9,10995041,442932377,453927418,6,1,9,431937336,In > Out
Sept 2020,161,82,1,332170,165134,497304,1,1,1,167036,Out > In
Sept 2020,161,84,1,11056260,15055484,26111744,1,1,1,3999224,In > Out
Sept 2020,161,90,1,89322324,96539576,185861900,1,1,1,7217252,In > Out
Sept 2020,161,94,1,46354113,64842407,111196520,1,1,1,18488294,In > Out
Sept 2020,161,95,1,3496,147721,151217,1,1,1,144225,In > Out
Sept 2020,161,97,8,1331703280,1576243991,2907947271,6,4,5,244540711,In > Out
Sept 2020,164,196,3,3348752,8968724,12317476,3,2,3,5619972,In > Out
Sept 2020,164,81,21,14430240,8095575,22525815,8,4,1,6334665,Out > In
Sept 2020,164,82,7,4517700,2533908,7051608,2,2,1,1983792,Out > In
Sept 2020,164,83,848,1769350260,271137862,2040488122,142,763,4,1498212398,Out > In
Sept 2020,165,123,27,1220450677,43522530,1263973207,25,1,1,1176928147,Out > In
Sept 2020,165,152,5,29242875,112592620,141835495,3,3,5,83349745,In > Out
Sept 2020,165,165,4,385840418,597541211,983381629,4,3,4,211700793,In > Out
Sept 2020,165,176,130,48371914,1557997947,1606369861,2,130,2,1509626033,In > Out
Sept 2020,165,202,5,150873965,1150958221,1301832186,2,1,5,1000084256,In > Out
Sept 2020,165,233,4785,13779420984,445307008,14224727992,405,4310,1,13334113976,Out > In
Sept 2020,165,31,455,66844229,38665305,105509534,323,449,1,28178924,Out > In
Sept 2020,165,43,1,4960116,66699764,71659880,1,1,1,61739648,In > Out
Sept 2020,165,93,2,4998274,87853188,92851462,1,1,2,82854914,In > Out
Sept 2020,166,138,6,567730507,605595912,1173326419,4,3,6,37865405,In > Out
Sept 2020,167,121,1,25388,777812,803200,1,1,1,752424,In > Out
Sept 2020,167,124,1,2849027,15325672,18174699,1,1,1,12476645,In > Out
Sept 2020,167,139,2,19607617,83182321,102789938,2,2,2,63574704,In > Out
Sept 2020,168,111,5,7793528,196455831,204249359,4,2,5,188662303,In > Out
Sept 2020,168,112,18,2819886,1373969,4193855,7,4,2,1445917,Out > In
Sept 2020,168,123,1,8135,241076,249211,1,1,1,232941,In > Out
Sept 2020,168,132,1,23672,325620,349292,1,1,1,301948,In > Out
Sept 2020,168,153,10,151633145,5016906,156650051,1,10,1,146616239,Out > In
Sept 2020,168,155,15305,172945233103,7966377064,180911610167,8280,6122,2,164978856039,Out > In
Sept 2020,168,186,507,1150812184,29020228,1179832412,76,498,2,1121791956,Out > In
Sept 2020,168,219,28,21132058,194359,21326417,20,28,1,20937699,Out > In
Sept 2020,168,57,1430,1402115667,419285836,1821401503,183,1315,4,982829831,Out > In
Sept 2020,168,59,2,669508998,860307558,1529816556,2,2,2,190798560,In > Out
Sept 2020,168,74,2,7028032,3484680,10512712,2,2,1,3543352,Out > In
Sept 2020,169,156,4,183126096,12902360,196028456,1,4,1,170223736,Out > In
Sept 2020,169,159,1,75821,76136,151957,1,1,1,315,In > Out
Sept 2020,169,168,1,4020308,233953,4254261,1,1,1,3786355,Out > In
Sept 2020,169,174,316,47862882,27057395,74920277,223,314,1,20805487,Out > In
Sept 2020,169,187,1,12690136,89185211,101875347,1,1,1,76495075,In > Out
Sept 2020,169,4,8,1353064,895142,2248206,2,8,1,457922,Out > In
Sept 2020,169,6,111,205634930,7611138116,7816773046,49,111,2,7405503186,In > Out
Sept 2020,169,8,156,40321067485,2569640948,42890708433,36,155,2,37751426537,Out > In
Sept 2020,169,82,200,90370231,2136042,92506273,79,199,1,88234189,Out > In
Sept 2020,169,87,9,7688627,83272,7771899,7,9,1,7605355,Out > In
Sept 2020,170,129,1,20247906,54005700,74253606,1,1,1,33757794,In > Out
Sept 2020,170,13,9,975563262,38369384,1013932646,2,9,9,937193878,Out > In
Sept 2020,170,164,2,57162868,1338612,58501480,1,2,2,55824256,Out > In
Sept 2020,170,187,3,181695582,45763863,227459445,3,3,3,135931719,Out > In
Sept 2020,170,194,2,138426672,92193616,230620288,1,2,2,46233056,Out > In
Sept 2020,170,227,5,7151252,4105269,11256521,4,4,2,3045983,Out > In
Sept 2020,170,229,9,535140565,24989594,560130159,2,9,9,510150971,Out > In
Sept 2020,170,45,3,2288104,148261,2436365,1,2,3,2139843,Out > In
Sept 2020,170,47,2,121136348,2646673,123783021,1,2,2,118489675,Out > In
Sept 2020,170,57,13,7273105,60079881,67352986,4,4,13,52806776,In > Out
Sept 2020,170,63,3,620856,64221308,64842164,1,1,3,63600452,In > Out
Sept 2020,171,103,2,149537,12682558,12832095,1,1,2,12533021,In > Out
Sept 2020,171,105,3,2834743,147642710,150477453,1,1,3,144807967,In > Out
Sept 2020,171,108,3,525478578,560937406,1086415984,3,3,1,35458828,In > Out
Sept 2020,171,109,3,24795593,15878576,40674169,3,3,3,8917017,Out > In
Sept 2020,171,112,1,159580,324440,484020,1,1,1,164860,In > Out
Sept 2020,171,115,2,16052916,9764253,25817169,2,2,2,6288663,Out > In
Sept 2020,171,116,2,748378,6138119,6886497,2,2,2,5389741,In > Out
Sept 2020,171,118,4,3555244037,4071874215,7627118252,3,3,3,516630178,In > Out
Sept 2020,171,120,2,8308150,77098342,85406492,1,1,2,68790192,In > Out
Sept 2020,171,125,1,10855881,10768491,21624372,1,1,1,87390,Out > In
Sept 2020,171,130,4,4780446,107572073,112352519,2,1,4,102791627,In > Out
Sept 2020,171,131,3,57158848,585243161,642402009,1,1,3,528084313,In > Out
Sept 2020,171,135,1,12891,637129,650020,1,1,1,624238,In > Out
Sept 2020,171,137,5,437227036,571820650,1009047686,5,2,2,134593614,In > Out
Sept 2020,171,138,1,153995039,186390211,340385250,1,1,1,32395172,In > Out
Sept 2020,171,139,44,1305117802,1286792631,2591910433,44,44,44,18325171,Out > In
Sept 2020,171,140,8,534976630,276774524,811751154,5,2,8,258202106,Out > In
Sept 2020,171,141,1,112407130,38813116,151220246,1,1,1,73594014,Out > In
Sept 2020,171,142,2,1854444316,1940986112,3795430428,1,2,2,86541796,In > Out
Sept 2020,171,146,2,95356754,781933668,877290422,1,1,2,686576914,In > Out
Sept 2020,171,147,51,6531089,451806222,458337311,37,44,2,445275133,In > Out
Sept 2020,171,148,1,30149,223054,253203,1,1,1,192905,In > Out
Sept 2020,171,149,1,301881794,208876055,510757849,1,1,1,93005739,Out > In
Sept 2020,171,15,5,21872700,58965860,80838560,3,2,5,37093160,In > Out
Sept 2020,171,150,1,904801215,1342183984,2246985199,1,1,1,437382769,In > Out
Sept 2020,171,153,2,6914381134,2402878180,9317259314,2,2,1,4511502954,Out > In
Sept 2020,171,156,1,111694,159279,270973,1,1,1,47585,In > Out
Sept 2020,171,158,3,2674633,222400468,225075101,2,2,3,219725835,In > Out
Sept 2020,171,159,4,27506198,15444970,42951168,3,2,4,12061228,Out > In
Sept 2020,171,16,2,332248978,846116719,1178365697,2,2,2,513867741,In > Out
Sept 2020,171,161,2,1438473,77140448,78578921,1,1,2,75701975,In > Out
Sept 2020,171,164,7,495201691,746960322,1242162013,6,4,7,251758631,In > Out
Sept 2020,171,165,4,154733,883036,1037769,4,1,4,728303,In > Out
Sept 2020,171,166,3,441179546,430025111,871204657,3,3,2,11154435,Out > In
Sept 2020,171,168,1,2311,104292,106603,1,1,1,101981,In > Out
Sept 2020,171,171,5,4384601,37034926,41419527,3,1,5,32650325,In > Out
Sept 2020,171,173,1,87984,43789,131773,1,1,1,44195,Out > In
Sept 2020,171,174,9,217564693,360445352,578010045,3,9,5,142880659,In > Out
Sept 2020,171,175,1,122150463,2537696,124688159,1,1,1,119612767,Out > In
Sept 2020,171,184,8,4302086872,4139481961,8441568833,5,4,4,162604911,Out > In
Sept 2020,171,185,1,91181347,67923492,159104839,1,1,1,23257855,Out > In
Sept 2020,171,187,1,5428897,5889200,11318097,1,1,1,460303,In > Out
Sept 2020,171,188,3,477336,655554,1132890,2,2,2,178218,In > Out
Sept 2020,171,19,1,72689939,304771271,377461210,1,1,1,232081332,In > Out
Sept 2020,171,202,1,619197916,614836159,1234034075,1,1,1,4361757,Out > In
Sept 2020,171,212,1,1312540,37356143,38668683,1,1,1,36043603,In > Out
Sept 2020,171,22,3,848994181,687095625,1536089806,2,3,2,161898556,Out > In
Sept 2020,171,221,12,418191267,464790655,882981922,9,2,12,46599388,In > Out
Sept 2020,171,23,2,710545584,744243765,1454789349,2,2,2,33698181,In > Out
Sept 2020,171,30,3,82182710,140162317,222345027,3,3,3,57979607,In > Out
Sept 2020,171,40,7,8096057082,6982917445,15078974527,4,3,7,1113139637,Out > In
Sept 2020,171,42,1,6626511,2949727,9576238,1,1,1,3676784,Out > In
Sept 2020,171,44,1,122864,28152,151016,1,1,1,94712,Out > In
Sept 2020,171,45,4,4884780,91969086,96853866,3,3,4,87084306,In > Out
Sept 2020,171,48,4,48634770,415716080,464350850,2,1,4,367081310,In > Out
Sept 2020,171,49,21,59203892,165811712,225015604,21,21,4,106607820,In > Out
Sept 2020,171,54,2,41381767,60243246,101625013,2,2,1,18861479,In > Out
Sept 2020,171,58,2,46384,1873453,1919837,2,2,2,1827069,In > Out
Sept 2020,171,59,29,1337503,48428752,49766255,28,28,2,47091249,In > Out
Sept 2020,171,60,3,297471698,304488044,601959742,2,1,3,7016346,In > Out
Sept 2020,171,65,4,1377028655,1054240454,2431269109,3,3,4,322788201,Out > In
Sept 2020,171,66,3,10864802,152197066,163061868,2,1,3,141332264,In > Out
Sept 2020,171,76,6,710484433,701014878,1411499311,5,2,5,9469555,Out > In
Sept 2020,171,77,2,183382827,248394499,431777326,1,1,2,65011672,In > Out
Sept 2020,171,78,2,898759,826972,1725731,1,2,2,71787,Out > In
Sept 2020,171,79,2,153694220,40621668,194315888,2,2,2,113072552,Out > In
Sept 2020,171,81,2,23124868,181717868,204842736,1,1,1,158593000,In > Out
Sept 2020,171,82,4,1162394600,1580104448,2742499048,2,2,4,417709848,In > Out
Sept 2020,171,86,4,4867361,35495025,40362386,3,2,4,30627664,In > Out
Sept 2020,171,87,2,643061,57894864,58537925,2,1,2,57251803,In > Out
Sept 2020,171,93,3,64423516,66466525,130890041,3,3,1,2043009,In > Out
Sept 2020,174,119,1,102678,2901,105579,1,1,1,99777,Out > In
Sept 2020,174,196,3,118016548,2790866380,2908882928,3,1,3,2672849832,In > Out
Sept 2020,175,192,1,134831127,10800283,145631410,1,1,1,124030844,Out > In
Sept 2020,176,38,1,2378,132487,134865,1,1,1,130109,In > Out
Sept 2020,177,174,11,11047717,287896,11335613,2,11,1,10759821,Out > In
Sept 2020,178,184,4,107201,667464,774665,1,1,1,560263,In > Out
Sept 2020,179,160,13574,141321408452,6592201438,147913609890,7912,4865,1,134729207014,Out > In
Sept 2020,179,44,10,1691881,73853,1765734,3,10,2,1618028,Out > In
Sept 2020,179,47,1,2544,105624,108168,1,1,1,103080,In > Out
Sept 2020,180,189,714,345166735,351887194,697053929,465,379,3,6720459,In > Out
Sept 2020,180,62,2,16562470,14289841,30852311,1,1,2,2272629,Out > In
Sept 2020,180,96,3,74231435,255798468,330029903,3,1,3,181567033,In > Out
Sept 2020,181,163,11,746208,1391220,2137428,9,11,1,645012,In > Out
Sept 2020,181,169,1372,1356406706,409776139,1766182845,154,1260,3,946630567,Out > In
Sept 2020,181,171,2,1724268,89963266,91687534,1,1,2,88238998,In > Out
Sept 2020,181,175,1,3576006,106803500,110379506,1,1,1,103227494,In > Out
Sept 2020,181,184,4712,123603781538,6013909228,129617690766,1410,3144,1,117589872310,Out > In
Sept 2020,181,20,9,2050370756,36188581,2086559337,1,9,9,2014182175,Out > In
Sept 2020,181,212,16,4627752,1410600,6038352,5,2,1,3217152,Out > In
Sept 2020,181,228,22,404230,3171075,3575305,16,22,2,2766845,In > Out
Sept 2020,181,229,2,453940,196633,650573,1,2,1,257307,Out > In
Sept 2020,181,244,23,5095888,2014035,7109923,9,9,2,3081853,Out > In
Sept 2020,181,248,3,41335661,29303570,70639231,3,3,3,12032091,Out > In
Sept 2020,181,59,7,2236979766,2232962725,4469942491,5,2,7,4017041,Out > In
Sept 2020,181,64,1651,485663624,255591833,741255457,321,609,2,230071791,Out > In
Sept 2020,181,71,10,372199764,1085167897,1457367661,7,6,10,712968133,In > Out
Sept 2020,181,82,1,30592,1097460,1128052,1,1,1,1066868,In > Out
Sept 2020,181,9,1,1658813,114697148,116355961,1,1,1,113038335,In > Out
Sept 2020,183,119,235,405866381,7338794,413205175,94,232,2,398527587,Out > In
Sept 2020,183,17,1100,824425433,38979481,863404914,75,1086,1,785445952,Out > In
Sept 2020,183,19,4,893092,19669,912761,2,4,1,873423,Out > In
Sept 2020,183,94,5,77503410,500613280,578116690,3,1,5,423109870,In > Out
Sept 2020,184,134,400,214775255,222113794,436889049,109,394,6,7338539,In > Out
Sept 2020,184,135,40,425837873,29289577,455127450,6,40,1,396548296,Out > In
Sept 2020,184,136,27,45668308,48883633,94551941,5,4,24,3215325,In > Out
Sept 2020,184,137,1234,8048322410,259239373,8307561783,277,1163,84,7789083037,Out > In
Sept 2020,184,138,57,6853946,6890737,13744683,1,1,1,36791,In > Out
Sept 2020,184,188,49,22917939,10712899,33630838,4,4,49,12205040,Out > In
Sept 2020,184,203,1,60609,97348,157957,1,1,1,36739,In > Out
Sept 2020,184,216,20,1141930,1849036,2990966,2,14,3,707106,In > Out
Sept 2020,184,218,12,34434751,2251120,36685871,5,11,1,32183631,Out > In
Sept 2020,184,219,13,161436,4126247,4287683,1,10,13,3964811,In > Out
Sept 2020,184,246,1,146996308,92113328,239109636,1,1,1,54882980,Out > In
Sept 2020,19,100,3,314968,110862,425830,2,3,2,204106,Out > In
Sept 2020,19,106,2,198594,198828,397422,1,2,1,234,In > Out
Sept 2020,19,108,3,235268,237552,472820,1,3,1,2284,In > Out
Sept 2020,19,111,4,254782,255520,510302,1,4,1,738,In > Out
Sept 2020,19,118,5,442466,539557,982023,2,5,1,97091,In > Out
Sept 2020,19,12,6,497338,497000,994338,1,6,1,338,Out > In
Sept 2020,19,121,4,279818,278940,558758,1,4,1,878,Out > In
Sept 2020,19,122,3,3702,361116,364818,1,1,3,357414,In > Out
Sept 2020,19,13,3,159190,470370,629560,2,3,1,311180,In > Out
Sept 2020,19,135,4,304703,304648,609351,1,4,1,55,Out > In
Sept 2020,19,137,4,324567,325740,650307,1,4,1,1173,In > Out
Sept 2020,19,138,3,213957,214000,427957,1,3,1,43,In > Out
Sept 2020,19,140,3,212734,119815,332549,2,3,2,92919,Out > In
Sept 2020,19,141,4016,8115436227,8972942894,17088379121,144,3602,2,857506667,In > Out
Sept 2020,19,143,404,8257701,439376168,447633869,22,402,2,431118467,In > Out
Sept 2020,19,150,105571,52916837178,2861672999,55778510177,27166,31372,2,50055164179,Out > In
Sept 2020,19,152,37388,5171401272,2145261270,7316662542,2546,16336,2,3026140002,Out > In
Sept 2020,19,155,7,331042,786835,1117877,4,7,2,455793,In > Out
Sept 2020,19,160,257,184874535,6095243,190969778,185,257,2,178779292,Out > In
Sept 2020,19,165,174,45772904,8986052,54758956,114,172,2,36786852,Out > In
Sept 2020,19,167,11,1409066,54452,1463518,10,11,1,1354614,Out > In
Sept 2020,19,169,53,9364903,15596266,24961169,21,53,1,6231363,In > Out
Sept 2020,19,190,338,2660432202,772604314,3433036516,96,335,2,1887827888,Out > In
Sept 2020,19,191,478,4586262837,1243511337,5829774174,56,476,2,3342751500,Out > In
Sept 2020,19,192,1,82749,84024,166773,1,1,1,1275,In > Out
Sept 2020,19,193,20,126462418,11542974,138005392,3,20,2,114919444,Out > In
Sept 2020,19,195,5,841706,241725,1083431,1,5,1,599981,Out > In
Sept 2020,19,27,4,284058,285628,569686,1,4,1,1570,In > Out
Sept 2020,19,28,17,3141074,84010,3225084,7,17,1,3057064,Out > In
Sept 2020,19,87,10,1531142,325865,1857007,6,10,2,1205277,Out > In
Sept 2020,19,88,1,72850,73916,146766,1,1,1,1066,In > Out
Sept 2020,19,92,5,356301,356732,713033,1,5,1,431,In > Out
Sept 2020,19,98,2,117861,117940,235801,1,2,1,79,In > Out
Sept 2020,190,125,5,1755277,156082,1911359,3,5,2,1599195,Out > In
Sept 2020,190,165,7,1240401,46535,1286936,2,7,1,1193866,Out > In
Sept 2020,190,199,32646,40772516899,1052915576,41825432475,10170,22940,2,39719601323,Out > In
Sept 2020,190,217,1,110998,5859,116857,1,1,1,105139,Out > In
Sept 2020,190,219,1,114606,4662,119268,1,1,1,109944,Out > In
Sept 2020,190,37,22,6942512,102098063,109040575,12,22,1,95155551,In > Out
Sept 2020,190,39,39,17906187,1929155,19835342,8,39,3,15977032,Out > In
Sept 2020,190,43,390,54371567,1634503,56006070,122,388,1,52737064,Out > In
Sept 2020,190,44,21711,4446828939,159480033,4606308972,1639,16494,2,4287348906,Out > In
Sept 2020,190,48,788,45167114,1288625446,1333792560,1,781,1,1243458332,In > Out
Sept 2020,190,57,1,1157519,40806,1198325,1,1,1,1116713,Out > In
Sept 2020,190,91,144,123032939,1591885,124624824,110,144,2,121441054,Out > In
Sept 2020,191,14,3,880196,312777,1192973,2,3,1,567419,Out > In
Sept 2020,191,37,1,31451468,518931,31970399,1,1,1,30932537,Out > In
Sept 2020,192,38,1,5318336,126630392,131948728,1,1,1,121312056,In > Out
Sept 2020,192,40,7,702248,20302430,21004678,2,7,1,19600182,In > Out
Sept 2020,195,10,1,1270939,821612,2092551,1,1,1,449327,Out > In
Sept 2020,195,100,1,6705114,7726586,14431700,1,1,1,1021472,In > Out
Sept 2020,195,106,5,231893872,243636362,475530234,4,5,5,11742490,In > Out
Sept 2020,195,11,2,7419776,6722631,14142407,2,2,2,697145,Out > In
Sept 2020,195,110,4,2106259,14913931,17020190,3,2,4,12807672,In > Out
Sept 2020,195,113,2,143847014,943376575,1087223589,1,2,2,799529561,In > Out
Sept 2020,195,12,1,1179843,1264398,2444241,1,1,1,84555,In > Out
Sept 2020,195,120,3,830999462,836576503,1667575965,3,3,2,5577041,In > Out
Sept 2020,195,125,10,1846498,27481954,29328452,10,10,2,25635456,In > Out
Sept 2020,195,129,4,540397,21193587,21733984,1,1,4,20653190,In > Out
Sept 2020,195,130,1,1093099928,1332882810,2425982738,1,1,1,239782882,In > Out
Sept 2020,195,137,4,408909603,492265646,901175249,1,4,4,83356043,In > Out
Sept 2020,195,14,4,5947775,310063155,316010930,2,1,4,304115380,In > Out
Sept 2020,195,142,5,797302296,842017135,1639319431,3,5,5,44714839,In > Out
Sept 2020,195,144,90,42827912,244568541,287396453,45,38,4,201740629,In > Out
Sept 2020,195,145,2,909296912,889571585,1798868497,1,1,1,19725327,Out > In
Sept 2020,195,147,4,549176670,756673858,1305850528,4,2,1,207497188,In > Out
Sept 2020,195,149,1,1097053,1235115,2332168,1,1,1,138062,In > Out
Sept 2020,195,154,1,70149,1381039,1451188,1,1,1,1310890,In > Out
Sept 2020,195,156,2,127251868,105691405,232943273,1,2,2,21560463,Out > In
Sept 2020,195,159,1,84837,59082,143919,1,1,1,25755,Out > In
Sept 2020,195,16,1,19175415,7190429,26365844,1,1,1,11984986,Out > In
Sept 2020,195,166,6,952658649,634706237,1587364886,3,5,2,317952412,Out > In
Sept 2020,195,169,8,1389101544,1892707867,3281809411,8,4,2,503606323,In > Out
Sept 2020,195,174,1,51066,84074,135140,1,1,1,33008,In > Out
Sept 2020,195,177,2,280312,611581,891893,2,2,2,331269,In > Out
Sept 2020,195,180,3,584372413,676389235,1260761648,2,3,3,92016822,In > Out
Sept 2020,195,182,1,98054769,122528563,220583332,1,1,1,24473794,In > Out
Sept 2020,195,185,1,92824,217396,310220,1,1,1,124572,In > Out
Sept 2020,195,187,4,60468594,54186132,114654726,2,4,2,6282462,Out > In
Sept 2020,195,188,2,7657760,26911086,34568846,1,2,2,19253326,In > Out
Sept 2020,195,191,1,340608,341835,682443,1,1,1,1227,In > Out
Sept 2020,195,194,1,52442675,178205523,230648198,1,1,1,125762848,In > Out
Sept 2020,195,196,1,90265,333400,423665,1,1,1,243135,In > Out
Sept 2020,195,200,4,373218,842034,1215252,4,1,4,468816,In > Out
Sept 2020,195,201,7,200277783,209160736,409438519,4,7,6,8882953,In > Out
Sept 2020,195,205,1,474138,22643286,23117424,1,1,1,22169148,In > Out
Sept 2020,195,207,12,1761930572,1955081934,3717012506,7,8,1,193151362,In > Out
Sept 2020,195,21,12,714031,3534313,4248344,1,1,12,2820282,In > Out
Sept 2020,195,212,3,1660650791,1034696264,2695347055,1,1,2,625954527,Out > In
Sept 2020,195,215,7,44080150,186913782,230993932,7,6,7,142833632,In > Out
Sept 2020,195,216,6,1363459130,1655897895,3019357025,6,6,2,292438765,In > Out
Sept 2020,195,217,2,154782830,337975657,492758487,2,2,1,183192827,In > Out
Sept 2020,195,218,1,13123478,1424060,14547538,1,1,1,11699418,Out > In
Sept 2020,195,220,2,667106,756938,1424044,2,2,2,89832,In > Out
Sept 2020,195,223,1,1766306,56356539,58122845,1,1,1,54590233,In > Out
Sept 2020,195,24,3,1249854,1965227,3215081,2,2,3,715373,In > Out
Sept 2020,195,25,1,1097807312,1115056921,2212864233,1,1,1,17249609,In > Out
Sept 2020,195,28,2,45611,12564067,12609678,1,1,2,12518456,In > Out
Sept 2020,195,32,1,7342652,3862412,11205064,1,1,1,3480240,Out > In
Sept 2020,195,34,2,236771768,420778161,657549929,2,2,2,184006393,In > Out
Sept 2020,195,37,2,502056366,693831924,1195888290,2,2,1,191775558,In > Out
Sept 2020,195,4,1,60738,3245521,3306259,1,1,1,3184783,In > Out
Sept 2020,195,40,2,131589,84433,216022,2,1,2,47156,Out > In
Sept 2020,195,41,1,8158788,9750034,17908822,1,1,1,1591246,In > Out
Sept 2020,195,45,6,5918281,7188706,13106987,2,6,1,1270425,In > Out
Sept 2020,195,50,1,36875,543977,580852,1,1,1,507102,In > Out
Sept 2020,195,52,1,333596,896468,1230064,1,1,1,562872,In > Out
Sept 2020,195,53,1,11343616,26765426,38109042,1,1,1,15421810,In > Out
Sept 2020,195,54,2,306953828,362311434,669265262,2,2,2,55357606,In > Out
Sept 2020,195,57,14,145516128,98929293,244445421,2,12,6,46586835,Out > In
Sept 2020,195,63,1,110312,103389,213701,1,1,1,6923,Out > In
Sept 2020,195,66,1,263433834,120314481,383748315,1,1,1,143119353,Out > In
Sept 2020,195,68,11,6286651,8195076,14481727,2,11,3,1908425,In > Out
Sept 2020,195,69,1,4989,232586,237575,1,1,1,227597,In > Out
Sept 2020,195,75,5,19899190,114347446,134246636,5,3,1,94448256,In > Out
Sept 2020,195,79,2,122260,55066656,55188916,2,2,2,54944396,In > Out
Sept 2020,195,8,613,100222833,92081831,192304664,156,284,1,8141002,Out > In
Sept 2020,195,82,1,45388268,59431075,104819343,1,1,1,14042807,In > Out
Sept 2020,195,85,2,173795734,147378925,321174659,1,1,1,26416809,Out > In
Sept 2020,195,89,2,4427811,227148356,231576167,1,1,2,222720545,In > Out
Sept 2020,195,93,3,411906481,430256390,842162871,2,3,3,18349909,In > Out
Sept 2020,195,94,1,880634,938973,1819607,1,1,1,58339,In > Out
Sept 2020,195,96,1,20610200,10579399,31189599,1,1,1,10030801,Out > In
Sept 2020,195,97,1,6178,153308,159486,1,1,1,147130,In > Out
Sept 2020,196,113,3,324538,25077,349615,3,3,1,299461,Out > In
Sept 2020,196,124,1,104366,8741,113107,1,1,1,95625,Out > In
Sept 2020,196,126,4,408343,185543,593886,4,4,2,222800,Out > In
Sept 2020,196,151,4,410293,28967,439260,3,4,1,381326,Out > In
Sept 2020,196,165,3,327864,24271,352135,2,3,1,303593,Out > In
Sept 2020,196,166,2,219232,16996,236228,2,2,1,202236,Out > In
Sept 2020,196,186,2,209851,16046,225897,2,2,1,193805,Out > In
Sept 2020,196,188,2,221160,17969,239129,2,2,1,203191,Out > In
Sept 2020,196,197,1,100080,9261,109341,1,1,1,90819,Out > In
Sept 2020,196,199,2,222660,18749,241409,2,2,1,203911,Out > In
Sept 2020,196,203,1,107483,8481,115964,1,1,1,99002,Out > In
Sept 2020,196,206,2,222660,17917,240577,2,2,1,204743,Out > In
Sept 2020,196,212,1,100976,9053,110029,1,1,1,91923,Out > In
Sept 2020,196,25,3,326381,25263,351644,3,3,1,301118,Out > In
Sept 2020,196,27,1,107337,9082,116419,1,1,1,98255,Out > In
Sept 2020,196,28,1,110655,8683,119338,1,1,1,101972,Out > In
Sept 2020,196,38,2,217349,16441,233790,2,2,1,200908,Out > In
Sept 2020,196,64,3,312129,24222,336351,2,3,1,287907,Out > In
Sept 2020,196,66,3,326899,22073,348972,3,3,1,304826,Out > In
Sept 2020,196,73,2,219369,15814,235183,2,2,1,203555,Out > In
Sept 2020,196,78,3,322653,21785,344438,2,3,1,300868,Out > In
Sept 2020,196,82,1,110655,8527,119182,1,1,1,102128,Out > In
Sept 2020,196,85,1,108941,9134,118075,1,1,1,99807,Out > In
Sept 2020,196,90,4,425042,30999,456041,3,4,1,394043,Out > In
Sept 2020,196,91,1,109074,6661,115735,1,1,1,102413,Out > In
Sept 2020,196,93,1,96767,10694,107461,1,1,1,86073,Out > In
Sept 2020,196,95,1,107284,8475,115759,1,1,1,98809,Out > In
Sept 2020,197,105,1,44102950,48320533,92423483,1,1,1,4217583,In > Out
Sept 2020,197,11,1,219311657,232314163,451625820,1,1,1,13002506,In > Out
Sept 2020,197,110,7,200139810,307585589,507725399,4,3,7,107445779,In > Out
Sept 2020,197,121,3,809645083,1077931131,1887576214,2,3,3,268286048,In > Out
Sept 2020,197,123,1,11680,91328,103008,1,1,1,79648,In > Out
Sept 2020,197,131,1,189948978,200953068,390902046,1,1,1,11004090,In > Out
Sept 2020,197,135,4,2901142,2123487,5024629,2,4,3,777655,Out > In
Sept 2020,197,14,1,29801,31572634,31602435,1,1,1,31542833,In > Out
Sept 2020,197,140,1,1110490302,136901131,1247391433,1,1,1,973589171,Out > In
Sept 2020,197,146,2,1674692,402443514,404118206,1,1,2,400768822,In > Out
Sept 2020,197,149,2,469876538,429894534,899771072,1,2,2,39982004,Out > In
Sept 2020,197,163,1,348,390655,391003,1,1,1,390307,In > Out
Sept 2020,197,172,2,394114500,450623208,844737708,2,2,2,56508708,In > Out
Sept 2020,197,181,2,2432617,188526425,190959042,1,1,2,186093808,In > Out
Sept 2020,197,187,2,984665,1101695,2086360,2,2,2,117030,In > Out
Sept 2020,197,191,1,199850246,124702371,324552617,1,1,1,75147875,Out > In
Sept 2020,197,192,1,27094,89609,116703,1,1,1,62515,In > Out
Sept 2020,197,198,1,78569,75387,153956,1,1,1,3182,Out > In
Sept 2020,197,205,4,957361,61123956,62081317,2,2,4,60166595,In > Out
Sept 2020,197,206,1,3435509,1174645,4610154,1,1,1,2260864,Out > In
Sept 2020,197,215,1,518356470,547985522,1066341992,1,1,1,29629052,In > Out
Sept 2020,197,221,1,908204,17333707,18241911,1,1,1,16425503,In > Out
Sept 2020,197,223,2,12431,211895,224326,2,2,2,199464,In > Out
Sept 2020,197,40,1,31466462,31774257,63240719,1,1,1,307795,In > Out
Sept 2020,197,42,1,498610594,500678549,999289143,1,1,1,2067955,In > Out
Sept 2020,197,43,1,292334168,327273925,619608093,1,1,1,34939757,In > Out
Sept 2020,197,48,1,928316351,926202983,1854519334,1,1,1,2113368,Out > In
Sept 2020,197,49,1,22287211,21982808,44270019,1,1,1,304403,Out > In
Sept 2020,197,53,2,661827,62189,724016,2,1,2,599638,Out > In
Sept 2020,197,57,2,11693321,46016323,57709644,1,2,2,34323002,In > Out
Sept 2020,197,58,1,1307169406,402963756,1710133162,1,1,1,904205650,Out > In
Sept 2020,197,60,2,24614044,24893314,49507358,2,2,2,279270,In > Out
Sept 2020,197,62,1,533495287,97086627,630581914,1,1,1,436408660,Out > In
Sept 2020,197,63,1,20970106,23476133,44446239,1,1,1,2506027,In > Out
Sept 2020,197,64,4,47664136,731439104,779103240,1,1,1,683774968,In > Out
Sept 2020,197,79,5,4545606,4330467,8876073,3,5,5,215139,Out > In
Sept 2020,197,83,2,63602495,63899608,127502103,1,1,1,297113,In > Out
Sept 2020,197,85,1,967646,1265303,2232949,1,1,1,297657,In > Out
Sept 2020,197,87,1,41125,48598586,48639711,1,1,1,48557461,In > Out
Sept 2020,197,89,1,6667,2419289,2425956,1,1,1,2412622,In > Out
Sept 2020,197,9,1,66376,70390,136766,1,1,1,4014,In > Out
Sept 2020,198,22,1319,2828210698,679395580,3507606278,261,487,16,2148815118,Out > In
Sept 2020,2,1,85,7160340,7016928,14177268,14,14,1,143412,Out > In
Sept 2020,2,100,8,574677814,187329007,762006821,4,4,3,387348807,Out > In
Sept 2020,2,12,11298,1632009610,2163272449,3795282059,111,10023,2,531262839,In > Out
Sept 2020,2,14,17,829733663,52685788,882419451,5,17,2,777047875,Out > In
Sept 2020,2,15,101,57690426,54614813,112305239,3,101,100,3075613,Out > In
Sept 2020,2,17,46574,78223919428,1058091412,79282010840,7640,25190,2,77165828016,Out > In
Sept 2020,2,19,23897,70699383849,752634730,71452018579,3203,18182,1,69946749119,Out > In
Sept 2020,2,21,41306,79571590645,10087525777,89659116422,6264,27788,5,69484064868,Out > In
Sept 2020,2,22,1,120298,7348,127646,1,1,1,112950,Out > In
Sept 2020,2,23,5,1376315,205780,1582095,3,5,2,1170535,Out > In
Sept 2020,2,24,11,17051230,277635,17328865,8,11,1,16773595,Out > In
Sept 2020,2,244,1796,6460634758,6057345716,12517980474,16,1713,1,403289042,Out > In
Sept 2020,2,25,5,818629,210719,1029348,4,5,3,607910,Out > In
Sept 2020,2,26,7,1248186,385070,1633256,4,7,3,863116,Out > In
Sept 2020,2,27,3,623514,195387,818901,2,3,2,428127,Out > In
Sept 2020,2,29,44,15665852,1021057,16686909,36,44,2,14644795,Out > In
Sept 2020,2,30,6381,18529482694,275423735,18804906429,1954,5879,2,18254058959,Out > In
Sept 2020,2,32,5,862458,192917,1055375,3,5,3,669541,Out > In
Sept 2020,2,33,6,8070509,95847,8166356,5,6,3,7974662,Out > In
Sept 2020,2,35,7,1138238,309394,1447632,7,7,4,828844,Out > In
Sept 2020,2,36,5,656017,36637,692654,4,5,1,619380,Out > In
Sept 2020,2,38,116,127985094,2383625,130368719,49,116,2,125601469,Out > In
Sept 2020,2,4,26,2213348,2187204,4400552,4,4,1,26144,Out > In
Sept 2020,2,8,1,922857,32889,955746,1,1,1,889968,Out > In
Sept 2020,2,85,384,470149997,23007971,493157968,127,379,1,447142026,Out > In
Sept 2020,2,91,43351,435317375509,14984796028,450302171537,968,20948,34,420332579481,Out > In
Sept 2020,200,17,1,146949,16561,163510,1,1,1,130388,Out > In
Sept 2020,200,199,6369,9439042596,207499156,9646541752,820,5803,1,9231543440,Out > In
Sept 2020,200,20,2,453507,188513,642020,1,2,1,264994,Out > In
Sept 2020,200,200,7,1711353,84509,1795862,7,7,1,1626844,Out > In
Sept 2020,200,206,6,6894087,199716,7093803,2,6,1,6694371,Out > In
Sept 2020,200,211,124,160038008,3239485,163277493,36,124,2,156798523,Out > In
Sept 2020,200,22,13,1519173,669279,2188452,11,13,2,849894,Out > In
Sept 2020,200,24,691,2180237107,34903058,2215140165,146,686,2,2145334049,Out > In
Sept 2020,200,25,2,279664,100726,380390,1,2,1,178938,Out > In
Sept 2020,200,33,88,19548039,1506146,21054185,67,88,2,18041893,Out > In
Sept 2020,200,34,78,243316834,5155255,248472089,51,78,2,238161579,Out > In
Sept 2020,200,35,72,157721080,1326536,159047616,32,71,2,156394544,Out > In
Sept 2020,200,36,56,11630075,439025,12069100,38,56,2,11191050,Out > In
Sept 2020,200,38,113,30992913,1723632,32716545,51,113,2,29269281,Out > In
Sept 2020,200,45,3189,6432477251,137594998,6570072249,435,3043,2,6294882253,Out > In
Sept 2020,200,60,53,40534495,1210583,41745078,17,53,1,39323912,Out > In
Sept 2020,200,61,15,5016931,193977,5210908,12,15,1,4822954,Out > In
Sept 2020,200,65,265,106826814,39621794,146448608,30,263,2,67205020,Out > In
Sept 2020,200,68,300,734134105,11851154,745985259,55,300,2,722282951,Out > In
Sept 2020,202,114,26,3521947,105446,3627393,20,26,1,3416501,Out > In
Sept 2020,202,120,2,115833,115516,231349,1,2,1,317,Out > In
Sept 2020,202,209,1,223089,6889,229978,1,1,1,216200,Out > In
Sept 2020,202,251,3,205728,205752,411480,1,3,1,24,In > Out
Sept 2020,202,37,2,205486,205552,411038,1,2,1,66,In > Out
Sept 2020,202,68,4,291826,315849,607675,2,4,1,24023,In > Out
Sept 2020,202,74,4,298427,296992,595419,1,4,1,1435,Out > In
Sept 2020,203,176,1,7292787,7250074,14542861,1,1,1,42713,Out > In
Sept 2020,206,113,525,243976980,91825619,335802599,278,253,1,152151361,Out > In
Sept 2020,206,127,1,63225,70145,133370,1,1,1,6920,In > Out
Sept 2020,206,200,267,205053810,85782155,290835965,182,72,1,119271655,Out > In
Sept 2020,206,7,304,185974330,47138927,233113257,188,101,2,138835403,Out > In
Sept 2020,206,9,134,87576469,28572370,116148839,103,61,3,59004099,Out > In
Sept 2020,207,111,1,27036,213976,241012,1,1,1,186940,In > Out
Sept 2020,207,127,1990,4600853448,928205425,5529058873,849,1497,1,3672648023,Out > In
Sept 2020,208,113,93991,161748271713,1959445552,163707717265,21721,41579,2,159788826161,Out > In
Sept 2020,208,114,2320,33166753614,289108319,33455861933,671,2261,1,32877645295,Out > In
Sept 2020,208,115,10927,6490494868,396809410,6887304278,446,9220,1,6093685458,Out > In
Sept 2020,208,116,4,741350,342763,1084113,2,4,1,398587,Out > In
Sept 2020,208,117,4,568617,37532,606149,4,4,1,531085,Out > In
Sept 2020,208,119,9,6000238,665116,6665354,1,9,1,5335122,Out > In
Sept 2020,208,125,178106,358924890261,7678036882,366602927143,32598,48674,2,351246853379,Out > In
Sept 2020,208,126,57,22406844,416565,22823409,48,57,1,21990279,Out > In
Sept 2020,208,128,74643,30954357754,698802013,31653159767,10830,36246,2,30255555741,Out > In
Sept 2020,208,195,3763,664912169,20951248,685863417,363,3413,2,643960921,Out > In
Sept 2020,208,29,10,44907605,591573,45499178,4,10,1,44316032,Out > In
Sept 2020,208,30,3,592503,17611,610114,3,3,1,574892,Out > In
Sept 2020,208,32,1,104388,13188,117576,1,1,1,91200,Out > In
Sept 2020,208,39,532,116399440,2400657,118800097,128,524,1,113998783,Out > In
Sept 2020,208,44,32040,511343176127,5318068320,516661244447,910,17992,2,506025107807,Out > In
Sept 2020,208,45,72237,70455418179,1041710145,71497128324,2492,24843,2,69413708034,Out > In
Sept 2020,208,47,42,5675216,2335019,8010235,20,42,1,3340197,Out > In
Sept 2020,208,49,171,44452040,3967587,48419627,67,171,1,40484453,Out > In
Sept 2020,208,50,30805,17617791473,5500835878,23118627351,4181,16801,1,12116955595,Out > In
Sept 2020,208,52,2941,917345349,49375245,966720594,318,2792,2,867970104,Out > In
Sept 2020,208,53,244,75539262,1280369,76819631,109,244,2,74258893,Out > In
Sept 2020,208,56,91,18485891,526031,19011922,65,91,1,17959860,Out > In
Sept 2020,208,59,604,218374020,25669195,244043215,66,596,2,192704825,Out > In
Sept 2020,208,64,1,109374,17015,126389,1,1,1,92359,Out > In
Sept 2020,208,71,35,11479700,3618199,15097899,1,35,1,7861501,Out > In
Sept 2020,208,81,24,3973566,111864,4085430,17,24,1,3861702,Out > In
Sept 2020,208,83,42177,15444314160,1171324147,16615638307,7948,23862,2,14272990013,Out > In
Sept 2020,208,85,96,6313570797,990466485,7304037282,2,96,1,5323104312,Out > In
Sept 2020,208,86,5,925517,34064,959581,1,5,1,891453,Out > In
Sept 2020,208,87,4109,723728476,33983963,757712439,1098,3867,2,689744513,Out > In
Sept 2020,208,88,84,15265084,522366,15787450,38,84,2,14742718,Out > In
Sept 2020,208,90,19,2305845,144645,2450490,3,19,1,2161200,Out > In
Sept 2020,208,91,2,320850,165345,486195,1,2,1,155505,Out > In
Sept 2020,208,92,194,124949417,3896500,128845917,35,193,1,121052917,Out > In
Sept 2020,208,93,36,15247177,585540,15832717,10,36,2,14661637,Out > In
Sept 2020,208,96,51950,98536173212,1732629800,100268803012,20061,26302,1,96803543412,Out > In
Sept 2020,209,100,1,78917,36626,115543,1,1,1,42291,Out > In
Sept 2020,209,202,1,163610,89535,253145,1,1,1,74075,Out > In
Sept 2020,209,203,1,2508947,107963,2616910,1,1,1,2400984,Out > In
Sept 2020,209,204,1564,38702662659,963446442,39666109101,15,1490,3,37739216217,Out > In
Sept 2020,209,205,1,181078,106113,287191,1,1,1,74965,Out > In
Sept 2020,209,214,2,627767,195368,823135,1,2,1,432399,Out > In
Sept 2020,21,219,1,5880,429876,435756,1,1,1,423996,In > Out
Sept 2020,21,223,1,53593,54503,108096,1,1,1,910,In > Out
Sept 2020,210,12,7359,3739138717587,1286127189699,5025265907286,2470,6140,1,2453011527888,Out > In
Sept 2020,210,4,1501,846515458792,221583750716,1068099209508,560,1448,1,624931708076,Out > In
Sept 2020,212,16,3,438254,14080,452334,3,3,1,424174,Out > In
Sept 2020,212,21,22,10515779,408155,10923934,4,22,1,10107624,Out > In
Sept 2020,212,22,1,208026,3860,211886,1,1,1,204166,Out > In
Sept 2020,212,24,3,329795,37879,367674,1,3,1,291916,Out > In
Sept 2020,212,25,391,1834667820,106757098,1941424918,29,389,1,1727910722,Out > In
Sept 2020,212,26,4708,20618935667,231556637,20850492304,1585,4402,1,20387379030,Out > In
Sept 2020,212,27,840,1132982400,19744228,1152726628,388,818,1,1113238172,Out > In
Sept 2020,212,31,153,249202484,57109062,306311546,43,152,2,192093422,Out > In
Sept 2020,213,1,46,1253779997,2446984479,3700764476,32,28,38,1193204482,In > Out
Sept 2020,213,10,47,4538955060,5985803163,10524758223,38,27,36,1446848103,In > Out
Sept 2020,213,100,49,1695122160,3153964823,4849086983,31,19,44,1458842663,In > Out
Sept 2020,213,101,110,2134877303,2772637130,4907514433,99,90,107,637759827,In > Out
Sept 2020,213,102,97,4366689687,7123890855,11490580542,61,67,88,2757201168,In > Out
Sept 2020,213,103,34,2707922480,2556624362,5264546842,29,17,28,151298118,Out > In
Sept 2020,213,104,54,10035779251,12787971501,22823750752,43,30,51,2752192250,In > Out
Sept 2020,213,105,96,6901460587,12814615419,19716076006,67,52,91,5913154832,In > Out
Sept 2020,213,106,44,1169934723,2539531358,3709466081,37,19,43,1369596635,In > Out
Sept 2020,213,107,114,5029305372,14944021722,19973327094,71,65,105,9914716350,In > Out
Sept 2020,213,108,65,5481969621,4575474836,10057444457,48,35,58,906494785,Out > In
Sept 2020,213,109,60,3402310697,5625571290,9027881987,46,22,53,2223260593,In > Out
Sept 2020,213,11,340,2999842291,4530458777,7530301068,229,319,331,1530616486,In > Out
Sept 2020,213,110,107,4758385981,5528351253,10286737234,87,71,62,769965272,In > Out
Sept 2020,213,111,45,864460225,2516336608,3380796833,36,22,42,1651876383,In > Out
Sept 2020,213,112,52,3522965149,4172807574,7695772723,34,27,49,649842425,In > Out
Sept 2020,213,113,37,1423924518,1703160694,3127085212,30,18,31,279236176,In > Out
Sept 2020,213,114,50,1729989648,3164953592,4894943240,43,19,44,1434963944,In > Out
Sept 2020,213,115,60,1738321620,3018760841,4757082461,54,35,52,1280439221,In > Out
Sept 2020,213,116,52,227517875,576570427,804088302,27,30,48,349052552,In > Out
Sept 2020,213,117,95,5375342912,6529767526,11905110438,63,41,72,1154424614,In > Out
Sept 2020,213,118,70,1857097909,4463354119,6320452028,48,24,66,2606256210,In > Out
Sept 2020,213,119,66,5529006628,12847708866,18376715494,45,24,61,7318702238,In > Out
Sept 2020,213,12,29,3421023111,5260833733,8681856844,26,23,25,1839810622,In > Out
Sept 2020,213,120,63,7035540767,9742841250,16778382017,52,33,55,2707300483,In > Out
Sept 2020,213,121,298,6714357754,14579083195,21293440949,276,212,74,7864725441,In > Out
Sept 2020,213,122,42,5277646641,5462726433,10740373074,32,15,35,185079792,In > Out
Sept 2020,213,123,116,6672376454,7079552660,13751929114,110,98,50,407176206,In > Out
Sept 2020,213,124,76,4085947448,6112350900,10198298348,50,41,67,2026403452,In > Out
Sept 2020,213,125,46,2382396167,3119693456,5502089623,29,22,44,737297289,In > Out
Sept 2020,213,126,53,2399625596,3178690180,5578315776,40,30,34,779064584,In > Out
Sept 2020,213,127,71,5096337477,2689140524,7785478001,40,40,59,2407196953,Out > In
Sept 2020,213,128,51,1282372854,2759993116,4042365970,35,28,41,1477620262,In > Out
Sept 2020,213,129,48,2323834597,2886387325,5210221922,37,25,36,562552728,In > Out
Sept 2020,213,13,59,2180054635,3668450255,5848504890,39,26,41,1488395620,In > Out
Sept 2020,213,130,75,1375274368,2584990381,3960264749,65,57,74,1209716013,In > Out
Sept 2020,213,131,44,4174919727,9233564070,13408483797,34,18,41,5058644343,In > Out
Sept 2020,213,132,60,18331936701,22381094413,40713031114,53,25,51,4049157712,In > Out
Sept 2020,213,133,97,5892482145,10393114056,16285596201,75,48,85,4500631911,In > Out
Sept 2020,213,134,102,7503684750,13090392048,20594076798,85,67,50,5586707298,In > Out
Sept 2020,213,135,48,1484398056,3811404899,5295802955,39,29,47,2327006843,In > Out
Sept 2020,213,136,44,2560439456,3522120115,6082559571,29,23,42,961680659,In > Out
Sept 2020,213,137,89,6946115479,11338443946,18284559425,77,61,86,4392328467,In > Out
Sept 2020,213,138,67,11530132437,14234578580,25764711017,51,23,56,2704446143,In > Out
Sept 2020,213,139,51,6450732259,15487873038,21938605297,40,30,40,9037140779,In > Out
Sept 2020,213,14,65,21330942611,76362275697,97693218308,41,33,59,55031333086,In > Out
Sept 2020,213,140,70,4074415164,5527842994,9602258158,53,37,55,1453427830,In > Out
Sept 2020,213,141,95,5723467531,6313013752,12036481283,69,31,42,589546221,In > Out
Sept 2020,213,142,77,1822886755,4973694058,6796580813,41,51,41,3150807303,In > Out
Sept 2020,213,143,67,4961152551,5633276817,10594429368,46,29,58,672124266,In > Out
Sept 2020,213,144,143,2518533232,4320642853,6839176085,119,118,140,1802109621,In > Out
Sept 2020,213,145,251,4993023288,10270198668,15263221956,227,216,237,5277175380,In > Out
Sept 2020,213,146,70,3935471141,27892384053,31827855194,55,35,60,23956912912,In > Out
Sept 2020,213,147,54,3903461437,4093751231,7997212668,44,31,34,190289794,In > Out
Sept 2020,213,148,55,4201623128,5510348632,9711971760,42,18,49,1308725504,In > Out
Sept 2020,213,149,74,9458160405,11579274087,21037434492,62,37,65,2121113682,In > Out
Sept 2020,213,15,43,4624712428,5143922769,9768635197,36,22,39,519210341,In > Out
Sept 2020,213,150,62,2515194581,3911432183,6426626764,53,30,57,1396237602,In > Out
Sept 2020,213,151,46,7379032672,7849852617,15228885289,39,20,43,470819945,In > Out
Sept 2020,213,152,875,11230181902,33863327570,45093509472,812,806,63,22633145668,In > Out
Sept 2020,213,153,73,4155071017,4428613699,8583684716,51,37,65,273542682,In > Out
Sept 2020,213,154,140,4095870384,9297767651,13393638035,109,84,129,5201897267,In > Out
Sept 2020,213,155,87,3186555133,5819140775,9005695908,66,39,81,2632585642,In > Out
Sept 2020,213,156,55,8939561663,10910513834,19850075497,45,27,52,1970952171,In > Out
Sept 2020,213,157,36,1794469406,4005709849,5800179255,28,17,32,2211240443,In > Out
Sept 2020,213,158,143,3605621956,4584238040,8189859996,65,123,140,978616084,In > Out
Sept 2020,213,159,67,1533871459,7004801164,8538672623,49,16,63,5470929705,In > Out
Sept 2020,213,16,57,2505640558,4032831004,6538471562,43,20,52,1527190446,In > Out
Sept 2020,213,160,75,7022935734,8588173904,15611109638,59,33,62,1565238170,In > Out
Sept 2020,213,161,57,4456123759,6735335397,11191459156,48,27,55,2279211638,In > Out
Sept 2020,213,162,104,1046342114,5547555452,6593897566,51,34,80,4501213338,In > Out
Sept 2020,213,163,39,1257582157,1811497107,3069079264,29,17,36,553914950,In > Out
Sept 2020,213,164,40,3432157927,4300952306,7733110233,32,20,35,868794379,In > Out
Sept 2020,213,165,105,6830568963,8265228490,15095797453,63,50,75,1434659527,In > Out
Sept 2020,213,166,144,14228270436,6372836573,20601107009,37,83,102,7855433863,Out > In
Sept 2020,213,167,117,9284258660,8838885865,18123144525,95,89,106,445372795,Out > In
Sept 2020,213,168,84,8902244240,20603491600,29505735840,54,59,58,11701247360,In > Out
Sept 2020,213,169,215,6135751485,8246353311,14382104796,188,180,205,2110601826,In > Out
Sept 2020,213,17,78,3976897143,12471722586,16448619729,54,33,75,8494825443,In > Out
Sept 2020,213,170,111,2853091140,6735356782,9588447922,93,61,60,3882265642,In > Out
Sept 2020,213,171,57,4758912429,7156873315,11915785744,45,18,52,2397960886,In > Out
Sept 2020,213,172,37,2232435876,3991516095,6223951971,31,22,30,1759080219,In > Out
Sept 2020,213,173,67,2432635236,3742094370,6174729606,46,45,64,1309459134,In > Out
Sept 2020,213,174,48,2590374900,4640208499,7230583399,36,22,44,2049833599,In > Out
Sept 2020,213,175,106,3206491268,5804080298,9010571566,79,64,74,2597589030,In > Out
Sept 2020,213,176,109,5236823779,6997776854,12234600633,97,79,79,1760953075,In > Out
Sept 2020,213,177,34,1502296483,2041622885,3543919368,30,17,31,539326402,In > Out
Sept 2020,213,178,46,7993639860,8410327843,16403967703,38,15,42,416687983,In > Out
Sept 2020,213,179,67,9194527116,4952981631,14147508747,39,49,48,4241545485,Out > In
Sept 2020,213,18,43,2167045200,6801432488,8968477688,34,18,36,4634387288,In > Out
Sept 2020,213,180,61,1412865180,3508027994,4920893174,48,41,56,2095162814,In > Out
Sept 2020,213,181,160,5803690687,9240928498,15044619185,143,130,149,3437237811,In > Out
Sept 2020,213,182,140,1913906631,3545670472,5459577103,119,107,68,1631763841,In > Out
Sept 2020,213,183,160,5402135745,7065553625,12467689370,154,141,155,1663417880,In > Out
Sept 2020,213,184,166,5069546875,4175681190,9245228065,137,147,161,893865685,Out > In
Sept 2020,213,185,135,924765370,2399104493,3323869863,123,108,60,1474339123,In > Out
Sept 2020,213,186,62,1203770798,3808996345,5012767143,45,25,60,2605225547,In > Out
Sept 2020,213,187,38,990026646,2931781007,3921807653,30,21,38,1941754361,In > Out
Sept 2020,213,188,95,5430726224,8404048167,13834774391,74,49,74,2973321943,In > Out
Sept 2020,213,189,61,1029709457,3210339995,4240049452,34,23,52,2180630538,In > Out
Sept 2020,213,19,62,3104606784,4991840818,8096447602,51,45,59,1887234034,In > Out
Sept 2020,213,190,67,3329924552,3257049406,6586973958,59,37,45,72875146,Out > In
Sept 2020,213,191,85,4789816327,8820460130,13610276457,65,44,80,4030643803,In > Out
Sept 2020,213,192,60,1326195693,2737922538,4064118231,33,33,48,1411726845,In > Out
Sept 2020,213,193,259,3303601197,5208780940,8512382137,234,235,254,1905179743,In > Out
Sept 2020,213,194,64,3125888099,6090974631,9216862730,44,14,53,2965086532,In > Out
Sept 2020,213,195,32,5112140041,3788802945,8900942986,28,19,30,1323337096,Out > In
Sept 2020,213,196,55,7133405233,5747395870,12880801103,40,32,52,1386009363,Out > In
Sept 2020,213,197,37,7008752114,10119599637,17128351751,27,13,33,3110847523,In > Out
Sept 2020,213,198,44,4439882095,2607502518,7047384613,37,25,37,1832379577,Out > In
Sept 2020,213,199,61,8497729349,10705445876,19203175225,45,19,51,2207716527,In > Out
Sept 2020,213,2,73,5261633774,6402209154,11663842928,60,46,54,1140575380,In > Out
Sept 2020,213,20,61,2244317086,3685374314,5929691400,46,34,53,1441057228,In > Out
Sept 2020,213,200,75,8808998211,8289839330,17098837541,61,37,59,519158881,Out > In
Sept 2020,213,201,32,2145311260,4639131417,6784442677,24,6,30,2493820157,In > Out
Sept 2020,213,202,32,660688859,1508622289,2169311148,27,18,30,847933430,In > Out
Sept 2020,213,203,40,2408872489,3573003983,5981876472,34,24,37,1164131494,In > Out
Sept 2020,213,204,55,3349890883,3957370950,7307261833,44,22,50,607480067,In > Out
Sept 2020,213,205,81,840834182,2408682561,3249516743,67,53,54,1567848379,In > Out
Sept 2020,213,206,33,495067867,1075548821,1570616688,25,21,31,580480954,In > Out
Sept 2020,213,207,42,754960572,2387006527,3141967099,24,27,26,1632045955,In > Out
Sept 2020,213,208,49,3836832485,6309473325,10146305810,36,23,44,2472640840,In > Out
Sept 2020,213,209,96,2082431410,4618524581,6700955991,79,46,93,2536093171,In > Out
Sept 2020,213,21,70,9018468576,10584861941,19603330517,59,37,39,1566393365,In > Out
Sept 2020,213,210,32,2151476577,2320603674,4472080251,25,20,27,169127097,In > Out
Sept 2020,213,211,29,4879339608,7256359654,12135699262,20,11,28,2377020046,In > Out
Sept 2020,213,212,34,3993009113,6602081812,10595090925,24,14,33,2609072699,In > Out
Sept 2020,213,213,19,1402163260,5912910776,7315074036,15,6,16,4510747516,In > Out
Sept 2020,213,214,27,9306343255,10353852069,19660195324,21,13,25,1047508814,In > Out
Sept 2020,213,215,119,5373295639,6398231517,11771527156,93,77,58,1024935878,In > Out
Sept 2020,213,216,98,6347322848,7642858368,13990181216,68,46,95,1295535520,In > Out
Sept 2020,213,217,133,2581893535,3653682649,6235576184,123,113,50,1071789114,In > Out
Sept 2020,213,218,67,2216248851,6878233473,9094482324,43,32,64,4661984622,In > Out
Sept 2020,213,219,35,7470118290,7893392720,15363511010,30,13,30,423274430,In > Out
Sept 2020,213,22,29,557077899,1246730278,1803808177,26,20,25,689652379,In > Out
Sept 2020,213,220,57,7973951169,7793292650,15767243819,46,38,54,180658519,Out > In
Sept 2020,213,221,65,2563485873,4803142248,7366628121,38,29,41,2239656375,In > Out
Sept 2020,213,222,58,7019731907,7895756623,14915488530,34,23,38,876024716,In > Out
Sept 2020,213,223,161,817945257,3708803049,4526748306,146,105,117,2890857792,In > Out
Sept 2020,213,224,61,2974462989,4823113724,7797576713,38,22,48,1848650735,In > Out
Sept 2020,213,225,39,843665916,2076019972,2919685888,28,16,39,1232354056,In > Out
Sept 2020,213,226,56,13924295068,17163620018,31087915086,38,20,52,3239324950,In > Out
Sept 2020,213,227,38,4472828630,5164870744,9637699374,28,16,36,692042114,In > Out
Sept 2020,213,228,399,4603004535,9652423912,14255428447,111,365,377,5049419377,In > Out
Sept 2020,213,229,55,3677757698,7523436097,11201193795,37,34,43,3845678399,In > Out
Sept 2020,213,23,110,7688478296,8634973915,16323452211,59,57,83,946495619,In > Out
Sept 2020,213,230,48,3384769629,4537289454,7922059083,33,21,43,1152519825,In > Out
Sept 2020,213,231,24,745642880,1708284798,2453927678,20,14,24,962641918,In > Out
Sept 2020,213,232,68,4791453394,7078144239,11869597633,52,48,65,2286690845,In > Out
Sept 2020,213,233,34,2948619402,3775883141,6724502543,27,14,31,827263739,In > Out
Sept 2020,213,234,172,3473856034,4299675985,7773532019,163,153,35,825819951,In > Out
Sept 2020,213,235,38,1298856864,2579237881,3878094745,33,24,36,1280381017,In > Out
Sept 2020,213,236,42,4411804970,7148567322,11560372292,30,17,40,2736762352,In > Out
Sept 2020,213,237,41,4997339492,5667761619,10665101111,35,17,32,670422127,In > Out
Sept 2020,213,238,90,6945608667,13253430738,20199039405,68,39,62,6307822071,In > Out
Sept 2020,213,239,114,1248957560,1810201981,3059159541,37,92,111,561244421,In > Out
Sept 2020,213,24,91,4485601547,15576623572,20062225119,80,63,85,11091022025,In > Out
Sept 2020,213,240,52,2315618498,3075889902,5391508400,42,30,51,760271404,In > Out
Sept 2020,213,241,68,10171492816,11273575617,21445068433,39,26,59,1102082801,In > Out
Sept 2020,213,242,68,9920320409,9858532384,19778852793,43,36,61,61788025,Out > In
Sept 2020,213,243,65,2215860722,3158871693,5374732415,43,36,60,943010971,In > Out
Sept 2020,213,244,34,6463643092,5560097630,12023740722,27,16,30,903545462,Out > In
Sept 2020,213,245,50,4491509174,6531331090,11022840264,38,19,47,2039821916,In > Out
Sept 2020,213,246,150,4978570364,10717750115,15696320479,135,108,114,5739179751,In > Out
Sept 2020,213,247,94,2883646333,5384639952,8268286285,47,63,49,2500993619,In > Out
Sept 2020,213,248,117,5691908447,8925505901,14617414348,110,98,113,3233597454,In > Out
Sept 2020,213,249,56,3429315194,3956630064,7385945258,42,34,41,527314870,In > Out
Sept 2020,213,25,43,2724090355,6930962114,9655052469,28,26,33,4206871759,In > Out
Sept 2020,213,250,75,3836753640,7602856419,11439610059,63,37,74,3766102779,In > Out
Sept 2020,213,251,40,4359019645,5604999344,9964018989,29,23,36,1245979699,In > Out
Sept 2020,213,252,436,6294804566,6944859960,13239664526,370,90,102,650055394,In > Out
Sept 2020,213,253,68,5419279166,5466554625,10885833791,58,43,35,47275459,In > Out
Sept 2020,213,254,61,9241708561,8422459943,17664168504,41,33,51,819248618,Out > In
Sept 2020,213,26,209,8190065523,7577056966,15767122489,187,178,195,613008557,Out > In
Sept 2020,213,27,95,6802666400,13622629245,20425295645,74,41,64,6819962845,In > Out
Sept 2020,213,28,926,3872274880,11833304641,15705579521,303,339,267,7961029761,In > Out
Sept 2020,213,29,94,6766774330,8468059468,15234833798,62,41,65,1701285138,In > Out
Sept 2020,213,3,208,4401174608,5333211424,9734386032,176,183,196,932036816,In > Out
Sept 2020,213,30,42,1842149722,6478112141,8320261863,32,14,37,4635962419,In > Out
Sept 2020,213,31,390,3690211596,8561792887,12252004483,298,353,383,4871581291,In > Out
Sept 2020,213,32,60,2319991830,3679321661,5999313491,43,27,56,1359329831,In > Out
Sept 2020,213,33,164,8513548186,12205561185,20719109371,149,133,56,3692012999,In > Out
Sept 2020,213,34,66,4849094706,7005991061,11855085767,45,27,58,2156896355,In > Out
Sept 2020,213,35,166,2509447759,3962258111,6471705870,125,41,48,1452810352,In > Out
Sept 2020,213,36,92,6407203881,7055616005,13462819886,73,47,61,648412124,In > Out
Sept 2020,213,37,39,11127082104,4142330738,15269412842,34,14,35,6984751366,Out > In
Sept 2020,213,38,70,2187329071,4205512355,6392841426,53,37,67,2018183284,In > Out
Sept 2020,213,39,72,6713114081,9212123434,15925237515,53,31,63,2499009353,In > Out
Sept 2020,213,4,80,1273537522,3789007490,5062545012,73,62,72,2515469968,In > Out
Sept 2020,213,40,43,1575707176,3142130787,4717837963,37,10,40,1566423611,In > Out
Sept 2020,213,41,64,1189051614,3349576953,4538628567,50,36,59,2160525339,In > Out
Sept 2020,213,42,96,29980927762,8713055466,38693983228,67,37,85,21267872296,Out > In
Sept 2020,213,43,90,1496837113,3039983373,4536820486,70,46,70,1543146260,In > Out
Sept 2020,213,44,1080,6868883185,24219393436,31088276621,144,970,1023,17350510251,In > Out
Sept 2020,213,45,58,9630451296,11886003559,21516454855,47,29,51,2255552263,In > Out
Sept 2020,213,46,74,3019705281,3929230194,6948935475,52,37,64,909524913,In > Out
Sept 2020,213,47,78,1192916461,7712681664,8905598125,53,33,77,6519765203,In > Out
Sept 2020,213,48,42,2182405471,3923032892,6105438363,34,13,39,1740627421,In > Out
Sept 2020,213,49,65,10629044015,13785694460,24414738475,39,45,55,3156650445,In > Out
Sept 2020,213,5,71,2301917619,4230016302,6531933921,51,41,63,1928098683,In > Out
Sept 2020,213,50,64,3829957772,7423834438,11253792210,50,27,61,3593876666,In > Out
Sept 2020,213,51,73,4810905143,6581135375,11392040518,45,43,66,1770230232,In > Out
Sept 2020,213,52,59,1731016700,4515382524,6246399224,40,24,56,2784365824,In > Out
Sept 2020,213,53,43,2732787307,4335592907,7068380214,35,27,35,1602805600,In > Out
Sept 2020,213,54,66,4696372300,9475707491,14172079791,55,32,50,4779335191,In > Out
Sept 2020,213,55,68,3517452002,5024807085,8542259087,47,43,62,1507355083,In > Out
Sept 2020,213,56,91,4850519383,8500924762,13351444145,66,41,72,3650405379,In > Out
Sept 2020,213,57,115,12259326749,14810031428,27069358177,88,76,78,2550704679,In > Out
Sept 2020,213,58,57,1744195172,3371353534,5115548706,43,22,52,1627158362,In > Out
Sept 2020,213,59,155,6533266510,13996671593,20529938103,66,59,66,7463405083,In > Out
Sept 2020,213,6,358,4459129838,7975600076,12434729914,288,335,346,3516470238,In > Out
Sept 2020,213,60,100,3030932856,6413329738,9444262594,54,41,68,3382396882,In > Out
Sept 2020,213,61,71,1084734711,3200459520,4285194231,48,41,53,2115724809,In > Out
Sept 2020,213,62,74,6418408152,7241747825,13660155977,56,46,65,823339673,In > Out
Sept 2020,213,63,57,1146517742,3457448581,4603966323,36,21,50,2310930839,In > Out
Sept 2020,213,64,166,8594619603,14786910821,23381530424,151,120,157,6192291218,In > Out
Sept 2020,213,65,435,13790020878,15645547280,29435568158,379,412,81,1855526402,In > Out
Sept 2020,213,66,66,20999271573,18046728038,39045999611,44,41,58,2952543535,Out > In
Sept 2020,213,67,73,5188901074,7760517039,12949418113,50,35,60,2571615965,In > Out
Sept 2020,213,68,181,9037901056,12653564925,21691465981,154,145,177,3615663869,In > Out
Sept 2020,213,69,95,25073299363,18397174638,43470474001,66,56,86,6676124725,Out > In
Sept 2020,213,7,70,1743916568,6352786570,8096703138,43,27,47,4608870002,In > Out
Sept 2020,213,70,74,8561448936,9401032473,17962481409,52,33,66,839583537,In > Out
Sept 2020,213,71,61,5186917584,6464446578,11651364162,40,26,48,1277528994,In > Out
Sept 2020,213,72,77,3748701101,5541349720,9290050821,45,43,66,1792648619,In > Out
Sept 2020,213,73,105,5262201691,12466004799,17728206490,77,55,97,7203803108,In > Out
Sept 2020,213,74,139,9180376817,11628300530,20808677347,45,31,124,2447923713,In > Out
Sept 2020,213,75,68,1364853043,2247183203,3612036246,56,38,66,882330160,In > Out
Sept 2020,213,76,64,5632931738,8616900295,14249832033,45,13,60,2983968557,In > Out
Sept 2020,213,77,71,5293257816,8965589440,14258847256,53,34,55,3672331624,In > Out
Sept 2020,213,78,48,4676417458,8041655980,12718073438,40,22,38,3365238522,In > Out
Sept 2020,213,79,47,2411025255,4362431063,6773456318,39,23,38,1951405808,In > Out
Sept 2020,213,8,56,5144484331,8320481946,13464966277,41,23,46,3175997615,In > Out
Sept 2020,213,80,49,1491847039,4700766307,6192613346,40,18,46,3208919268,In > Out
Sept 2020,213,81,49,2311299789,2937331497,5248631286,38,23,43,626031708,In > Out
Sept 2020,213,82,209,7893876236,14870833747,22764709983,194,173,208,6976957511,In > Out
Sept 2020,213,83,43,2057482029,3725701976,5783184005,34,13,38,1668219947,In > Out
Sept 2020,213,84,60,3232611630,4700532305,7933143935,46,33,55,1467920675,In > Out
Sept 2020,213,85,132,6855461543,11517775818,18373237361,87,53,109,4662314275,In > Out
Sept 2020,213,86,96,9028547228,10490943458,19519490686,71,69,88,1462396230,In > Out
Sept 2020,213,87,79,2937327452,6777502715,9714830167,50,31,75,3840175263,In > Out
Sept 2020,213,88,264,5447792886,7240032399,12687825285,234,235,246,1792239513,In > Out
Sept 2020,213,89,78,6401794581,8655627435,15057422016,63,47,76,2253832854,In > Out
Sept 2020,213,9,64,7514566462,12415482836,19930049298,39,16,54,4900916374,In > Out
Sept 2020,213,90,50,1425500009,2668489728,4093989737,41,32,45,1242989719,In > Out
Sept 2020,213,91,93,12364252334,9849063245,22213315579,75,48,85,2515189089,Out > In
Sept 2020,213,92,76,4274381280,5771694687,10046075967,57,29,74,1497313407,In > Out
Sept 2020,213,93,40,9462795461,15782190413,25244985874,33,21,36,6319394952,In > Out
Sept 2020,213,94,298,4506609498,3538639584,8045249082,227,81,30,967969914,Out > In
Sept 2020,213,95,53,3018863123,4155811012,7174674135,43,23,48,1136947889,In > Out
Sept 2020,213,96,51,5738250640,11005629643,16743880283,40,21,48,5267379003,In > Out
Sept 2020,213,97,87,3664887585,8873039857,12537927442,71,57,83,5208152272,In > Out
Sept 2020,213,98,123,862103881,2625310308,3487414189,52,34,117,1763206427,In > Out
Sept 2020,213,99,59,1645416407,2936003407,4581419814,38,28,49,1290587000,In > Out
Sept 2020,215,113,13619,138099187904,6896737802,144995925706,7964,4820,1,131202450102,Out > In
Sept 2020,215,189,1,117345,3312,120657,1,1,1,114033,Out > In
Sept 2020,215,215,12,51740273,44461060,96201333,7,3,12,7279213,Out > In
Sept 2020,215,216,19,144129,2788990,2933119,19,19,1,2644861,In > Out
Sept 2020,215,55,19,57874857,3075614,60950471,5,19,1,54799243,Out > In
Sept 2020,215,85,1,45472,1468115,1513587,1,1,1,1422643,In > Out
Sept 2020,215,94,1,16552,224378,240930,1,1,1,207826,In > Out
Sept 2020,215,97,1,45344,1423674,1469018,1,1,1,1378330,In > Out
Sept 2020,220,32,19,156333952,1008572,157342524,8,19,1,155325380,Out > In
Sept 2020,221,144,1,2727,315967,318694,1,1,1,313240,In > Out
Sept 2020,221,162,231,17692678,48100394,65793072,9,227,2,30407716,In > Out
Sept 2020,221,168,8,287031439,632548239,919579678,7,1,8,345516800,In > Out
Sept 2020,221,185,1,1677556,2110152,3787708,1,1,1,432596,In > Out
Sept 2020,221,193,5378,135067402656,6580812504,141648215160,1304,4020,1,128486590152,Out > In
Sept 2020,221,198,4276,12223040090,1202906236,13425946326,1376,3971,2,11020133854,Out > In
Sept 2020,221,25,5503,136639517738,6315668690,142955186428,1386,3987,1,130323849048,Out > In
Sept 2020,221,57,1,8456,107644,116100,1,1,1,99188,In > Out
Sept 2020,221,62,310,55887860,54144264,110032124,61,278,2,1743596,Out > In
Sept 2020,221,97,7,293367929,153752253,447120182,7,6,7,139615676,Out > In
Sept 2020,222,226,7,3124823,500108,3624931,1,7,1,2624715,Out > In
Sept 2020,224,201,1,75812241,153325334,229137575,1,1,1,77513093,In > Out
Sept 2020,224,221,4,288847379,1047522246,1336369625,2,3,4,758674867,In > Out
Sept 2020,225,149,3,134260788,5230914,139491702,3,1,3,129029874,Out > In
Sept 2020,225,158,63,386024480,566619890,952644370,29,1,63,180595410,In > Out
Sept 2020,225,170,354,48784224,29718005,78502229,256,349,1,19066219,Out > In
Sept 2020,225,210,118,88619145,7104183,95723328,4,118,1,81514962,Out > In
Sept 2020,225,218,171,345718055,15597001,361315056,116,154,3,330121054,Out > In
Sept 2020,225,224,1,2360,113000,115360,1,1,1,110640,In > Out
Sept 2020,225,8,34,405220167,64095976,469316143,5,34,10,341124191,Out > In
Sept 2020,228,104,1,390216,115309,505525,1,1,1,274907,Out > In
Sept 2020,228,105,1,165176,184468,349644,1,1,1,19292,In > Out
Sept 2020,228,11,2,180421854,251469296,431891150,2,2,2,71047442,In > Out
Sept 2020,228,110,13,53077341,190413992,243491333,7,4,13,137336651,In > Out
Sept 2020,228,113,4,122426735,343533124,465959859,4,2,4,221106389,In > Out
Sept 2020,228,116,4,245913353,307209865,553123218,4,3,4,61296512,In > Out
Sept 2020,228,119,15,16896314,17618872,34515186,8,15,14,722558,In > Out
Sept 2020,228,12,4,737685,261576391,262314076,2,3,4,260838706,In > Out
Sept 2020,228,132,1,8152147,6364178,14516325,1,1,1,1787969,Out > In
Sept 2020,228,14,2,103488439,99377036,202865475,2,2,1,4111403,Out > In
Sept 2020,228,140,1,153460,227283,380743,1,1,1,73823,In > Out
Sept 2020,228,146,1,437346,1300199,1737545,1,1,1,862853,In > Out
Sept 2020,228,153,8,517349007,300580755,817929762,4,6,6,216768252,Out > In
Sept 2020,228,154,6,281841894,515111420,796953314,5,4,6,233269526,In > Out
Sept 2020,228,16,1,24291,128145,152436,1,1,1,103854,In > Out
Sept 2020,228,160,4,167025901,255420309,422446210,3,2,4,88394408,In > Out
Sept 2020,228,168,5,296773911,272651096,569425007,3,4,2,24122815,Out > In
Sept 2020,228,171,1,767726302,547525573,1315251875,1,1,1,220200729,Out > In
Sept 2020,228,175,1,38061623,820441201,858502824,1,1,1,782379578,In > Out
Sept 2020,228,178,1,35921,44736269,44772190,1,1,1,44700348,In > Out
Sept 2020,228,18,141,65673282,1227291976,1292965258,130,127,2,1161618694,In > Out
Sept 2020,228,183,118,5118465,175781278,180899743,106,108,18,170662813,In > Out
Sept 2020,228,184,2,1274823722,1146458314,2421282036,1,2,2,128365408,Out > In
Sept 2020,228,187,2,394440777,414803054,809243831,1,1,1,20362277,In > Out
Sept 2020,228,191,17,297776,10683968,10981744,17,17,2,10386192,In > Out
Sept 2020,228,195,6,16422417,781603089,798025506,2,1,6,765180672,In > Out
Sept 2020,228,196,3,312660882,644492585,957153467,3,2,3,331831703,In > Out
Sept 2020,228,198,1,37320,257678,294998,1,1,1,220358,In > Out
Sept 2020,228,199,2,20322582,11514958,31837540,1,2,2,8807624,Out > In
Sept 2020,228,200,5,8702695,273885699,282588394,3,1,5,265183004,In > Out
Sept 2020,228,204,4,23952208,20209576,44161784,2,4,4,3742632,Out > In
Sept 2020,228,208,76,256134677,2669101188,2925235865,70,71,2,2412966511,In > Out
Sept 2020,228,209,1,90874,93151,184025,1,1,1,2277,In > Out
Sept 2020,228,21,5,387131511,560931748,948063259,3,2,5,173800237,In > Out
Sept 2020,228,210,3,812347433,590556595,1402904028,3,3,2,221790838,Out > In
Sept 2020,228,211,1,7663,96670,104333,1,1,1,89007,In > Out
Sept 2020,228,212,3,161166878,187450121,348616999,3,2,1,26283243,In > Out
Sept 2020,228,214,3,485243339,407473379,892716718,3,3,2,77769960,Out > In
Sept 2020,228,221,1,55107605,21495379,76602984,1,1,1,33612226,Out > In
Sept 2020,228,24,2,157416021,424656603,582072624,1,1,2,267240582,In > Out
Sept 2020,228,30,2,546874,1259699,1806573,2,2,2,712825,In > Out
Sept 2020,228,32,6,2439707437,2167043137,4606750574,4,4,3,272664300,Out > In
Sept 2020,228,37,2,21626168,31018854,52645022,2,2,2,9392686,In > Out
Sept 2020,228,38,3,3351044,248049535,251400579,2,2,3,244698491,In > Out
Sept 2020,228,41,3,143146194,98709295,241855489,3,3,1,44436899,Out > In
Sept 2020,228,48,6,7832115,506342763,514174878,5,3,6,498510648,In > Out
Sept 2020,228,53,3,140617057,221845969,362463026,2,2,3,81228912,In > Out
Sept 2020,228,58,10,63190592,230156719,293347311,7,10,10,166966127,In > Out
Sept 2020,228,61,1,2402445,220439805,222842250,1,1,1,218037360,In > Out
Sept 2020,228,62,1,2686024,88906313,91592337,1,1,1,86220289,In > Out
Sept 2020,228,65,1,21090862,27575233,48666095,1,1,1,6484371,In > Out
Sept 2020,228,70,2,4167790,30848279,35016069,2,2,2,26680489,In > Out
Sept 2020,228,72,1,46431672,46329776,92761448,1,1,1,101896,Out > In
Sept 2020,228,74,3,480372,206192,686564,2,2,3,274180,Out > In
Sept 2020,228,79,2,10328361,54967529,65295890,1,1,2,44639168,In > Out
Sept 2020,228,8,4,129428550,392285289,521713839,2,1,4,262856739,In > Out
Sept 2020,228,82,4,1280076085,1163028171,2443104256,4,4,3,117047914,Out > In
Sept 2020,228,85,2,539480126,351344886,890825012,2,2,2,188135240,Out > In
Sept 2020,228,9,3,86720493,48480628,135201121,3,3,3,38239865,Out > In
Sept 2020,228,92,1,68794,40247,109041,1,1,1,28547,Out > In
Sept 2020,229,104,3,1956738,1764140,3720878,2,2,3,192598,Out > In
Sept 2020,229,109,9,929286427,851224383,1780510810,6,8,6,78062044,Out > In
Sept 2020,229,11,1,220251705,667294379,887546084,1,1,1,447042674,In > Out
Sept 2020,229,111,1,526418,245821,772239,1,1,1,280597,Out > In
Sept 2020,229,119,1,509336,1111976,1621312,1,1,1,602640,In > Out
Sept 2020,229,120,4,4469249,238064876,242534125,2,1,4,233595627,In > Out
Sept 2020,229,122,2,134051,112227079,112361130,2,2,2,112093028,In > Out
Sept 2020,229,124,38,43242289,3308486,46550775,29,25,1,39933803,Out > In
Sept 2020,229,125,1,936372378,910707591,1847079969,1,1,1,25664787,Out > In
Sept 2020,229,127,2,5916540,358097029,364013569,1,1,2,352180489,In > Out
Sept 2020,229,129,6,1831657,83265295,85096952,3,1,6,81433638,In > Out
Sept 2020,229,130,1,722428,724268,1446696,1,1,1,1840,In > Out
Sept 2020,229,136,1,75849,83143,158992,1,1,1,7294,In > Out
Sept 2020,229,137,2,28879493,34800964,63680457,1,1,2,5921471,In > Out
Sept 2020,229,138,2,117063,819302,936365,2,1,2,702239,In > Out
Sept 2020,229,14,1,34540630,18848088,53388718,1,1,1,15692542,Out > In
Sept 2020,229,143,1,76451429,74549283,151000712,1,1,1,1902146,Out > In
Sept 2020,229,144,3,6081,348690,354771,3,3,1,342609,In > Out
Sept 2020,229,146,2,1706776,9336700,11043476,2,2,2,7629924,In > Out
Sept 2020,229,148,4,3013947,2508874,5522821,2,4,4,505073,Out > In
Sept 2020,229,151,1,1734632,1892484,3627116,1,1,1,157852,In > Out
Sept 2020,229,155,1,215932811,239375243,455308054,1,1,1,23442432,In > Out
Sept 2020,229,156,4,104827605,104324643,209152248,1,4,4,502962,Out > In
Sept 2020,229,158,5,5737733,6606410,12344143,5,4,5,868677,In > Out
Sept 2020,229,160,2,3593907,1735888,5329795,2,2,1,1858019,Out > In
Sept 2020,229,174,2,1148331,191648846,192797177,1,1,2,190500515,In > Out
Sept 2020,229,177,1,759113,3536045,4295158,1,1,1,2776932,In > Out
Sept 2020,229,182,2,10923253,13583883,24507136,1,2,2,2660630,In > Out
Sept 2020,229,186,13,2438620,5216228,7654848,6,8,2,2777608,In > Out
Sept 2020,229,190,1,42698582,37115751,79814333,1,1,1,5582831,Out > In
Sept 2020,229,191,2,12760117,60256960,73017077,1,1,2,47496843,In > Out
Sept 2020,229,195,8,33888863,410001948,443890811,6,6,8,376113085,In > Out
Sept 2020,229,20,11,198174482,314758191,512932673,8,9,7,116583709,In > Out
Sept 2020,229,200,7,463571,86985157,87448728,6,6,3,86521586,In > Out
Sept 2020,229,210,1,163389024,185817392,349206416,1,1,1,22428368,In > Out
Sept 2020,229,214,3,6189774,106545658,112735432,3,2,3,100355884,In > Out
Sept 2020,229,217,370,724826035,3320393995,4045220030,322,330,13,2595567960,In > Out
Sept 2020,229,219,3,76996869,83773877,160770746,3,3,2,6777008,In > Out
Sept 2020,229,222,2,1913752,132228918,134142670,2,1,2,130315166,In > Out
Sept 2020,229,223,1,21121,28354433,28375554,1,1,1,28333312,In > Out
Sept 2020,229,4,1,9320132,26624028,35944160,1,1,1,17303896,In > Out
Sept 2020,229,42,91,10032897,8893723,18926620,22,32,1,1139174,Out > In
Sept 2020,229,43,7,428031962,520022544,948054506,5,7,7,91990582,In > Out
Sept 2020,229,5,1,31282,277315,308597,1,1,1,246033,In > Out
Sept 2020,229,52,3,3189928,33373936,36563864,2,3,3,30184008,In > Out
Sept 2020,229,54,4,1812608110,1956939218,3769547328,2,1,2,144331108,In > Out
Sept 2020,229,59,3,1459649268,1277992812,2737642080,3,3,3,181656456,Out > In
Sept 2020,229,6,1,2667390,332724775,335392165,1,1,1,330057385,In > Out
Sept 2020,229,62,9,335356063,354007090,689363153,4,7,5,18651027,In > Out
Sept 2020,229,64,1,222103,25811820,26033923,1,1,1,25589717,In > Out
Sept 2020,229,72,3,1352314125,1406021569,2758335694,3,3,2,53707444,In > Out
Sept 2020,229,73,1,616687598,690808128,1307495726,1,1,1,74120530,In > Out
Sept 2020,229,78,3,9333052829,1996099357,11329152186,1,3,3,7336953472,Out > In
Sept 2020,229,8,11,1951834733,2131640173,4083474906,9,10,8,179805440,In > Out
Sept 2020,229,83,8,14954078,77731133,92685211,6,8,8,62777055,In > Out
Sept 2020,229,92,7,1669460306,1133724045,2803184351,6,4,1,535736261,Out > In
Sept 2020,229,93,3,7415483,11206860,18622343,3,3,3,3791377,In > Out
Sept 2020,229,94,2,33518763,24842114,58360877,2,2,1,8676649,Out > In
Sept 2020,229,99,6,4111189,12873138,16984327,5,3,6,8761949,In > Out
Sept 2020,230,171,12,2910062,122163,3032225,4,12,1,2787899,Out > In
Sept 2020,234,116,2,209724975,9414885,219139860,1,2,2,200310090,Out > In
Sept 2020,234,120,3,3086404,19585001,22671405,3,3,3,16498597,In > Out
Sept 2020,234,135,27,4670117221,5864935043,10535052264,23,11,27,1194817822,In > Out
Sept 2020,234,137,1,69643,131145893,131215536,1,1,1,131076250,In > Out
Sept 2020,234,151,4,6530609,6345828,12876437,1,4,4,184781,Out > In
Sept 2020,234,16,1,106174,4551,110725,1,1,1,101623,Out > In
Sept 2020,234,201,21,3271273,1866230,5137503,9,7,2,1405043,Out > In
Sept 2020,234,228,7,12993071,3544274,16537345,1,7,1,9448797,Out > In
Sept 2020,234,23,1,290144,494886,785030,1,1,1,204742,In > Out
Sept 2020,234,56,2,133141821,334754908,467896729,2,1,2,201613087,In > Out
Sept 2020,234,66,1,154700,8748896,8903596,1,1,1,8594196,In > Out
Sept 2020,234,76,2,2276292,110216433,112492725,2,1,2,107940141,In > Out
Sept 2020,235,212,10,4117874,63476,4181350,2,10,2,4054398,Out > In
Sept 2020,235,223,957514,499808669706,15602421448,515411091154,17202,56670,2,484206248258,Out > In
Sept 2020,236,253,2,271864,261544,533408,1,2,2,10320,Out > In
Sept 2020,239,185,1,29944,735376,765320,1,1,1,705432,In > Out
Sept 2020,239,192,1,35632,700100,735732,1,1,1,664468,In > Out
Sept 2020,239,198,1,30672,934420,965092,1,1,1,903748,In > Out
Sept 2020,239,207,16,3850520968,3317457994,7167978962,4,16,10,533062974,Out > In
Sept 2020,242,105,3,2732425,63341,2795766,2,3,1,2669084,Out > In
Sept 2020,242,106,2,2693264,63815,2757079,1,2,1,2629449,Out > In
Sept 2020,242,110,19,11696898,389862,12086760,3,19,1,11307036,Out > In
Sept 2020,242,122,6,7779450,182168,7961618,2,6,1,7597282,Out > In
Sept 2020,242,169,8,5738394,133338,5871732,2,8,1,5605056,Out > In
Sept 2020,242,39,2,1592772,37999,1630771,1,2,1,1554773,Out > In
Sept 2020,242,40,4,3986405,141085,4127490,3,4,1,3845320,Out > In
Sept 2020,242,44,17,593905164,358482349,952387513,11,17,1,235422815,Out > In
Sept 2020,250,204,87,97475330,136846355,234321685,38,4,85,39371025,In > Out
Sept 2020,250,57,1,122761,84858,207619,1,1,1,37903,Out > In
Sept 2020,250,62,2,103065,838311,941376,1,1,2,735246,In > Out
Sept 2020,256,103,6,929810,410230,1340040,3,6,1,519580,Out > In
Sept 2020,256,104,38,18150591,548532,18699123,15,38,1,17602059,Out > In
Sept 2020,256,105,2,337209,168449,505658,1,2,1,168760,Out > In
Sept 2020,256,11,682,1055495041,177416578,1232911619,59,665,5,878078463,Out > In
Sept 2020,256,12,211,56831720,2517041,59348761,84,211,3,54314679,Out > In
Sept 2020,256,15,624,16436570,446279575,462716145,430,624,2,429843005,In > Out
Sept 2020,256,248,180,3820767142,7936311576,11757078718,119,97,148,4115544434,In > Out
Sept 2020,256,249,175,8697319550,11104440661,19801760211,135,90,139,2407121111,In > Out
Sept 2020,256,250,262,7589625783,11721982163,19311607946,194,111,143,4132356380,In > Out
Sept 2020,256,251,185,5283068294,9882074823,15165143117,127,86,140,4599006529,In > Out
Sept 2020,256,252,801,5949148362,11152497407,17101645769,635,195,138,5203349045,In > Out
Sept 2020,256,253,174,3244257931,6452381324,9696639255,134,87,124,3208123393,In > Out
Sept 2020,256,254,144,5351229666,9095002028,14446231694,101,88,118,3743772362,In > Out
Sept 2020,26,2,6,779454,215676,995130,2,6,2,563778,Out > In
Sept 2020,28,129,11,8295848,62595,8358443,2,11,1,8233253,Out > In
Sept 2020,29,19,2,189196578,1411635026,1600831604,1,1,2,1222438448,In > Out
Sept 2020,29,52,162,2644126040,10066083356,12710209396,47,83,19,7421957316,In > Out
Sept 2020,29,67,4,3303635,151494036,154797671,4,2,4,148190401,In > Out
Sept 2020,29,94,1,29228,627396,656624,1,1,1,598168,In > Out
Sept 2020,35,111,8,3881072,190560,4071632,1,8,1,3690512,Out > In
Sept 2020,35,116,1176,423950091,20084961,444035052,316,1159,1,403865130,Out > In
Sept 2020,35,118,1640,633944200,168712465,802656665,157,1560,1,465231735,Out > In
Sept 2020,35,16,12,1593914,444820,2038734,2,3,1,1149094,Out > In
Sept 2020,35,182,722,478547656,12702321,491249977,150,714,2,465845335,Out > In
Sept 2020,35,191,184,49354191,8357846,57712037,73,184,2,40996345,Out > In
Sept 2020,35,192,271,161430143,10038524,171468667,95,268,1,151391619,Out > In
Sept 2020,35,195,41141,23818943349,2152192708,25971136057,2469,25095,2,21666750641,Out > In
Sept 2020,35,202,308,65063235,1994101,67057336,18,305,2,63069134,Out > In
Sept 2020,35,208,9,2298986,259710,2558696,5,9,1,2039276,Out > In
Sept 2020,35,212,2148,8935988816,8403001790,17338990606,423,2028,1,532987026,Out > In
Sept 2020,35,251,24,16962102,380311,17342413,10,24,1,16581791,Out > In
Sept 2020,35,253,3,211566,127095,338661,1,3,1,84471,Out > In
Sept 2020,35,254,1965,39689333694,2502442418,42191776112,124,1839,1,37186891276,Out > In
Sept 2020,35,35,21,3972602,18970199,22942801,5,21,1,14997597,In > Out
Sept 2020,35,58,40,11276858,1564192,12841050,8,40,1,9712666,Out > In
Sept 2020,35,60,491,1313442751,410798787,1724241538,66,485,1,902643964,Out > In
Sept 2020,35,61,72,17146947,3708872,20855819,12,71,1,13438075,Out > In
Sept 2020,35,98,12,2561221,137816,2699037,11,12,1,2423405,Out > In
Sept 2020,37,71,1,99032,4730,103762,1,1,1,94302,Out > In
Sept 2020,37,76,21175,124443892751,3572254836,128016147587,4589,15005,1,120871637915,Out > In
Sept 2020,38,17,10,1361259,457828,1819087,2,10,2,903431,Out > In
Sept 2020,38,18,6,408069,411424,819493,1,6,1,3355,In > Out
Sept 2020,38,19,4,328061,329604,657665,1,4,1,1543,In > Out
Sept 2020,38,20,3,176652,204898,381550,2,3,1,28246,In > Out
Sept 2020,38,21,7,1220838,360430,1581268,2,7,2,860408,Out > In
Sept 2020,38,22,4,310560,308196,618756,1,4,1,2364,Out > In
Sept 2020,38,23,4,306111,309144,615255,1,4,1,3033,In > Out
Sept 2020,38,24,2,121402,122440,243842,1,2,1,1038,In > Out
Sept 2020,38,25,2,142809,145188,287997,1,2,1,2379,In > Out
Sept 2020,38,26,3,198466,196696,395162,1,3,1,1770,Out > In
Sept 2020,38,27,4,229579,230636,460215,1,4,1,1057,In > Out
Sept 2020,38,28,3,284260,283976,568236,1,3,1,284,Out > In
Sept 2020,38,30,5,328812,333404,662216,1,5,1,4592,In > Out
Sept 2020,38,40,23,1092885,2343924,3436809,19,23,2,1251039,In > Out
Sept 2020,38,41,537040,227440118590,88584758514,316024877104,43312,53561,2,138855360076,Out > In
Sept 2020,38,42,11725,6968106347,3671270575,10639376922,1146,8953,2,3296835772,Out > In
Sept 2020,38,43,32296,10670130902,3429671932,14099802834,4883,17075,2,7240458970,Out > In
Sept 2020,38,44,118286,43667043551,9530203257,53197246808,18139,29692,2,34136840294,Out > In
Sept 2020,38,45,18262,28423117835,2973037025,31396154860,2068,12173,2,25450080810,Out > In
Sept 2020,38,46,4,294612,296136,590748,1,4,1,1524,In > Out
Sept 2020,38,47,14,559345,7134582,7693927,3,14,2,6575237,In > Out
Sept 2020,38,48,3,217669,218552,436221,1,3,1,883,In > Out
Sept 2020,38,49,5433,885569220,59763931,945333151,3,4531,2,825805289,Out > In
Sept 2020,38,50,4,244360,244852,489212,1,4,1,492,In > Out
Sept 2020,38,51,3,194671,193808,388479,1,3,1,863,Out > In
Sept 2020,38,52,3,237594,238312,475906,1,3,1,718,In > Out
Sept 2020,38,53,3,227691,228908,456599,1,3,1,1217,In > Out
Sept 2020,38,54,4,285203,285464,570667,1,4,1,261,In > Out
Sept 2020,38,55,10,820720,483386,1304106,4,10,2,337334,Out > In
Sept 2020,38,56,16,1835679,434030,2269709,10,16,1,1401649,Out > In
Sept 2020,4,105,103,25615668,988118,26603786,30,103,2,24627550,Out > In
Sept 2020,4,106,18,3051783,156456,3208239,13,18,2,2895327,Out > In
Sept 2020,4,11,5,271834376,155832628,427667004,2,5,1,116001748,Out > In
Sept 2020,4,112,12,1898015,125634,2023649,3,12,3,1772381,Out > In
Sept 2020,4,15,15,3266305792,87296075,3353601867,4,12,7,3179009717,Out > In
Sept 2020,4,35,2,1299764,12025230,13324994,1,1,2,10725466,In > Out
Sept 2020,43,4,7,6453304,2563920,9017224,5,7,3,3889384,Out > In
Sept 2020,44,211,5,1540712246,1507002285,3047714531,3,5,5,33709961,Out > In
Sept 2020,44,214,29,267583793,11512841273,11780425066,24,14,29,11245257480,In > Out
Sept 2020,46,100,58,1104820414,943506992,2048327406,30,18,4,161313422,Out > In
Sept 2020,46,101,5,1415986,100270,1516256,2,2,5,1315716,Out > In
Sept 2020,46,108,2,2196371,10506225,12702596,1,1,2,8309854,In > Out
Sept 2020,46,109,1,1621459,14213035,15834494,1,1,1,12591576,In > Out
Sept 2020,46,11,19,97060683,910009506,1007070189,14,16,19,812948823,In > Out
Sept 2020,46,114,4,17668665,56667970,74336635,4,1,4,38999305,In > Out
Sept 2020,46,116,3,3758008,103690862,107448870,3,1,3,99932854,In > Out
Sept 2020,46,117,6,20017426,673909190,693926616,3,1,6,653891764,In > Out
Sept 2020,46,122,4,1846475,18258012,20104487,3,3,4,16411537,In > Out
Sept 2020,46,123,3,5865812,47222664,53088476,2,2,3,41356852,In > Out
Sept 2020,46,132,9,118028770,226150178,344178948,8,7,9,108121408,In > Out
Sept 2020,46,133,20,100098212,611033839,711132051,15,2,20,510935627,In > Out
Sept 2020,46,138,2,939765,585186,1524951,2,2,2,354579,Out > In
Sept 2020,46,139,2,67922,200081187,200149109,1,1,2,200013265,In > Out
Sept 2020,46,144,4,74007124,276725628,350732752,2,1,4,202718504,In > Out
Sept 2020,46,146,12,112958307,2088809517,2201767824,10,6,12,1975851210,In > Out
Sept 2020,46,149,1,2145447,29278868,31424315,1,1,1,27133421,In > Out
Sept 2020,46,150,10,658488199,804124102,1462612301,8,7,10,145635903,In > Out
Sept 2020,46,156,1,1661841,70837023,72498864,1,1,1,69175182,In > Out
Sept 2020,46,158,3,7460517,205549242,213009759,1,1,3,198088725,In > Out
Sept 2020,46,167,3,4904191,276922643,281826834,2,1,3,272018452,In > Out
Sept 2020,46,175,1,85284,85212,170496,1,1,1,72,Out > In
Sept 2020,46,181,5,39197649,256402843,295600492,2,1,5,217205194,In > Out
Sept 2020,46,189,1,243436,289684,533120,1,1,1,46248,In > Out
Sept 2020,46,194,4,1429185,80451871,81881056,2,1,4,79022686,In > Out
Sept 2020,46,199,12,627913994,950429359,1578343353,7,8,12,322515365,In > Out
Sept 2020,46,20,1,299404,362227,661631,1,1,1,62823,In > Out
Sept 2020,46,202,9,18980116,28817528,47797644,9,9,9,9837412,In > Out
Sept 2020,46,210,2,697540,34070364,34767904,1,1,2,33372824,In > Out
Sept 2020,46,23,3,9746904,34736525,44483429,3,3,3,24989621,In > Out
Sept 2020,46,29,6,19834873,282483863,302318736,5,2,6,262648990,In > Out
Sept 2020,46,30,3,2237365,32053211,34290576,3,2,3,29815846,In > Out
Sept 2020,46,32,19,95407277,1118434739,1213842016,13,12,19,1023027462,In > Out
Sept 2020,46,36,18,91856237,959634548,1051490785,13,7,18,867778311,In > Out
Sept 2020,46,45,1,189466270,61694787,251161057,1,1,1,127771483,Out > In
Sept 2020,46,47,1,3886211,4395231,8281442,1,1,1,509020,In > Out
Sept 2020,46,57,8,35128882,159995607,195124489,5,2,8,124866725,In > Out
Sept 2020,46,71,10,21776252,462669237,484445489,8,3,10,440892985,In > Out
Sept 2020,46,72,1,55666,54518256,54573922,1,1,1,54462590,In > Out
Sept 2020,46,87,5,16883907,4257530,21141437,4,5,3,12626377,Out > In
Sept 2020,46,90,6,9181477,13546957,22728434,6,1,1,4365480,In > Out
Sept 2020,46,99,1,9055920,18006099,27062019,1,1,1,8950179,In > Out
Sept 2020,48,15,12,21815257,125722242,147537499,12,10,12,103906985,In > Out
Sept 2020,48,173,3,6883375,118427700,125311075,3,3,3,111544325,In > Out
Sept 2020,48,56,17,1621919494,4668694016,6290613510,14,9,17,3046774522,In > Out
Sept 2020,48,95,103,2310934597,717453316,3028387913,93,100,13,1593481281,Out > In
Sept 2020,49,113,4,42225625,2992303,45217928,2,2,4,39233322,Out > In
Sept 2020,49,114,5,108819917,8637897,117457814,4,4,5,100182020,Out > In
Sept 2020,49,115,22,2852401494,3355188520,6207590014,11,11,19,502787026,In > Out
Sept 2020,49,116,9,585524217,35575041,621099258,4,7,9,549949176,Out > In
Sept 2020,49,117,10,936319918,498019931,1434339849,8,6,9,438299987,Out > In
Sept 2020,49,118,17,1401854548,1344774349,2746628897,9,6,17,57080199,Out > In
Sept 2020,49,119,74,2696052455,4060597964,6756650419,25,24,68,1364545509,In > Out
Sept 2020,49,120,124,218999733,556255862,775255595,13,7,124,337256129,In > Out
Sept 2020,49,121,14,148611266,273341386,421952652,9,7,14,124730120,In > Out
Sept 2020,49,122,13,746945565,379196773,1126142338,8,5,13,367748792,Out > In
Sept 2020,49,123,37,4109312244,778255678,4887567922,15,25,37,3331056566,Out > In
Sept 2020,49,124,8,121437722,336357049,457794771,6,3,8,214919327,In > Out
Sept 2020,49,125,18,241569809,1598880386,1840450195,10,9,18,1357310577,In > Out
Sept 2020,49,126,12,12116579,818413036,830529615,6,3,12,806296457,In > Out
Sept 2020,49,180,1,592200,591448,1183648,1,1,1,752,Out > In
Sept 2020,49,212,6,2110766971,534909074,2645676045,3,6,1,1575857897,Out > In
Sept 2020,49,228,1,302102,10020,312122,1,1,1,292082,Out > In
Sept 2020,5,103,196,470579421,161355605,631935026,3,196,1,309223816,Out > In
Sept 2020,5,16,1046,18639423077,9996195237,28635618314,212,1025,1,8643227840,Out > In
Sept 2020,5,17,9,36426550,524020019,560446569,3,9,1,487593469,In > Out
Sept 2020,5,19,830,2291042729,398164301,2689207030,123,803,1,1892878428,Out > In
Sept 2020,5,22,87,91033996197,1373438231,92407434428,8,86,4,89660557966,Out > In
Sept 2020,5,23,1,928901,47991690,48920591,1,1,1,47062789,In > Out
Sept 2020,5,25,615,513553740,2644173,516197913,5,615,4,510909567,Out > In
Sept 2020,5,27,3,5152508,993072,6145580,2,3,2,4159436,Out > In
Sept 2020,5,42,48,530418563,164036504,694455067,18,48,1,366382059,Out > In
Sept 2020,50,52,10,72325567,22514780,94840347,6,10,1,49810787,Out > In
Sept 2020,51,10,60,425010821,23801034494,24226045315,15,59,1,23376023673,In > Out
Sept 2020,51,151,11,8003201946,117321880,8120523826,2,11,11,7885880066,Out > In
Sept 2020,51,182,3036,18844997645,276480964,19121478609,112,2909,14,18568516681,Out > In
Sept 2020,51,209,4,475834594,13347307,489181901,1,4,4,462487287,Out > In
Sept 2020,51,239,11,2707059724,55749421,2762809145,2,11,10,2651310303,Out > In
Sept 2020,51,30,1,67200,80330,147530,1,1,1,13130,In > Out
Sept 2020,51,35,6,1303170,4231317,5534487,6,6,1,2928147,In > Out
Sept 2020,51,50,23,25697334373,549247634,26246582007,4,20,21,25148086739,Out > In
Sept 2020,52,10,1257,1312836758,485585208,1798421966,194,1213,7,827251550,Out > In
Sept 2020,52,113,4,474280,128991,603271,4,4,2,345289,Out > In
Sept 2020,52,118,33,825334460,137354685,962689145,1,33,2,687979775,Out > In
Sept 2020,52,12,19774,103974660453,7489507222,111464167675,116,11814,5,96485153231,Out > In
Sept 2020,52,137,15,18135277,904580376,922715653,1,15,1,886445099,In > Out
Sept 2020,52,24,9,1433301,161582,1594883,4,9,2,1271719,Out > In
Sept 2020,52,242,1,108407,3536,111943,1,1,1,104871,Out > In
Sept 2020,52,29,12801,69806678579,1439569349,71246247928,720,11099,3,68367109230,Out > In
Sept 2020,52,35,1,2133716,261241400,263375116,1,1,1,259107684,In > Out
Sept 2020,52,38,2,770848,82486892,83257740,1,2,2,81716044,In > Out
Sept 2020,52,97,370,193252792,28556742,221809534,145,369,2,164696050,Out > In
Sept 2020,53,28,1,68555,41282,109837,1,1,1,27273,Out > In
Sept 2020,54,158,1,1993031,2335278,4328309,1,1,1,342247,In > Out
Sept 2020,55,13,2,756539,24031886,24788425,1,2,1,23275347,In > Out
Sept 2020,55,130,11145,31472121068,524303255,31996424323,1472,8942,1,30947817813,Out > In
Sept 2020,55,9,1,124715,116447,241162,1,1,1,8268,Out > In
Sept 2020,57,129,4015,73138379243,2030062362,75168441605,1777,2974,1,71108316881,Out > In
Sept 2020,57,131,2572,2439495042,53074630,2492569672,268,2420,2,2386420412,Out > In
Sept 2020,57,152,56,6456598,204147,6660745,9,55,1,6252451,Out > In
Sept 2020,57,153,7,835928,42080,878008,2,7,1,793848,Out > In
Sept 2020,57,180,2,6263906,3216016,9479922,1,1,2,3047890,Out > In
Sept 2020,57,2,3072,8607870638,257711990,8865582628,1163,2868,1,8350158648,Out > In
Sept 2020,57,239,1,70022,60111,130133,1,1,1,9911,Out > In
Sept 2020,57,240,1,2720230,85828094,88548324,1,1,1,83107864,In > Out
Sept 2020,57,242,1,697025,569818,1266843,1,1,1,127207,Out > In
Sept 2020,58,218,1,137449737,631546383,768996120,1,1,1,494096646,In > Out
Sept 2020,59,16,18195,27809791097,10910677803,38720468900,1847,13743,2,16899113294,Out > In
Sept 2020,59,18,442,28780715150,27496253341,56276968491,160,422,86,1284461809,Out > In
Sept 2020,59,19,20463,30932566843,12505032890,43437599733,1757,15126,3,18427533953,Out > In
Sept 2020,59,21,393,25925517774,18746800258,44672318032,164,385,57,7178717516,Out > In
Sept 2020,60,101,3,220982,221396,442378,1,3,1,414,In > Out
Sept 2020,60,102,3,204914,206672,411586,1,3,1,1758,In > Out
Sept 2020,60,16,17,1358771,1650413,3009184,1,17,1,291642,In > Out
Sept 2020,60,17,5,719701,336888,1056589,2,5,2,382813,Out > In
Sept 2020,60,18,4,527435,212545,739980,2,4,2,314890,Out > In
Sept 2020,60,19,3,443605,139108,582713,2,3,2,304497,Out > In
Sept 2020,60,24,170,44957758,6781648,51739406,60,169,1,38176110,Out > In
Sept 2020,60,27,2811,1025192565,221221296,1246413861,456,2597,2,803971269,Out > In
Sept 2020,60,31,3975,1130857417,99421555,1230278972,1552,3687,2,1031435862,Out > In
Sept 2020,60,34,96637,132124017655,2918776645,135042794300,16703,41229,2,129205241010,Out > In
Sept 2020,60,35,12406,4386032139,2305682860,6691714999,1336,9817,2,2080349279,Out > In
Sept 2020,60,38,4,271664,272128,543792,1,4,1,464,In > Out
Sept 2020,60,41,2,154873,155488,310361,1,2,1,615,In > Out
Sept 2020,60,43,112,17769608,561537,18331145,90,112,2,17208071,Out > In
Sept 2020,60,44,17656,19102996437,888648730,19991645167,1411,13851,2,18214347707,Out > In
Sept 2020,60,45,6,681992,56215,738207,5,6,1,625777,Out > In
Sept 2020,60,46,15,18624562,609088,19233650,7,15,2,18015474,Out > In
Sept 2020,60,47,3,204002,203128,407130,1,3,1,874,Out > In
Sept 2020,60,48,2,134791,134256,269047,1,2,1,535,Out > In
Sept 2020,60,49,24,5388791,6104991,11493782,4,24,3,716200,In > Out
Sept 2020,60,51,2,149465,149748,299213,1,2,1,283,In > Out
Sept 2020,60,52,182,79689215,58090685,137779900,4,182,2,21598530,Out > In
Sept 2020,60,53,5,374649,374088,748737,1,5,1,561,Out > In
Sept 2020,60,54,47,8480802,3646613,12127415,26,47,2,4834189,Out > In
Sept 2020,60,55,4,246549,248000,494549,1,4,1,1451,In > Out
Sept 2020,60,56,33,44328787,632336,44961123,5,33,2,43696451,Out > In
Sept 2020,60,59,3,218469,219028,437497,1,3,1,559,In > Out
Sept 2020,60,60,38,28923660,696172,29619832,22,38,2,28227488,Out > In
Sept 2020,60,63,2,117745,116908,234653,1,2,1,837,Out > In
Sept 2020,60,66,2341,781993790,907662692,1689656482,362,2227,2,125668902,In > Out
Sept 2020,60,68,10,3750479,459695,4210174,4,10,2,3290784,Out > In
Sept 2020,60,69,16,20402526,831945,21234471,6,16,2,19570581,Out > In
Sept 2020,60,70,1493,1781330376,39985671,1821316047,283,1432,2,1741344705,Out > In
Sept 2020,60,71,4,301634,302228,603862,1,4,1,594,In > Out
Sept 2020,60,72,49,41272596,3806787,45079383,3,49,2,37465809,Out > In
Sept 2020,60,76,2917,4054993640,830056436,4885050076,437,2732,2,3224937204,Out > In
Sept 2020,60,77,27371,59418033364,1867820309,61285853673,140,20825,1,57550213055,Out > In
Sept 2020,60,79,177,182550487,3370319,185920806,33,176,2,179180168,Out > In
Sept 2020,60,80,2,114417,115220,229637,1,2,1,803,In > Out
Sept 2020,60,83,84,81610297,9310370,90920667,31,83,3,72299927,Out > In
Sept 2020,60,84,3,535317,269130,804447,2,3,1,266187,Out > In
Sept 2020,60,85,61,10334485,4585865,14920350,3,61,2,5748620,Out > In
Sept 2020,60,87,70839,44451470005,1399138406,45850608411,10671,24259,2,43052331599,Out > In
Sept 2020,60,88,13,3845343,1499206,5344549,4,13,1,2346137,Out > In
Sept 2020,60,89,866,191393189,8377112,199770301,665,846,2,183016077,Out > In
Sept 2020,60,91,1,108011,4759,112770,1,1,1,103252,Out > In
Sept 2020,60,93,58,2440396,92874945,95315341,4,20,2,90434549,In > Out
Sept 2020,60,94,2055,50633111,4238902936,4289536047,40,241,2,4188269825,In > Out
Sept 2020,60,95,25968,63451258861,1062486664,64513745525,2656,19661,1,62388772197,Out > In
Sept 2020,60,96,24913,23230198447,583673897,23813872344,3908,18019,2,22646524550,Out > In
Sept 2020,60,97,2,134260,134852,269112,1,2,1,592,In > Out
Sept 2020,60,98,58,43218544,4660989,47879533,10,58,2,38557555,Out > In
Sept 2020,60,99,377,374786556,12184690,386971246,97,372,2,362601866,Out > In
Sept 2020,65,128,10,1886332874,2071982460,3958315334,9,5,10,185649586,In > Out
Sept 2020,65,153,1,102045229,50680399,152725628,1,1,1,51364830,Out > In
Sept 2020,65,236,6,104480830,4063238,108544068,1,6,2,100417592,Out > In
Sept 2020,7,107,3,433240,9886,443126,3,3,1,423354,Out > In
Sept 2020,7,11,37,5522428729,1367676298,6890105027,5,37,6,4154752431,Out > In
Sept 2020,7,119,94,1067070036,975163287,2042233323,8,85,94,91906749,Out > In
Sept 2020,7,12,15,3671226780,3659776816,7331003596,10,8,15,11449964,Out > In
Sept 2020,7,129,4474,3544531890,187715487,3732247377,260,3955,3,3356816403,Out > In
Sept 2020,7,165,1,4474131,995616,5469747,1,1,1,3478515,Out > In
Sept 2020,7,186,15,2992937,193836,3186773,6,15,2,2799101,Out > In
Sept 2020,7,213,6,578411,983388,1561799,1,6,2,404977,In > Out
Sept 2020,7,248,2,365882,165929,531811,1,2,1,199953,Out > In
Sept 2020,7,58,1,16773994,1557349,18331343,1,1,1,15216645,Out > In
Sept 2020,7,69,942,986930120,15456052,1002386172,223,928,1,971474068,Out > In
Sept 2020,7,77,104,77139463,3457093,80596556,66,98,3,73682370,Out > In
Sept 2020,7,91,23,7657416,411798,8069214,8,23,1,7245618,Out > In
Sept 2020,70,10,1,33546787,35007368,68554155,1,1,1,1460581,In > Out
Sept 2020,70,103,1,98742949,91710104,190453053,1,1,1,7032845,Out > In
Sept 2020,70,104,1,697901271,746735736,1444637007,1,1,1,48834465,In > Out
Sept 2020,70,106,1,1729205158,1897861953,3627067111,1,1,1,168656795,In > Out
Sept 2020,70,11,1,816426949,546780184,1363207133,1,1,1,269646765,Out > In
Sept 2020,70,113,6,475069440,435264122,910333562,3,4,5,39805318,Out > In
Sept 2020,70,114,9,667205939,1552320088,2219526027,7,2,9,885114149,In > Out
Sept 2020,70,121,2,8810862,188041037,196851899,1,1,2,179230175,In > Out
Sept 2020,70,124,5,1585459180,1484362106,3069821286,5,4,2,101097074,Out > In
Sept 2020,70,131,4,46414824,632749466,679164290,3,3,4,586334642,In > Out
Sept 2020,70,134,3,879407290,674465299,1553872589,3,3,1,204941991,Out > In
Sept 2020,70,135,2,3574849,93233778,96808627,1,1,2,89658929,In > Out
Sept 2020,70,136,5,4981208,48161611,53142819,3,3,5,43180403,In > Out
Sept 2020,70,138,1,156963994,144712341,301676335,1,1,1,12251653,Out > In
Sept 2020,70,14,4,2272407006,2117461219,4389868225,2,3,1,154945787,Out > In
Sept 2020,70,140,2,384111,109035331,109419442,2,2,2,108651220,In > Out
Sept 2020,70,142,1,2106599,34619438,36726037,1,1,1,32512839,In > Out
Sept 2020,70,148,4,1153006772,1523624218,2676630990,4,4,3,370617446,In > Out
Sept 2020,70,149,1,73016,41756,114772,1,1,1,31260,Out > In
Sept 2020,70,15,2,1839967418,1751780411,3591747829,2,2,1,88187007,Out > In
Sept 2020,70,151,1,1183462675,1057850481,2241313156,1,1,1,125612194,Out > In
Sept 2020,70,158,3,65031291,59588659,124619950,2,3,3,5442632,Out > In
Sept 2020,70,159,1,24208925,542761709,566970634,1,1,1,518552784,In > Out
Sept 2020,70,165,2,123207,675791,798998,2,2,2,552584,In > Out
Sept 2020,70,166,3,271769983,263247805,535017788,2,3,3,8522178,Out > In
Sept 2020,70,171,1,146646710,205730625,352377335,1,1,1,59083915,In > Out
Sept 2020,70,174,1,270063,50497594,50767657,1,1,1,50227531,In > Out
Sept 2020,70,175,2,34303999,211296053,245600052,2,2,2,176992054,In > Out
Sept 2020,70,178,4,6598292,146168722,152767014,3,3,4,139570430,In > Out
Sept 2020,70,179,4,138539235,370109049,508648284,3,2,4,231569814,In > Out
Sept 2020,70,18,21,120222424,748048518,868270942,11,2,21,627826094,In > Out
Sept 2020,70,183,4,141932,896585,1038517,4,2,4,754653,In > Out
Sept 2020,70,187,1,1031046,1161531,2192577,1,1,1,130485,In > Out
Sept 2020,70,189,3,11434029,33087695,44521724,2,1,3,21653666,In > Out
Sept 2020,70,19,2,12786660,227489204,240275864,2,2,2,214702544,In > Out
Sept 2020,70,193,3,726184880,410757627,1136942507,2,2,3,315427253,Out > In
Sept 2020,70,199,1,17795,134273,152068,1,1,1,116478,In > Out
Sept 2020,70,20,6,759159044,673366783,1432525827,4,5,1,85792261,Out > In
Sept 2020,70,201,4,571137421,1873915038,2445052459,3,2,4,1302777617,In > Out
Sept 2020,70,204,6,24836646,638583944,663420590,4,1,6,613747298,In > Out
Sept 2020,70,207,5,354813174,107091018,461904192,5,3,5,247722156,Out > In
Sept 2020,70,209,2,52720679,263631864,316352543,1,1,2,210911185,In > Out
Sept 2020,70,21,4,19608913,164744629,184353542,3,1,4,145135716,In > Out
Sept 2020,70,210,1,9138273,50761067,59899340,1,1,1,41622794,In > Out
Sept 2020,70,214,1,505983,242429,748412,1,1,1,263554,Out > In
Sept 2020,70,217,2,156498575,147642468,304141043,1,1,1,8856107,Out > In
Sept 2020,70,218,4,41293825,1107980904,1149274729,2,1,4,1066687079,In > Out
Sept 2020,70,223,2,134905,1219467,1354372,2,1,2,1084562,In > Out
Sept 2020,70,23,2,1247230801,960060183,2207290984,2,2,2,287170618,Out > In
Sept 2020,70,26,9,926060730,1334010653,2260071383,5,9,7,407949923,In > Out
Sept 2020,70,30,5,288967598,263570030,552537628,3,5,5,25397568,Out > In
Sept 2020,70,35,3,8470661529,5329391072,13800052601,3,2,2,3141270457,Out > In
Sept 2020,70,4,2,42515661,32945253,75460914,2,2,1,9570408,Out > In
Sept 2020,70,40,1,105886,3202,109088,1,1,1,102684,Out > In
Sept 2020,70,44,4,7253673,436515252,443768925,2,1,4,429261579,In > Out
Sept 2020,70,56,4,217841653,306262593,524104246,3,1,4,88420940,In > Out
Sept 2020,70,59,7,2789431407,599514589,3388945996,2,1,2,2189916818,Out > In
Sept 2020,70,62,2,66445258,358488140,424933398,2,2,2,292042882,In > Out
Sept 2020,70,64,1,220295,1466718,1687013,1,1,1,1246423,In > Out
Sept 2020,70,68,1,11258466,12007520,23265986,1,1,1,749054,In > Out
Sept 2020,70,71,10,14522736,10469199,24991935,3,10,3,4053537,Out > In
Sept 2020,70,83,2,2482419,290976477,293458896,1,1,2,288494058,In > Out
Sept 2020,70,85,6,727104514,329880574,1056985088,4,6,6,397223940,Out > In
Sept 2020,70,89,2,68500213,597670477,666170690,1,1,2,529170264,In > Out
Sept 2020,70,92,3,340375183,243299246,583674429,2,2,2,97075937,Out > In
Sept 2020,70,94,2,2760426,1920435,4680861,2,2,2,839991,Out > In
Sept 2020,70,95,1,4734372,3788405,8522777,1,1,1,945967,Out > In
Sept 2020,70,96,1,213693,87824,301517,1,1,1,125869,Out > In
Sept 2020,72,101,2,137673,138792,276465,1,2,1,1119,In > Out
Sept 2020,72,123,31,4414391,142493,4556884,13,31,1,4271898,Out > In
Sept 2020,72,124,1,132228,4935,137163,1,1,1,127293,Out > In
Sept 2020,72,125,1,102171,5338,107509,1,1,1,96833,Out > In
Sept 2020,72,129,4,310768,310996,621764,1,4,1,228,In > Out
Sept 2020,72,133,148,63076300,1430223,64506523,45,54,2,61646077,Out > In
Sept 2020,72,134,1,191911,4164,196075,1,1,1,187747,Out > In
Sept 2020,72,138,27,9667041,290078,9957119,8,27,1,9376963,Out > In
Sept 2020,72,144,2,128873,129364,258237,1,2,1,491,In > Out
Sept 2020,72,146,4,262574,265928,528502,1,4,1,3354,In > Out
Sept 2020,72,148,14,1962593,64827,2027420,10,14,1,1897766,Out > In
Sept 2020,72,149,42,6131904,231952,6363856,30,42,1,5899952,Out > In
Sept 2020,72,150,3,246839,247132,493971,1,3,1,293,In > Out
Sept 2020,72,162,4,236206,236388,472594,1,4,1,182,In > Out
Sept 2020,72,184,2,144681,144720,289401,1,2,1,39,In > Out
Sept 2020,72,185,2,159666,160016,319682,1,2,1,350,In > Out
Sept 2020,72,19,117,27746636,1105787,28852423,62,117,2,26640849,Out > In
Sept 2020,72,191,13,4934675,367202,5301877,7,13,2,4567473,Out > In
Sept 2020,72,20,2,154157,154548,308705,1,2,1,391,In > Out
Sept 2020,72,22,6,463073,365083,828156,2,6,2,97990,Out > In
Sept 2020,72,23,4,241448,241692,483140,1,4,1,244,In > Out
Sept 2020,72,24,21,2758629,183901,2942530,19,21,2,2574728,Out > In
Sept 2020,72,254,1,51445,51608,103053,1,1,1,163,In > Out
Sept 2020,72,30,4,307284,308264,615548,1,4,1,980,In > Out
Sept 2020,72,55,4,1938352,178995,2117347,3,4,2,1759357,Out > In
Sept 2020,72,56,11,1009108,368139,1377247,7,11,2,640969,Out > In
Sept 2020,72,57,1,1142037,7404,1149441,1,1,1,1134633,Out > In
Sept 2020,72,59,4,288092,289048,577140,1,4,1,956,In > Out
Sept 2020,72,61,2,154564,160676,315240,1,2,1,6112,In > Out
Sept 2020,72,62,4,244123,246316,490439,1,4,1,2193,In > Out
Sept 2020,72,63,4,318237,319124,637361,1,4,1,887,In > Out
Sept 2020,72,67,5,350989,354016,705005,1,5,1,3027,In > Out
Sept 2020,72,70,8,912931,328414,1241345,3,8,2,584517,Out > In
Sept 2020,72,76,3,221536,222392,443928,1,3,1,856,In > Out
Sept 2020,72,78,2,168694,168296,336990,1,2,1,398,Out > In
Sept 2020,72,83,4,377908,377408,755316,1,4,1,500,Out > In
Sept 2020,72,95,4,271891,270628,542519,1,4,1,1263,Out > In
Sept 2020,72,97,15,1502471,252886,1755357,4,15,2,1249585,Out > In
Sept 2020,72,98,5,347619,349996,697615,1,5,1,2377,In > Out
Sept 2020,73,10,19818,16362236197,605748666,16967984863,3523,14510,2,15756487531,Out > In
Sept 2020,73,105,1,2739613,694571,3434184,1,1,1,2045042,Out > In
Sept 2020,73,117,4,160901740,396726826,557628566,3,2,4,235825086,In > Out
Sept 2020,73,130,3,75466603,306132187,381598790,3,3,3,230665584,In > Out
Sept 2020,73,136,2,271278,12918,284196,2,2,1,258360,Out > In
Sept 2020,73,14,640,1056089671,27234124,1083323795,191,638,1,1028855547,Out > In
Sept 2020,73,143,2,2536546,80595,2617141,2,1,2,2455951,Out > In
Sept 2020,73,148,46,451962712,74122709,526085421,16,32,5,377840003,Out > In
Sept 2020,73,149,3,1973332,227933,2201265,2,3,2,1745399,Out > In
Sept 2020,73,150,4,8274901,290137741,298412642,4,4,2,281862840,In > Out
Sept 2020,73,157,1408,2400622540,738374006,3138996546,172,1291,4,1662248534,Out > In
Sept 2020,73,165,1,117948,4915,122863,1,1,1,113033,Out > In
Sept 2020,73,166,112,247047694,4008619,251056313,84,112,2,243039075,Out > In
Sept 2020,73,167,2,398138,35656,433794,2,2,1,362482,Out > In
Sept 2020,73,169,3,1934903595,2993410806,4928314401,3,3,3,1058507211,In > Out
Sept 2020,73,181,52,4593575789,3208423560,7801999349,24,16,44,1385152229,Out > In
Sept 2020,73,190,2,250133416,1076171,251209587,1,2,2,249057245,Out > In
Sept 2020,73,194,569,82907874,51745655,134653529,396,561,1,31162219,Out > In
Sept 2020,73,195,1,580155687,5626771,585782458,1,1,1,574528916,Out > In
Sept 2020,73,198,1,250479096,1108083,251587179,1,1,1,249371013,Out > In
Sept 2020,73,2,1,128618,6486,135104,1,1,1,122132,Out > In
Sept 2020,73,206,2,76628228,224192648,300820876,2,1,2,147564420,In > Out
Sept 2020,73,208,3,441858695,494609084,936467779,3,2,3,52750389,In > Out
Sept 2020,73,211,10,123857890,518335032,642192922,3,3,4,394477142,In > Out
Sept 2020,73,215,2,507219463,836909402,1344128865,2,2,2,329689939,In > Out
Sept 2020,73,217,672,6230079738,1256277605,7486357343,423,407,2,4973802133,Out > In
Sept 2020,73,220,1,8597338,938173,9535511,1,1,1,7659165,Out > In
Sept 2020,73,224,2,274284,13162,287446,2,2,1,261122,Out > In
Sept 2020,73,237,16354,1107799181383,18531105240,1126330286623,8760,6994,2,1089268076143,Out > In
Sept 2020,73,24,64,16722391,2034547,18756938,34,64,1,14687844,Out > In
Sept 2020,73,29,2,385582,163900,549482,1,2,1,221682,Out > In
Sept 2020,73,3,4626,124402845118,12704492151,137107337269,2783,268,1,111698352967,Out > In
Sept 2020,73,32,228,2136477344,469854598,2606331942,191,141,1,1666622746,Out > In
Sept 2020,73,4,557,1475391268,17365924,1492757192,4,551,2,1458025344,Out > In
Sept 2020,73,42,1,21773877,50970058,72743935,1,1,1,29196181,In > Out
Sept 2020,73,47,3,127015682,711719209,838734891,2,1,3,584703527,In > Out
Sept 2020,73,49,211,2310638,31885400,34196038,184,210,1,29574762,In > Out
Sept 2020,73,56,4,228861896,231355526,460217422,4,3,4,2493630,In > Out
Sept 2020,73,58,1,1205643771,869784639,2075428410,1,1,1,335859132,Out > In
Sept 2020,73,59,1,127169,135963,263132,1,1,1,8794,In > Out
Sept 2020,73,63,234,14631922,24999385,39631307,159,234,1,10367463,In > Out
Sept 2020,73,66,3,466845,85431,552276,3,3,1,381414,Out > In
Sept 2020,73,79,1,880603,20639141,21519744,1,1,1,19758538,In > Out
Sept 2020,73,8,70,39383619,1476569,40860188,53,70,2,37907050,Out > In
Sept 2020,73,9,2,401380,475671,877051,2,2,1,74291,In > Out
Sept 2020,74,117,10,4365027,1738872,6103899,5,8,2,2626155,Out > In
Sept 2020,74,127,1,1890135,3113165,5003300,1,1,1,1223030,In > Out
Sept 2020,74,152,1514,1871729515,565205923,2436935438,196,1380,2,1306523592,Out > In
Sept 2020,74,154,1,113524,41514,155038,1,1,1,72010,Out > In
Sept 2020,74,180,1,133867,141662,275529,1,1,1,7795,In > Out
Sept 2020,74,202,2,10607630,200555025,211162655,2,1,2,189947395,In > Out
Sept 2020,74,219,5,2527647799,1323558369,3851206168,3,2,5,1204089430,Out > In
Sept 2020,74,229,1,49140,57710,106850,1,1,1,8570,In > Out
Sept 2020,74,234,5,1740683,12535609,14276292,2,3,5,10794926,In > Out
Sept 2020,74,237,2,348943081,334404076,683347157,1,2,2,14539005,Out > In
Sept 2020,74,45,1599,3774317001,1052183382,4826500383,235,1459,1,2722133619,Out > In
Sept 2020,74,46,5,528060,1201167,1729227,3,5,1,673107,In > Out
Sept 2020,74,52,1080,1725079132,424095524,2149174656,626,481,1,1300983608,Out > In
Sept 2020,74,61,1,115255,17993,133248,1,1,1,97262,Out > In
Sept 2020,74,93,1,5397327,857652726,863050053,1,1,1,852255399,In > Out
Sept 2020,75,37,66,13003490,4079340,17082830,57,66,1,8924150,Out > In
Sept 2020,77,120,15,25417469,546039,25963508,10,15,2,24871430,Out > In
Sept 2020,77,121,30,2283515,1554476,3837991,1,2,1,729039,Out > In
Sept 2020,77,122,933,1362801567,724592910,2087394477,4,16,1,638208657,Out > In
Sept 2020,77,231,40,7247547,53772079,61019626,31,39,15,46524532,In > Out
Sept 2020,79,10,7,4223166,2280760,6503926,1,7,1,1942406,Out > In
Sept 2020,79,11,7,5908500,182302695,188211195,4,5,7,176394195,In > Out
Sept 2020,79,12,374,1343365465,113117737277,114461102742,9,374,1,111774371812,In > Out
Sept 2020,79,13,5,1535228,353198,1888426,1,5,1,1182030,Out > In
Sept 2020,79,16,2,327456,28153970,28481426,2,2,2,27826514,In > Out
Sept 2020,79,22,9,420087190,8006509,428093699,1,9,1,412080681,Out > In
Sept 2020,79,9,98,19320850,1923807,21244657,55,93,1,17397043,Out > In
Sept 2020,80,9,11,1992399389,113873622,2106273011,1,11,11,1878525767,Out > In
Sept 2020,81,140,164979,202428332620,46664891365,249093223985,2742,21843,1,155763441255,Out > In
Sept 2020,82,134,7,39306138,1082501520,1121807658,4,1,7,1043195382,In > Out
Sept 2020,82,142,1,5016475,151522076,156538551,1,1,1,146505601,In > Out
Sept 2020,82,146,10,870833047,15780506,886613553,2,10,10,855052541,Out > In
Sept 2020,82,167,77,769044339,10072936,779117275,2,77,1,758971403,Out > In
Sept 2020,82,169,1,41604,896293,937897,1,1,1,854689,In > Out
Sept 2020,82,204,9,10145240,4933654,15078894,4,4,1,5211586,Out > In
Sept 2020,82,239,14,18084679,6934392,25019071,3,5,1,11150287,Out > In
Sept 2020,82,54,2,6790646,1264781,8055427,2,2,2,5525865,Out > In
Sept 2020,82,56,12,822979995,1313863832,2136843827,8,4,12,490883837,In > Out
Sept 2020,82,58,39,236495928,125133557,361629485,6,38,1,111362371,Out > In
Sept 2020,83,105,3,165555244,307791615,473346859,2,2,3,142236371,In > Out
Sept 2020,83,130,5,797748,60719,858467,3,5,1,737029,Out > In
Sept 2020,83,142,53,3539406,3995428,7534834,22,53,2,456022,In > Out
Sept 2020,83,150,3,169663791,260271077,429934868,2,2,3,90607286,In > Out
Sept 2020,83,154,2,24477903,59875841,84353744,1,1,2,35397938,In > Out
Sept 2020,83,156,8,772805123,1039288059,1812093182,5,2,8,266482936,In > Out
Sept 2020,83,157,3,39792849,6663305,46456154,3,2,3,33129544,Out > In
Sept 2020,83,158,3,194141917,175749013,369890930,2,1,3,18392904,Out > In
Sept 2020,83,159,3,12376234,88824649,101200883,2,1,3,76448415,In > Out
Sept 2020,84,36,2,2596171,93644791,96240962,2,2,2,91048620,In > Out
Sept 2020,85,107,1,200551216,914553864,1115105080,1,1,1,714002648,In > Out
Sept 2020,85,109,6,67373327,451559085,518932412,4,5,6,384185758,In > Out
Sept 2020,85,110,1,52235419,70664860,122900279,1,1,1,18429441,In > Out
Sept 2020,85,117,2,22224567,57522391,79746958,1,1,2,35297824,In > Out
Sept 2020,85,120,2,79076282,74442974,153519256,2,1,2,4633308,Out > In
Sept 2020,85,121,6,237181876,253088884,490270760,5,2,6,15907008,In > Out
Sept 2020,85,125,5,134099906,175293276,309393182,4,2,5,41193370,In > Out
Sept 2020,85,126,15,5937199959,6571781412,12508981371,10,6,15,634581453,In > Out
Sept 2020,85,130,6,154583430,244411940,398995370,2,1,6,89828510,In > Out
Sept 2020,85,131,1,2504288,51011356,53515644,1,1,1,48507068,In > Out
Sept 2020,85,132,4,26111601,60232751,86344352,2,1,4,34121150,In > Out
Sept 2020,85,133,4,102322672,300698742,403021414,2,3,4,198376070,In > Out
Sept 2020,85,144,2,3440456,67012072,70452528,2,2,2,63571616,In > Out
Sept 2020,85,16,179,84062301036,128909574773,212971875809,48,7,1,44847273737,In > Out
Sept 2020,85,2,32407,33197836937,767047764,33964884701,2559,261,1,32430789173,Out > In
Sept 2020,85,66,1,2501024,28380567,30881591,1,1,1,25879543,In > Out
Sept 2020,86,175,426,29847653175,232791982,30080445157,109,426,1,29614861193,Out > In
Sept 2020,86,66,31654,11367524034,377665426,11745189460,11236,20339,2,10989858608,Out > In
Sept 2020,89,100,1,134884,84112,218996,1,1,1,50772,Out > In
Sept 2020,89,115,1,65520,69310,134830,1,1,1,3790,In > Out
Sept 2020,89,130,1,344879336,1380837775,1725717111,1,1,1,1035958439,In > Out
Sept 2020,89,61,2,228072,1704114,1932186,2,1,2,1476042,In > Out
Sept 2020,89,87,6,8027355,108438951,116466306,4,3,5,100411596,In > Out
Sept 2020,9,53,1,2905813,2755106,5660919,1,1,1,150707,Out > In
Sept 2020,90,12,1,714478,16159167,16873645,1,1,1,15444689,In > Out
Sept 2020,90,215,143,99471068,10270381,109741449,81,19,1,89200687,Out > In
Sept 2020,90,220,1,58164,58608,116772,1,1,1,444,In > Out
Sept 2020,90,235,4620,115734047065,5781737572,121515784637,1504,3091,4,109952309493,Out > In
Sept 2020,90,253,4,29515615,1036074,30551689,4,4,4,28479541,Out > In
Sept 2020,90,26,1,309975,11077,321052,1,1,1,298898,Out > In
Sept 2020,90,38,2,3908617,63258541,67167158,2,1,2,59349924,In > Out
Sept 2020,90,48,4,1162064101,979994201,2142058302,2,2,4,182069900,Out > In
Sept 2020,90,5,11,296303385,360537058,656840443,6,1,11,64233673,In > Out
Sept 2020,91,15,1,18140,20365902,20384042,1,1,1,20347762,In > Out
Sept 2020,91,16,1,584074,8695965,9280039,1,1,1,8111891,In > Out
Sept 2020,91,21,1,4614919,315631,4930550,1,1,1,4299288,Out > In
Sept 2020,91,225,2,366562576,6535919,373098495,1,2,1,360026657,Out > In
Sept 2020,91,226,6,636059820,550252732,1186312552,3,1,6,85807088,Out > In
Sept 2020,91,227,3,344427,2464868,2809295,1,3,1,2120441,In > Out
Sept 2020,91,228,4,155810296,2692203,158502499,2,4,1,153118093,Out > In
Sept 2020,91,239,8132,67863622540,2309244481,70172867021,1656,7414,3,65554378059,Out > In
Sept 2020,91,5,5,149122084,389543738,538665822,2,4,5,240421654,In > Out
Sept 2020,91,58,21,13058091338,280544693,13338636031,2,21,20,12777546645,Out > In
Sept 2020,91,64,2,43854527,373682636,417537163,1,1,2,329828109,In > Out
Sept 2020,92,227,1,3643698,46452,3690150,1,1,1,3597246,Out > In
Sept 2020,92,228,31751,34227227312,740246907,34967474219,2373,211,1,33486980405,Out > In
Sept 2020,94,21,5,664419,29296,693715,3,5,1,635123,Out > In
Sept 2020,94,22,2592,8918621782,601747684,9520369466,510,2268,28,8316874098,Out > In
Sept 2020,94,29,255,52104872444,14283644359,66388516803,83,72,179,37821228085,Out > In
Sept 2020,94,30,23,18191409,15706838,33898247,2,1,23,2484571,Out > In
Sept 2020,94,51,14,13577071,293692,13870763,1,14,14,13283379,Out > In
Sept 2020,96,1,4116,4910631579,141850316,5052481895,1651,3831,2,4768781263,Out > In
Sept 2020,96,10,438,560482202,37425951,597908153,52,433,3,523056251,Out > In
Sept 2020,96,119,3,729575,22622,752197,3,3,1,706953,Out > In
Sept 2020,96,124,2,124694,123820,248514,1,2,1,874,Out > In
Sept 2020,96,125,2682516,2466009799753,172050908400,2638060708153,210523,64588,2,2293958891353,Out > In
Sept 2020,96,135,2,112297,112048,224345,1,2,1,249,Out > In
Sept 2020,96,136,308,2098260289,62500784,2160761073,50,307,2,2035759505,Out > In
Sept 2020,96,141,1,74057,75788,149845,1,1,1,1731,In > Out
Sept 2020,96,142,8,724203,303595,1027798,3,8,2,420608,Out > In
Sept 2020,96,143,2,121189,121372,242561,1,2,1,183,In > Out
Sept 2020,96,144,681798,267175365157,11873316007,279048681164,81840,61346,2,255302049150,Out > In
Sept 2020,96,145,3,241695,241872,483567,1,3,1,177,In > Out
Sept 2020,96,148,43,41467122,1828118,43295240,6,43,2,39639004,Out > In
Sept 2020,96,149,551,187502820,29875419,217378239,256,545,2,157627401,Out > In
Sept 2020,96,150,7,4887175,277634,5164809,2,7,2,4609541,Out > In
Sept 2020,96,151,5,368592,369304,737896,1,5,1,712,In > Out
Sept 2020,96,152,61,6985559,568867,7554426,42,61,2,6416692,Out > In
Sept 2020,96,153,4,329124,328980,658104,1,4,1,144,Out > In
Sept 2020,96,162,6,397417,456817,854234,2,6,1,59400,In > Out
Sept 2020,96,163,3,183143,187328,370471,1,3,1,4185,In > Out
Sept 2020,96,17,1,3162,323993,327155,1,1,1,320831,In > Out
Sept 2020,96,181,3,184131,184572,368703,1,3,1,441,In > Out
Sept 2020,96,182,1408,398480943,167626675,566107618,117,1348,2,230854268,Out > In
Sept 2020,96,183,3043,2224581784,99541548,2324123332,838,2922,2,2125040236,Out > In
Sept 2020,96,190,1467,9813867513,3051783488,12865651001,154,1415,2,6762084025,Out > In
Sept 2020,96,192,82503,58464109948,26524253960,84988363908,155,23789,2,31939855988,Out > In
Sept 2020,96,193,4,266071,264560,530631,1,4,1,1511,Out > In
Sept 2020,96,194,3,614507,144108,758615,2,3,2,470399,Out > In
Sept 2020,96,195,2,2983451,117367,3100818,2,2,2,2866084,Out > In
Sept 2020,96,23,2,382020,8696,390716,2,2,1,373324,Out > In
Sept 2020,96,24,90,345432698,4554661,349987359,30,90,2,340878037,Out > In
Sept 2020,96,25,23030,3921018971,171453742,4092472713,11457,16561,2,3749565229,Out > In
Sept 2020,96,26,4954,2662343253,51239983,2713583236,1524,4633,2,2611103270,Out > In
Sept 2020,96,29,5,364944,376755,741699,2,5,1,11811,In > Out
Sept 2020,96,30,750,659378942,93868324,753247266,73,743,2,565510618,Out > In
Sept 2020,96,31,1053,84358655,70769531,155128186,863,1039,2,13589124,Out > In
Sept 2020,96,32,3,220307,220064,440371,1,3,1,243,Out > In
Sept 2020,96,33,211,86082119,8262038,94344157,15,210,2,77820081,Out > In
Sept 2020,96,34,502,198613828,27799867,226413695,10,500,2,170813961,Out > In
Sept 2020,96,39,3125,1797562438,168804204,1966366642,494,2826,2,1628758234,Out > In
Sept 2020,96,41,2674,656117141,19039358,675156499,382,2577,2,637077783,Out > In
Sept 2020,96,44,1,83425,83692,167117,1,1,1,267,In > Out
Sept 2020,96,45,2,110063,113072,223135,1,2,1,3009,In > Out
Sept 2020,96,51,247362,50075278656,5236342247,55311620903,43586,42959,2,44838936409,Out > In
Sept 2020,96,53,19,3750112,277251,4027363,9,19,2,3472861,Out > In
Sept 2020,96,58,237,164928146,18866869,183795015,12,237,2,146061277,Out > In
Sept 2020,96,60,189,5527978845,1059824275,6587803120,88,188,3,4468154570,Out > In
Sept 2020,96,61,4,2303513,27144,2330657,3,4,2,2276369,Out > In
Sept 2020,96,62,696,244053521,22989010,267042531,111,684,2,221064511,Out > In
Sept 2020,96,63,2,132804,134608,267412,1,2,1,1804,In > Out
Sept 2020,96,73,3,261826,262092,523918,1,3,1,266,In > Out
Sept 2020,96,74,7,463793,469912,933705,1,7,1,6119,In > Out
Sept 2020,96,78,330,734700020,116716547,851416567,19,329,3,617983473,Out > In
Sept 2020,96,79,4,332055,331872,663927,1,4,1,183,Out > In
Sept 2020,96,80,5,366820,367408,734228,1,5,1,588,In > Out
Sept 2020,96,81,17628,15193460956,3632459718,18825920674,1742,11623,2,11561001238,Out > In
Sept 2020,96,82,2,165966,165964,331930,1,2,1,2,Out > In
Sept 2020,96,85,6796,1865118960,1545841030,3410959990,347,5513,2,319277930,Out > In
Sept 2020,96,86,163,62863881,13123977,75987858,24,163,2,49739904,Out > In
Sept 2020,96,88,624,418647577,8621499,427269076,413,620,1,410026078,Out > In
Sept 2020,96,92,3,212530,213020,425550,1,3,1,490,In > Out
Sept 2020,96,94,6,731657,210192,941849,4,6,2,521465,Out > In
Sept 2020,96,95,40070,11714764130,1362250029,13077014159,861,17503,1,10352514101,Out > In
Sept 2020,96,96,80298,25819586921,1546633545,27366220466,4486,23845,2,24272953376,Out > In
Sept 2020,96,97,5,1609959,217455,1827414,2,5,2,1392504,Out > In
Sept 2020,96,98,1,54808,55048,109856,1,1,1,240,In > Out
Sept 2020,98,101,1,3200885,3062481,6263366,1,1,1,138404,Out > In
Sept 2020,98,102,1,13586373,5453183,19039556,1,1,1,8133190,Out > In
Sept 2020,98,104,3,1531906,20728236,22260142,2,1,3,19196330,In > Out
Sept 2020,98,108,1,1342941,14825538,16168479,1,1,1,13482597,In > Out
Sept 2020,98,11,24,825149537,685388099,1510537636,19,21,19,139761438,Out > In
Sept 2020,98,120,1,2690616,2956707,5647323,1,1,1,266091,In > Out
Sept 2020,98,123,2,21655871,39772696,61428567,1,1,2,18116825,In > Out
Sept 2020,98,126,2,1081980573,738740118,1820720691,2,2,1,343240455,Out > In
Sept 2020,98,128,1,99262087,57058316,156320403,1,1,1,42203771,Out > In
Sept 2020,98,134,2,44111081,36690732,80801813,1,2,2,7420349,Out > In
Sept 2020,98,135,8,2139168446,914119997,3053288443,5,6,1,1225048449,Out > In
Sept 2020,98,137,36,569616200,562564485,1132180685,15,16,2,7051715,Out > In
Sept 2020,98,139,3,14521726,123238374,137760100,3,3,3,108716648,In > Out
Sept 2020,98,141,2,2957242313,2681375461,5638617774,2,2,2,275866852,Out > In
Sept 2020,98,156,5,169584,5799296,5968880,5,5,1,5629712,In > Out
Sept 2020,98,157,2,885754,1084779,1970533,1,2,2,199025,In > Out
Sept 2020,98,162,2,24202573,47704700,71907273,2,1,1,23502127,In > Out
Sept 2020,98,163,1,17094785,26201519,43296304,1,1,1,9106734,In > Out
Sept 2020,98,168,4,227850128,369213202,597063330,4,3,2,141363074,In > Out
Sept 2020,98,170,2,6785060,92874948,99660008,2,2,2,86089888,In > Out
Sept 2020,98,171,1,42710979,44222833,86933812,1,1,1,1511854,In > Out
Sept 2020,98,177,1,301758071,880668994,1182427065,1,1,1,578910923,In > Out
Sept 2020,98,180,4,308147842,240261110,548408952,4,4,4,67886732,Out > In
Sept 2020,98,181,1,11440,137663,149103,1,1,1,126223,In > Out
Sept 2020,98,184,10,6102837,105073946,111176783,5,2,10,98971109,In > Out
Sept 2020,98,186,1,1353999139,1011565271,2365564410,1,1,1,342433868,Out > In
Sept 2020,98,188,1,51388,331338,382726,1,1,1,279950,In > Out
Sept 2020,98,194,1,70537,186529,257066,1,1,1,115992,In > Out
Sept 2020,98,196,1,3755309,81413564,85168873,1,1,1,77658255,In > Out
Sept 2020,98,200,1,333674812,731242156,1064916968,1,1,1,397567344,In > Out
Sept 2020,98,206,2,500078,71208043,71708121,1,1,2,70707965,In > Out
Sept 2020,98,208,9,3211627917,3158628407,6370256324,6,5,6,52999510,Out > In
Sept 2020,98,210,1,1862493,2816836,4679329,1,1,1,954343,In > Out
Sept 2020,98,212,4,1687040,7741900,9428940,4,1,4,6054860,In > Out
Sept 2020,98,216,2,797212,800272,1597484,1,1,1,3060,In > Out
Sept 2020,98,219,7,1180496947,1114282049,2294778996,2,7,7,66214898,Out > In
Sept 2020,98,22,5,6899577,683234398,690133975,4,1,5,676334821,In > Out
Sept 2020,98,220,3,1567717,89077441,90645158,1,1,3,87509724,In > Out
Sept 2020,98,221,1,305784,355944,661728,1,1,1,50160,In > Out
Sept 2020,98,222,3,205615,355037,560652,3,1,3,149422,In > Out
Sept 2020,98,223,3,801088913,849468886,1650557799,2,3,2,48379973,In > Out
Sept 2020,98,26,3,18655095,31433854,50088949,2,2,3,12778759,In > Out
Sept 2020,98,27,8,125445208,295596787,421041995,3,2,8,170151579,In > Out
Sept 2020,98,29,9,866851497,1594302840,2461154337,6,3,9,727451343,In > Out
Sept 2020,98,30,1,7506957,8980641,16487598,1,1,1,1473684,In > Out
Sept 2020,98,37,1,37154,295902,333056,1,1,1,258748,In > Out
Sept 2020,98,43,1,2840593,21753273,24593866,1,1,1,18912680,In > Out
Sept 2020,98,44,3,697234832,1001434395,1698669227,1,3,3,304199563,In > Out
Sept 2020,98,46,5,352786693,5562071562,5914858255,5,5,5,5209284869,In > Out
Sept 2020,98,56,4,12545979,234517659,247063638,2,1,4,221971680,In > Out
Sept 2020,98,57,5,346934008,558532237,905466245,5,4,4,211598229,In > Out
Sept 2020,98,59,1,565518860,530238198,1095757058,1,1,1,35280662,Out > In
Sept 2020,98,61,2,1241490222,1968359185,3209849407,2,2,1,726868963,In > Out
Sept 2020,98,68,1,105687,83648,189335,1,1,1,22039,Out > In
Sept 2020,98,70,2,290293,548300,838593,2,2,2,258007,In > Out
Sept 2020,98,77,3,131250418,553023719,684274137,2,2,3,421773301,In > Out
Sept 2020,98,83,1,61507,58003354,58064861,1,1,1,57941847,In > Out
Sept 2020,98,86,1,569475,1240518,1809993,1,1,1,671043,In > Out
Sept 2020,98,90,4,1197795785,1145859930,2343655715,3,3,3,51935855,Out > In
Sept 2020,98,98,1,179629560,167076160,346705720,1,1,1,12553400,Out > In
Sept 2020,98,99,2,129600277,119584679,249184956,2,2,2,10015598,Out > In
Sept 2020,99,100,1,442777,226965,669742,1,1,1,215812,Out > In
Sept 2020,99,121,14,867951949,64442633,932394582,2,14,1,803509316,Out > In
Sept 2020,99,130,6,192799900,52125301,244925201,1,1,1,140674599,Out > In
Sept 2020,99,131,2,9765536,2263064,12028600,1,2,1,7502472,Out > In
Sept 2020,99,162,225,491291373,169920140,661211513,48,223,3,321371233,Out > In
Sept 2020,99,168,10,148230208,21696111,169926319,1,10,10,126534097,Out > In
Sept 2020,99,185,11,18332687,11571776,29904463,1,11,1,6760911,Out > In
Sept 2020,99,50,6,57500390,94586001,152086391,1,6,1,37085611,In > Out
Sept 2021,1,21,5,393954,403465,797419,3,4,1,9511,In > Out
Sept 2021,101,160,217,1893347136,59931943,1953279079,182,205,3,1833415193,Out > In
Sept 2021,101,177,8,231706406,48103185,279809591,8,3,8,183603221,Out > In
Sept 2021,101,28,1,6374524,668903,7043427,1,1,1,5705621,Out > In
Sept 2021,101,69,157,1089629461,8012383,1097641844,71,157,1,1081617078,Out > In
Sept 2021,101,89,1,13836659,14002691,27839350,1,1,1,166032,In > Out
Sept 2021,102,80,2,194652,116594,311246,2,2,1,78058,Out > In
Sept 2021,103,237,3,80176386,162779447,242955833,1,1,3,82603061,In > Out
Sept 2021,103,247,3,2525166,73746057,76271223,1,1,3,71220891,In > Out
Sept 2021,104,109,1,30697420,187191,30884611,1,1,1,30510229,Out > In
Sept 2021,104,135,5,3235504908,38885299,3274390207,2,5,5,3196619609,Out > In
Sept 2021,104,138,1,407620,18891,426511,1,1,1,388729,Out > In
Sept 2021,104,141,1,57183,52912,110095,1,1,1,4271,Out > In
Sept 2021,104,142,1,1108730363,15213772,1123944135,1,1,1,1093516591,Out > In
Sept 2021,104,150,3,1712722,347604,2060326,1,3,1,1365118,Out > In
Sept 2021,104,158,1,94276,6822520,6916796,1,1,1,6728244,In > Out
Sept 2021,104,179,1,353960,683724,1037684,1,1,1,329764,In > Out
Sept 2021,104,221,5,1593112,52946,1646058,3,5,1,1540166,Out > In
Sept 2021,104,248,10,31620816,305744311,337365127,5,4,10,274123495,In > Out
Sept 2021,104,57,3,403528164,36790011,440318175,1,3,1,366738153,Out > In
Sept 2021,104,96,5,62505941,467707747,530213688,3,3,5,405201806,In > Out
Sept 2021,108,3,1,64300,62980,127280,1,1,1,1320,Out > In
Sept 2021,111,5,228,140212941,131198743,271411684,34,89,25,9014198,Out > In
Sept 2021,112,10,1,73880,82624,156504,1,1,1,8744,In > Out
Sept 2021,112,100,1,554677142,570678738,1125355880,1,1,1,16001596,In > Out
Sept 2021,112,104,7,108809210,300251846,409061056,5,4,7,191442636,In > Out
Sept 2021,112,105,1,99232,95952,195184,1,1,1,3280,Out > In
Sept 2021,112,107,1,17612579,53230263,70842842,1,1,1,35617684,In > Out
Sept 2021,112,109,10,3508622156,3067812501,6576434657,5,5,8,440809655,Out > In
Sept 2021,112,114,2,427800162,441622687,869422849,2,1,1,13822525,In > Out
Sept 2021,112,115,1,2548626,49671865,52220491,1,1,1,47123239,In > Out
Sept 2021,112,117,1,224187566,228562658,452750224,1,1,1,4375092,In > Out
Sept 2021,112,119,2,4415620,58089258,62504878,1,1,2,53673638,In > Out
Sept 2021,112,123,2,260171576,159120534,419292110,1,2,2,101051042,Out > In
Sept 2021,112,125,5,41861565,231032467,272894032,4,4,4,189170902,In > Out
Sept 2021,112,126,1,85668,162227,247895,1,1,1,76559,In > Out
Sept 2021,112,127,3,69439795,63250649,132690444,3,3,3,6189146,Out > In
Sept 2021,112,128,2,1237480106,2035292858,3272772964,2,2,2,797812752,In > Out
Sept 2021,112,129,1,4661249,3484741,8145990,1,1,1,1176508,Out > In
Sept 2021,112,131,1,1400726156,1352895479,2753621635,1,1,1,47830677,Out > In
Sept 2021,112,132,3,2244123,72238836,74482959,2,1,3,69994713,In > Out
Sept 2021,112,134,5,540269658,550831413,1091101071,2,5,5,10561755,In > Out
Sept 2021,112,136,3,1325879973,1295507431,2621387404,2,3,1,30372542,Out > In
Sept 2021,112,137,5,2956806,3070281,6027087,1,1,5,113475,In > Out
Sept 2021,112,139,1,75160,49364,124524,1,1,1,25796,Out > In
Sept 2021,112,14,3,257136089,381322193,638458282,3,2,3,124186104,In > Out
Sept 2021,112,142,1,492663062,500392181,993055243,1,1,1,7729119,In > Out
Sept 2021,112,143,19,275960973,280535677,556496650,10,8,17,4574704,In > Out
Sept 2021,112,147,2,6601781585,6297416060,12899197645,1,1,1,304365525,Out > In
Sept 2021,112,148,8,1976900152,2029208131,4006108283,7,6,2,52307979,In > Out
Sept 2021,112,15,16,196050265,335407088,531457353,14,13,6,139356823,In > Out
Sept 2021,112,150,4,2001185874,2263866409,4265052283,4,4,3,262680535,In > Out
Sept 2021,112,153,2,1537109,101465928,103003037,1,1,2,99928819,In > Out
Sept 2021,112,156,2,12418983,87986325,100405308,2,2,2,75567342,In > Out
Sept 2021,112,159,2,1165040,4924361,6089401,2,2,2,3759321,In > Out
Sept 2021,112,161,8,28371337,121528824,149900161,6,4,8,93157487,In > Out
Sept 2021,112,164,1,1441814,3415423,4857237,1,1,1,1973609,In > Out
Sept 2021,112,165,2,20861491,178221744,199083235,1,1,2,157360253,In > Out
Sept 2021,112,170,5,203630172,224244174,427874346,5,5,3,20614002,In > Out
Sept 2021,112,175,1,38326050,506176587,544502637,1,1,1,467850537,In > Out
Sept 2021,112,177,1,515487375,510545675,1026033050,1,1,1,4941700,Out > In
Sept 2021,112,178,1,246888,776651,1023539,1,1,1,529763,In > Out
Sept 2021,112,184,1,903230190,1066823140,1970053330,1,1,1,163592950,In > Out
Sept 2021,112,185,1,30478393,22222855,52701248,1,1,1,8255538,Out > In
Sept 2021,112,186,1,220062,83367948,83588010,1,1,1,83147886,In > Out
Sept 2021,112,187,2,983062,58699540,59682602,2,1,2,57716478,In > Out
Sept 2021,112,193,16,436867701,890298419,1327166120,12,12,14,453430718,In > Out
Sept 2021,112,202,2,226299940,181810160,408110100,2,2,1,44489780,Out > In
Sept 2021,112,205,1,54947835,93800818,148748653,1,1,1,38852983,In > Out
Sept 2021,112,206,4,2589841,32424650,35014491,4,4,4,29834809,In > Out
Sept 2021,112,207,1,1911027,4359184,6270211,1,1,1,2448157,In > Out
Sept 2021,112,208,1,235861007,230017538,465878545,1,1,1,5843469,Out > In
Sept 2021,112,209,1,4446725,6195619,10642344,1,1,1,1748894,In > Out
Sept 2021,112,212,1,507893293,515862199,1023755492,1,1,1,7968906,In > Out
Sept 2021,112,22,2,100738632,564173216,664911848,1,1,2,463434584,In > Out
Sept 2021,112,25,2,364542283,421285303,785827586,2,2,1,56743020,In > Out
Sept 2021,112,28,1,88360,48832,137192,1,1,1,39528,Out > In
Sept 2021,112,31,11,69956407,180609659,250566066,7,7,8,110653252,In > Out
Sept 2021,112,32,1,8580,134998,143578,1,1,1,126418,In > Out
Sept 2021,112,36,2,19076063,30713653,49789716,1,1,2,11637590,In > Out
Sept 2021,112,38,1,9686,2862392,2872078,1,1,1,2852706,In > Out
Sept 2021,112,39,2,188696427,51640314,240336741,2,2,1,137056113,Out > In
Sept 2021,112,41,1,356416,227954237,228310653,1,1,1,227597821,In > Out
Sept 2021,112,42,2,824183,1319850,2144033,2,2,2,495667,In > Out
Sept 2021,112,45,2,823461,887815,1711276,2,2,1,64354,In > Out
Sept 2021,112,49,1,42544638,56713006,99257644,1,1,1,14168368,In > Out
Sept 2021,112,53,6,718957421,2221645783,2940603204,4,4,6,1502688362,In > Out
Sept 2021,112,59,3,22710190,19986652,42696842,3,3,3,2723538,Out > In
Sept 2021,112,64,5,427838249,784470955,1212309204,3,5,4,356632706,In > Out
Sept 2021,112,71,1,795886,2767068,3562954,1,1,1,1971182,In > Out
Sept 2021,112,72,2,18125771,115086608,133212379,2,2,2,96960837,In > Out
Sept 2021,112,74,1,15862379,19067899,34930278,1,1,1,3205520,In > Out
Sept 2021,112,78,13,160374614,526474761,686849375,5,5,13,366100147,In > Out
Sept 2021,112,86,10,1730302,2684942,4415244,5,7,3,954640,In > Out
Sept 2021,112,88,2,5331403,5816545,11147948,2,2,2,485142,In > Out
Sept 2021,112,9,34,5039333,30704661,35743994,5,4,34,25665328,In > Out
Sept 2021,112,90,1,33959118,5893987,39853105,1,1,1,28065131,Out > In
Sept 2021,112,91,14,2193689206,1748106682,3941795888,11,14,6,445582524,Out > In
Sept 2021,112,93,4,4820016744,2630340626,7450357370,2,1,4,2189676118,Out > In
Sept 2021,112,96,1,93918,57868,151786,1,1,1,36050,Out > In
Sept 2021,112,97,8,2273424385,4205639458,6479063843,5,6,2,1932215073,In > Out
Sept 2021,112,99,2,187799693,110751824,298551517,2,2,2,77047869,Out > In
Sept 2021,115,95,1,46500,13164916,13211416,1,1,1,13118416,In > Out
Sept 2021,117,150,117,479018054,172741182,651759236,74,46,2,306276872,Out > In
Sept 2021,117,151,6,20116298,14473136,34589434,2,1,6,5643162,Out > In
Sept 2021,117,208,12,153875854,1142489,155018343,1,12,1,152733365,Out > In
Sept 2021,117,209,4,85458362,121577349,207035711,4,4,4,36118987,In > Out
Sept 2021,117,236,725,89463827,89742564,179206391,25,721,3,278737,In > Out
Sept 2021,117,246,1028,966562188,35301228,1001863416,12,1016,1,931260960,Out > In
Sept 2021,117,50,154,1193918301,30562506,1224480807,1,2,153,1163355795,Out > In
Sept 2021,117,58,2,212248821,323408965,535657786,1,1,2,111160144,In > Out
Sept 2021,117,76,28,28819824,16314776,45134600,1,1,1,12505048,Out > In
Sept 2021,117,90,1888,48524328629,72598164222,121122492851,788,444,1346,24073835593,In > Out
Sept 2021,118,124,24,5722742431,82551924,5805294355,4,24,13,5640190507,Out > In
Sept 2021,118,137,5,148777923,10612013,159389936,2,5,5,138165910,Out > In
Sept 2021,118,140,2,1773540,26488208,28261748,1,1,2,24714668,In > Out
Sept 2021,118,144,2,13254455,109244157,122498612,2,1,2,95989702,In > Out
Sept 2021,118,177,6,1649241,151642682,153291923,4,3,6,149993441,In > Out
Sept 2021,118,191,4,941578280,379886952,1321465232,4,2,4,561691328,Out > In
Sept 2021,118,212,14,1413645215,1968581902,3382227117,10,7,14,554936687,In > Out
Sept 2021,118,225,1,137296,48306,185602,1,1,1,88990,Out > In
Sept 2021,118,28,58,43069367,1249549,44318916,43,58,3,41819818,Out > In
Sept 2021,118,46,6,6960719,11535227,18495946,4,6,6,4574508,In > Out
Sept 2021,118,47,3,150808177,9631936,160440113,2,3,3,141176241,Out > In
Sept 2021,118,63,2,14080374,5220849,19301223,1,1,2,8859525,Out > In
Sept 2021,118,85,6,43722100,315973092,359695192,1,1,6,272250992,In > Out
Sept 2021,119,102,24,110727044,2185553485,2296280529,1,24,1,2074826441,In > Out
Sept 2021,119,103,3,538824810,1044750542,1583575352,3,3,3,505925732,In > Out
Sept 2021,119,16,5,949909,201375,1151284,4,5,3,748534,Out > In
Sept 2021,119,160,38,34804284,1678687,36482971,3,38,1,33125597,Out > In
Sept 2021,119,168,1814,4346452802,1744101488,6090554290,53,1774,5,2602351314,Out > In
Sept 2021,119,199,4,240070534,275677636,515748170,3,1,4,35607102,In > Out
Sept 2021,119,73,1,4376118,38122104,42498222,1,1,1,33745986,In > Out
Sept 2021,120,105,4,614132309,1233832240,1847964549,4,2,4,619699931,In > Out
Sept 2021,120,193,2,64271,1346354,1410625,1,1,2,1282083,In > Out
Sept 2021,120,71,725,4311666905,63754064208,68065731113,9,704,2,59442397303,In > Out
Sept 2021,122,10,14,1324661,1262425,2587086,11,7,2,62236,Out > In
Sept 2021,122,104,14,380244942,3939288,384184230,10,14,1,376305654,Out > In
Sept 2021,122,105,24,1156026653,14762138,1170788791,16,24,2,1141264515,Out > In
Sept 2021,122,121,19,302270283,4876484,307146767,12,19,1,297393799,Out > In
Sept 2021,122,130,10,147395955,2421924,149817879,8,10,1,144974031,Out > In
Sept 2021,122,149,12,391391035,5023782,396414817,8,12,1,386367253,Out > In
Sept 2021,122,160,29,28452919,56488135,84941054,29,29,1,28035216,In > Out
Sept 2021,122,202,11,423345480,5487390,428832870,8,11,1,417858090,Out > In
Sept 2021,122,209,40,421307958,7271889,428579847,24,40,1,414036069,Out > In
Sept 2021,122,214,1813,5035788154,1711560492,6747348646,43,1775,1,3324227662,Out > In
Sept 2021,122,217,17,9819180,195922084,205741264,2,2,17,186102904,In > Out
Sept 2021,122,237,317,730686332,1740729591,2471415923,27,314,3,1010043259,In > Out
Sept 2021,122,73,8,289550548,3529950,293080498,6,8,1,286020598,Out > In
Sept 2021,122,78,1,102092,1231,103323,1,1,1,100861,Out > In
Sept 2021,123,101,1,8526264,3600074,12126338,1,1,1,4926190,Out > In
Sept 2021,123,103,11,4027044419,3961317967,7988362386,9,10,8,65726452,Out > In
Sept 2021,123,107,1,18884168,38410365,57294533,1,1,1,19526197,In > Out
Sept 2021,123,11,5,3205569408,2502342190,5707911598,5,5,5,703227218,Out > In
Sept 2021,123,116,2,348503950,168515229,517019179,1,2,2,179988721,Out > In
Sept 2021,123,117,2,1065866638,42184896,1108051534,2,2,2,1023681742,Out > In
Sept 2021,123,119,2,53040515,278919538,331960053,1,1,2,225879023,In > Out
Sept 2021,123,124,3,171703393,168748680,340452073,3,3,2,2954713,Out > In
Sept 2021,123,129,5,10745252,200231338,210976590,3,1,5,189486086,In > Out
Sept 2021,123,130,11,307464536,156178138,463642674,7,8,9,151286398,Out > In
Sept 2021,123,131,3,4013295,3874147,7887442,3,3,2,139148,Out > In
Sept 2021,123,133,1,166213350,159654688,325868038,1,1,1,6558662,Out > In
Sept 2021,123,134,1,1079208,1169332,2248540,1,1,1,90124,In > Out
Sept 2021,123,135,1,87189,86575,173764,1,1,1,614,Out > In
Sept 2021,123,136,1,2815884,9803328,12619212,1,1,1,6987444,In > Out
Sept 2021,123,137,1,255118354,298297648,553416002,1,1,1,43179294,In > Out
Sept 2021,123,138,1,103789585,512205853,615995438,1,1,1,408416268,In > Out
Sept 2021,123,140,2,67502948,193688743,261191691,1,1,2,126185795,In > Out
Sept 2021,123,141,2,2879288274,2900059351,5779347625,2,2,2,20771077,In > Out
Sept 2021,123,143,1,158457044,160445835,318902879,1,1,1,1988791,In > Out
Sept 2021,123,145,1,65784,133402,199186,1,1,1,67618,In > Out
Sept 2021,123,146,2,723858428,733626646,1457485074,2,2,1,9768218,In > Out
Sept 2021,123,149,2,9148053,12227967,21376020,2,2,2,3079914,In > Out
Sept 2021,123,150,1,20412,263836,284248,1,1,1,243424,In > Out
Sept 2021,123,151,1,543544,732343,1275887,1,1,1,188799,In > Out
Sept 2021,123,152,2,25087081,221245676,246332757,1,1,2,196158595,In > Out
Sept 2021,123,154,3,99243590,80197076,179440666,3,3,3,19046514,Out > In
Sept 2021,123,155,7,129536958,486164788,615701746,6,5,7,356627830,In > Out
Sept 2021,123,157,2,496321,430809,927130,2,1,2,65512,Out > In
Sept 2021,123,159,4,554587,2169953,2724540,3,4,3,1615366,In > Out
Sept 2021,123,16,1,11198160,13098396,24296556,1,1,1,1900236,In > Out
Sept 2021,123,163,1,2306150,324498782,326804932,1,1,1,322192632,In > Out
Sept 2021,123,164,2,1872987,1596187,3469174,2,2,2,276800,Out > In
Sept 2021,123,168,1,1828386939,2971484549,4799871488,1,1,1,1143097610,In > Out
Sept 2021,123,17,7,65205863,60931164,126137027,4,3,7,4274699,Out > In
Sept 2021,123,170,1,2802652,3114549,5917201,1,1,1,311897,In > Out
Sept 2021,123,171,1,89552,81178,170730,1,1,1,8374,Out > In
Sept 2021,123,172,1,122580,102508,225088,1,1,1,20072,Out > In
Sept 2021,123,174,2,197350,38900731,39098081,2,2,2,38703381,In > Out
Sept 2021,123,177,9,12067671,440890766,452958437,5,1,9,428823095,In > Out
Sept 2021,123,178,9,4695361,10984029,15679390,3,2,9,6288668,In > Out
Sept 2021,123,180,5,4775377,114217895,118993272,3,3,5,109442518,In > Out
Sept 2021,123,189,3,1132197406,1508289659,2640487065,3,3,3,376092253,In > Out
Sept 2021,123,190,4,71008812,520692769,591701581,2,2,4,449683957,In > Out
Sept 2021,123,197,2,1049581,1703233,2752814,2,2,2,653652,In > Out
Sept 2021,123,198,1,354064127,4910058020,5264122147,1,1,1,4555993893,In > Out
Sept 2021,123,199,1,377961094,340711923,718673017,1,1,1,37249171,Out > In
Sept 2021,123,200,1,5481,179547,185028,1,1,1,174066,In > Out
Sept 2021,123,201,2,4634311,148744794,153379105,2,1,2,144110483,In > Out
Sept 2021,123,204,2,112412293,171281742,283694035,1,1,2,58869449,In > Out
Sept 2021,123,206,1,5467160,6821995,12289155,1,1,1,1354835,In > Out
Sept 2021,123,208,13,83720564,366364359,450084923,13,13,7,282643795,In > Out
Sept 2021,123,21,1,358022,248629,606651,1,1,1,109393,Out > In
Sept 2021,123,211,3,204494705,251268767,455763472,3,3,2,46774062,In > Out
Sept 2021,123,216,3,2289431,10751443,13040874,3,3,3,8462012,In > Out
Sept 2021,123,217,1,138696715,374852452,513549167,1,1,1,236155737,In > Out
Sept 2021,123,219,5,5344865,30553823,35898688,3,3,5,25208958,In > Out
Sept 2021,123,221,4,2522321774,2528864827,5051186601,4,4,2,6543053,In > Out
Sept 2021,123,222,1,235487,221769,457256,1,1,1,13718,Out > In
Sept 2021,123,223,2,558467273,946258042,1504725315,2,2,1,387790769,In > Out
Sept 2021,123,24,4,417153132,730594067,1147747199,3,4,1,313440935,In > Out
Sept 2021,123,28,2,1432500,1246998,2679498,1,1,2,185502,Out > In
Sept 2021,123,31,10,4656077,169938344,174594421,5,4,10,165282267,In > Out
Sept 2021,123,33,3,227336148,1758513937,1985850085,2,2,3,1531177789,In > Out
Sept 2021,123,39,6,839100117,1105977604,1945077721,3,3,6,266877487,In > Out
Sept 2021,123,42,1,1861975772,1848639434,3710615206,1,1,1,13336338,Out > In
Sept 2021,123,45,2,3758333,177096032,180854365,1,1,2,173337699,In > Out
Sept 2021,123,48,2,170781,439866,610647,2,2,2,269085,In > Out
Sept 2021,123,5,4,15464953,89028357,104493310,4,4,4,73563404,In > Out
Sept 2021,123,55,3,1672535,2619922,4292457,3,1,3,947387,In > Out
Sept 2021,123,56,2,278561129,85068822,363629951,2,2,1,193492307,Out > In
Sept 2021,123,57,2,176422920,562634950,739057870,2,2,2,386212030,In > Out
Sept 2021,123,58,1,305425059,273461089,578886148,1,1,1,31963970,Out > In
Sept 2021,123,59,1,96656,325276,421932,1,1,1,228620,In > Out
Sept 2021,123,63,2,4786603,381615074,386401677,1,1,2,376828471,In > Out
Sept 2021,123,66,8,225604799,226621227,452226026,3,3,8,1016428,In > Out
Sept 2021,123,68,4,822708,178872314,179695022,2,1,4,178049606,In > Out
Sept 2021,123,70,1,5575878,6154664,11730542,1,1,1,578786,In > Out
Sept 2021,123,72,2,195518402,185655082,381173484,2,2,2,9863320,Out > In
Sept 2021,123,77,3,57694584,147433373,205127957,2,3,3,89738789,In > Out
Sept 2021,123,79,12,605352561,590470715,1195823276,10,12,7,14881846,Out > In
Sept 2021,123,81,2,33131683,94296818,127428501,2,2,2,61165135,In > Out
Sept 2021,123,86,23,36371289,13167988,49539277,9,2,23,23203301,Out > In
Sept 2021,123,87,1,50950558,34987820,85938378,1,1,1,15962738,Out > In
Sept 2021,123,89,1,21814175,22086185,43900360,1,1,1,272010,In > Out
Sept 2021,123,90,1,318308,245070,563378,1,1,1,73238,Out > In
Sept 2021,123,92,6,2955723940,2972756846,5928480786,5,5,3,17032906,In > Out
Sept 2021,123,96,1,9596678,55091948,64688626,1,1,1,45495270,In > Out
Sept 2021,123,97,3,10186021,29623687,39809708,2,2,3,19437666,In > Out
Sept 2021,123,98,36,57583978,18101099,75685077,35,36,36,39482879,Out > In
Sept 2021,123,99,1,1991602,36619241,38610843,1,1,1,34627639,In > Out
Sept 2021,124,100,4,2282128992,2091769035,4373898027,3,3,4,190359957,Out > In
Sept 2021,124,104,3,87283092,149174789,236457881,3,3,3,61891697,In > Out
Sept 2021,124,105,9,3038902643,3590052870,6628955513,4,6,2,551150227,In > Out
Sept 2021,124,108,3,3739221,43869928,47609149,3,3,2,40130707,In > Out
Sept 2021,124,109,3,27946613,91694556,119641169,3,3,3,63747943,In > Out
Sept 2021,124,110,3,20843930,123152383,143996313,3,3,3,102308453,In > Out
Sept 2021,124,113,2,44685734,43824175,88509909,1,2,2,861559,Out > In
Sept 2021,124,118,2,1765232,5493467,7258699,2,2,2,3728235,In > Out
Sept 2021,124,128,1,43871,59069,102940,1,1,1,15198,In > Out
Sept 2021,124,129,3,4372658,7049182,11421840,2,2,3,2676524,In > Out
Sept 2021,124,130,2,413698512,466494797,880193309,2,2,2,52796285,In > Out
Sept 2021,124,132,35,52332548,259923675,312256223,12,9,35,207591127,In > Out
Sept 2021,124,136,9,218458372,207267494,425725866,4,5,9,11190878,Out > In
Sept 2021,124,137,18,27797002,95866369,123663371,4,5,18,68069367,In > Out
Sept 2021,124,138,1,2494956,84482425,86977381,1,1,1,81987469,In > Out
Sept 2021,124,139,1,33894,167598,201492,1,1,1,133704,In > Out
Sept 2021,124,14,1,3571228,164038948,167610176,1,1,1,160467720,In > Out
Sept 2021,124,140,3,226709344,163852462,390561806,3,3,3,62856882,Out > In
Sept 2021,124,144,2,81940248,92772938,174713186,2,2,2,10832690,In > Out
Sept 2021,124,147,4,284349995,349777276,634127271,4,3,1,65427281,In > Out
Sept 2021,124,148,1,72591,72014,144605,1,1,1,577,Out > In
Sept 2021,124,149,3,77806565,78590743,156397308,3,3,3,784178,In > Out
Sept 2021,124,150,7,118529682,140898373,259428055,4,7,3,22368691,In > Out
Sept 2021,124,151,4,257235287,238529494,495764781,4,4,4,18705793,Out > In
Sept 2021,124,153,4,881318769,304119986,1185438755,3,2,2,577198783,Out > In
Sept 2021,124,154,3,985246145,958939776,1944185921,3,3,3,26306369,Out > In
Sept 2021,124,155,4,59584607,93172947,152757554,3,3,4,33588340,In > Out
Sept 2021,124,159,14,58435426,63787569,122222995,4,4,14,5352143,In > Out
Sept 2021,124,160,1,702883646,1059076261,1761959907,1,1,1,356192615,In > Out
Sept 2021,124,161,9,787004,5135587,5922591,2,1,9,4348583,In > Out
Sept 2021,124,163,3,16214805,37849393,54064198,3,3,3,21634588,In > Out
Sept 2021,124,164,1,9299,183490,192789,1,1,1,174191,In > Out
Sept 2021,124,165,1,1710776,1480357,3191133,1,1,1,230419,Out > In
Sept 2021,124,167,13,99149383,244963551,344112934,7,7,12,145814168,In > Out
Sept 2021,124,168,1,68765,262758,331523,1,1,1,193993,In > Out
Sept 2021,124,169,2,542878,474595,1017473,2,2,2,68283,Out > In
Sept 2021,124,17,43,54315606,519521712,573837318,5,5,43,465206106,In > Out
Sept 2021,124,172,190,142089087,3244933838,3387022925,176,176,7,3102844751,In > Out
Sept 2021,124,174,2,56257117,72144309,128401426,2,2,2,15887192,In > Out
Sept 2021,124,176,3,3195538,86550978,89746516,2,2,3,83355440,In > Out
Sept 2021,124,177,1,4152333,115919708,120072041,1,1,1,111767375,In > Out
Sept 2021,124,178,6,1874111,62519610,64393721,2,2,6,60645499,In > Out
Sept 2021,124,18,1,292622,48766444,49059066,1,1,1,48473822,In > Out
Sept 2021,124,181,9,346019418,515868064,861887482,4,4,6,169848646,In > Out
Sept 2021,124,182,2,618840,359032,977872,2,2,2,259808,Out > In
Sept 2021,124,183,1,26375947,29291706,55667653,1,1,1,2915759,In > Out
Sept 2021,124,184,6,151367333,146738483,298105816,5,6,6,4628850,Out > In
Sept 2021,124,185,1,55158,72159,127317,1,1,1,17001,In > Out
Sept 2021,124,187,3,8411935,6616157,15028092,2,3,2,1795778,Out > In
Sept 2021,124,19,2,2211661,125488035,127699696,1,1,2,123276374,In > Out
Sept 2021,124,190,4,155734400,100478968,256213368,2,2,4,55255432,Out > In
Sept 2021,124,191,2,152551197,67310379,219861576,2,2,2,85240818,Out > In
Sept 2021,124,192,1,315037055,314642066,629679121,1,1,1,394989,Out > In
Sept 2021,124,193,9,10486283,10140261,20626544,3,9,9,346022,Out > In
Sept 2021,124,197,3,5546840,49871256,55418096,2,2,3,44324416,In > Out
Sept 2021,124,200,1,14871392,18947607,33818999,1,1,1,4076215,In > Out
Sept 2021,124,201,3,192234,12941832,13134066,1,1,3,12749598,In > Out
Sept 2021,124,202,2,3562846,4255720,7818566,2,2,2,692874,In > Out
Sept 2021,124,206,1,1949384,2585283,4534667,1,1,1,635899,In > Out
Sept 2021,124,208,5,1648476181,465213070,2113689251,3,3,2,1183263111,Out > In
Sept 2021,124,211,2,59647268,64678813,124326081,1,1,2,5031545,In > Out
Sept 2021,124,213,3,697530221,374067531,1071597752,3,3,1,323462690,Out > In
Sept 2021,124,215,1,203806097,286817733,490623830,1,1,1,83011636,In > Out
Sept 2021,124,219,3,9967222,8909340,18876562,3,3,3,1057882,Out > In
Sept 2021,124,223,2,925910286,903017346,1828927632,2,2,2,22892940,Out > In
Sept 2021,124,23,1,34545780,265791692,300337472,1,1,1,231245912,In > Out
Sept 2021,124,26,7,3265830,61667050,64932880,2,2,7,58401220,In > Out
Sept 2021,124,27,1,2321499,9602825,11924324,1,1,1,7281326,In > Out
Sept 2021,124,29,83,539796032,1762553582,2302349614,33,64,50,1222757550,In > Out
Sept 2021,124,32,5,200124914,868005890,1068130804,4,2,5,667880976,In > Out
Sept 2021,124,33,8,897552548,2097185447,2994737995,4,4,8,1199632899,In > Out
Sept 2021,124,35,1,2121161,52457,2173618,1,1,1,2068704,Out > In
Sept 2021,124,36,3,148858712,123685052,272543764,2,3,3,25173660,Out > In
Sept 2021,124,37,2,9421041,14672653,24093694,2,2,1,5251612,In > Out
Sept 2021,124,41,2,15176355,25161214,40337569,1,2,2,9984859,In > Out
Sept 2021,124,43,3,6684755,3178131,9862886,2,3,3,3506624,Out > In
Sept 2021,124,44,4,16587809,49917687,66505496,4,1,4,33329878,In > Out
Sept 2021,124,45,24,41362506,120126639,161489145,10,9,24,78764133,In > Out
Sept 2021,124,46,2,5156848546,4110063387,9266911933,1,2,1,1046785159,Out > In
Sept 2021,124,48,1,144505057,163258645,307763702,1,1,1,18753588,In > Out
Sept 2021,124,51,4,125832204,86661433,212493637,1,4,4,39170771,Out > In
Sept 2021,124,53,1,69640,75308,144948,1,1,1,5668,In > Out
Sept 2021,124,54,6,805511713,1025404160,1830915873,5,4,2,219892447,In > Out
Sept 2021,124,55,2,164266972,163728077,327995049,2,2,1,538895,Out > In
Sept 2021,124,58,3,184716028,222307066,407023094,2,2,3,37591038,In > Out
Sept 2021,124,59,3,110962237,44875847,155838084,2,2,3,66086390,Out > In
Sept 2021,124,64,23,82701078,63802605,146503683,6,6,23,18898473,Out > In
Sept 2021,124,73,1,330420497,437427754,767848251,1,1,1,107007257,In > Out
Sept 2021,124,74,1,241369103,232826363,474195466,1,1,1,8542740,Out > In
Sept 2021,124,77,6,25022346,25991319,51013665,6,2,2,968973,In > Out
Sept 2021,124,78,6,63101043,88144359,151245402,5,6,4,25043316,In > Out
Sept 2021,124,8,3,120492,360524,481016,3,2,3,240032,In > Out
Sept 2021,124,81,4,4199379,151734612,155933991,2,2,4,147535233,In > Out
Sept 2021,124,83,2,2601408,10178171,12779579,2,1,2,7576763,In > Out
Sept 2021,124,9,1,3415192,28302347,31717539,1,1,1,24887155,In > Out
Sept 2021,124,91,2,3984334,2547727,6532061,2,2,1,1436607,Out > In
Sept 2021,124,96,1,3259572,89861941,93121513,1,1,1,86602369,In > Out
Sept 2021,125,153,3,62566700,147496813,210063513,3,3,3,84930113,In > Out
Sept 2021,125,157,14,6163731,12134741,18298472,7,4,4,5971010,In > Out
Sept 2021,125,210,2,52538771,1371907,53910678,1,2,2,51166864,Out > In
Sept 2021,125,43,3,643106137,29687019,672793156,1,3,1,613419118,Out > In
Sept 2021,125,51,7,96521562,228417414,324938976,5,2,7,131895852,In > Out
Sept 2021,125,53,6,10542782,38152271,48695053,5,2,6,27609489,In > Out
Sept 2021,126,25,3,16157380456,288166972,16445547428,1,3,1,15869213484,Out > In
Sept 2021,127,100,10,5674763,8367423,14042186,5,8,9,2692660,In > Out
Sept 2021,127,103,2,1034415,7571438,8605853,2,1,2,6537023,In > Out
Sept 2021,127,105,1,269234,13079,282313,1,1,1,256155,Out > In
Sept 2021,127,109,1,7240992,86435880,93676872,1,1,1,79194888,In > Out
Sept 2021,127,11,2,298454684,157935807,456390491,2,2,1,140518877,Out > In
Sept 2021,127,117,3,313722037,372266027,685988064,3,3,3,58543990,In > Out
Sept 2021,127,121,6,6899027,583751466,590650493,5,2,6,576852439,In > Out
Sept 2021,127,124,3,30763402,9257284,40020686,3,2,3,21506118,Out > In
Sept 2021,127,126,2,170176,5814559,5984735,2,2,2,5644383,In > Out
Sept 2021,127,13,22,29845979,81246576,111092555,8,8,22,51400597,In > Out
Sept 2021,127,131,1,61425,301816,363241,1,1,1,240391,In > Out
Sept 2021,127,132,6,51815430,67969062,119784492,2,2,6,16153632,In > Out
Sept 2021,127,134,2,1019659096,995180218,2014839314,2,2,1,24478878,Out > In
Sept 2021,127,136,4,91735948,62025050,153760998,4,4,3,29710898,Out > In
Sept 2021,127,137,1,1224351549,1279257319,2503608868,1,1,1,54905770,In > Out
Sept 2021,127,139,11,66197504,56598630,122796134,4,11,9,9598874,Out > In
Sept 2021,127,14,13,4724116,49982674,54706790,2,2,13,45258558,In > Out
Sept 2021,127,141,5,523667495,645476234,1169143729,3,3,5,121808739,In > Out
Sept 2021,127,142,1,4027228,2584404,6611632,1,1,1,1442824,Out > In
Sept 2021,127,146,6,212568,6005927,6218495,6,1,6,5793359,In > Out
Sept 2021,127,147,1,202997,287310,490307,1,1,1,84313,In > Out
Sept 2021,127,148,6,288355253,1074671058,1363026311,5,6,6,786315805,In > Out
Sept 2021,127,149,3,38849194,34615175,73464369,3,2,2,4234019,Out > In
Sept 2021,127,151,1,52406981,56406198,108813179,1,1,1,3999217,In > Out
Sept 2021,127,152,3,24292365,8268203,32560568,3,3,3,16024162,Out > In
Sept 2021,127,156,1,523942,3321980,3845922,1,1,1,2798038,In > Out
Sept 2021,127,159,1,263195721,241733549,504929270,1,1,1,21462172,Out > In
Sept 2021,127,160,3,1839309359,2137991180,3977300539,3,3,1,298681821,In > Out
Sept 2021,127,162,1,217889,174303,392192,1,1,1,43586,Out > In
Sept 2021,127,163,1,4634560,5497367,10131927,1,1,1,862807,In > Out
Sept 2021,127,165,1,1795969,115080136,116876105,1,1,1,113284167,In > Out
Sept 2021,127,166,2,1150044813,210067713,1360112526,2,2,2,939977100,Out > In
Sept 2021,127,168,1,284802,57594,342396,1,1,1,227208,Out > In
Sept 2021,127,169,1,11546429,11131682,22678111,1,1,1,414747,Out > In
Sept 2021,127,17,3,23848116,30258171,54106287,3,3,3,6410055,In > Out
Sept 2021,127,173,11,447149852,1005664018,1452813870,6,2,11,558514166,In > Out
Sept 2021,127,175,1,53771,60174,113945,1,1,1,6403,In > Out
Sept 2021,127,176,4,505686983,55552577,561239560,2,3,1,450134406,Out > In
Sept 2021,127,177,1,717467,743938,1461405,1,1,1,26471,In > Out
Sept 2021,127,178,2,262143793,443292234,705436027,2,2,1,181148441,In > Out
Sept 2021,127,180,5,138915,2308194,2447109,4,1,5,2169279,In > Out
Sept 2021,127,181,16,4897619967,4193885582,9091505549,7,15,10,703734385,Out > In
Sept 2021,127,183,1,2322019,67113387,69435406,1,1,1,64791368,In > Out
Sept 2021,127,185,4,1712731,12183101,13895832,3,2,4,10470370,In > Out
Sept 2021,127,186,4,8505595,48292727,56798322,3,4,3,39787132,In > Out
Sept 2021,127,187,6,588566506,582139299,1170705805,5,5,5,6427207,Out > In
Sept 2021,127,189,1,15450,307174,322624,1,1,1,291724,In > Out
Sept 2021,127,190,6,94645119,121648637,216293756,4,6,5,27003518,In > Out
Sept 2021,127,191,4,22337701,77860860,100198561,4,3,3,55523159,In > Out
Sept 2021,127,192,5,60300954,184726500,245027454,5,5,5,124425546,In > Out
Sept 2021,127,193,1,101382489,106530009,207912498,1,1,1,5147520,In > Out
Sept 2021,127,194,4,2117290,9887320,12004610,3,2,4,7770030,In > Out
Sept 2021,127,197,2,5688394,96160480,101848874,2,1,2,90472086,In > Out
Sept 2021,127,198,6,2691575,3780571,6472146,1,1,6,1088996,In > Out
Sept 2021,127,200,12,3506295,14914458,18420753,3,2,12,11408163,In > Out
Sept 2021,127,202,1,247401,8600354,8847755,1,1,1,8352953,In > Out
Sept 2021,127,203,8,86291336,632779187,719070523,4,6,6,546487851,In > Out
Sept 2021,127,205,2,82169488,660827642,742997130,2,2,1,578658154,In > Out
Sept 2021,127,206,4,770009959,621232856,1391242815,3,3,4,148777103,Out > In
Sept 2021,127,207,8,164848230,181941818,346790048,5,5,8,17093588,In > Out
Sept 2021,127,208,2,51221,888774,939995,2,1,2,837553,In > Out
Sept 2021,127,209,13,48936377,169911920,218848297,3,8,13,120975543,In > Out
Sept 2021,127,21,1,1478742,298827252,300305994,1,1,1,297348510,In > Out
Sept 2021,127,211,1,2326110,1895531,4221641,1,1,1,430579,Out > In
Sept 2021,127,212,3,13412781,181010272,194423053,1,1,3,167597491,In > Out
Sept 2021,127,215,2,15239823,52620399,67860222,2,2,2,37380576,In > Out
Sept 2021,127,217,2,48795898,19910207,68706105,2,2,2,28885691,Out > In
Sept 2021,127,219,5,66510354,24355420,90865774,2,2,2,42154934,Out > In
Sept 2021,127,220,2,12601424,71113560,83714984,2,2,2,58512136,In > Out
Sept 2021,127,223,3,490043220,484753641,974796861,3,2,1,5289579,Out > In
Sept 2021,127,23,1,4023020575,7423415145,11446435720,1,1,1,3400394570,In > Out
Sept 2021,127,24,2,784111,1490195,2274306,2,2,1,706084,In > Out
Sept 2021,127,26,1,4548643,5416008,9964651,1,1,1,867365,In > Out
Sept 2021,127,27,1,69103430,62102520,131205950,1,1,1,7000910,Out > In
Sept 2021,127,28,3,21803251,90332502,112135753,3,3,3,68529251,In > Out
Sept 2021,127,35,2,607229327,1201360616,1808589943,2,2,2,594131289,In > Out
Sept 2021,127,36,5,332179681,367676257,699855938,4,5,2,35496576,In > Out
Sept 2021,127,37,17,45330199,35530823,80861022,10,12,12,9799376,Out > In
Sept 2021,127,40,1,6191477,8988805,15180282,1,1,1,2797328,In > Out
Sept 2021,127,41,3,344798308,388217121,733015429,3,3,2,43418813,In > Out
Sept 2021,127,5,1,7638224,4550634,12188858,1,1,1,3087590,Out > In
Sept 2021,127,50,6,664443899,524635329,1189079228,4,4,5,139808570,Out > In
Sept 2021,127,52,32,2231736439,2201505299,4433241738,20,31,30,30231140,Out > In
Sept 2021,127,54,11,12038787,11174376,23213163,3,3,11,864411,Out > In
Sept 2021,127,55,1,718301,955761,1674062,1,1,1,237460,In > Out
Sept 2021,127,59,2,241212655,258508216,499720871,2,2,1,17295561,In > Out
Sept 2021,127,62,1,23861,200235,224096,1,1,1,176374,In > Out
Sept 2021,127,63,1,166247,262844,429091,1,1,1,96597,In > Out
Sept 2021,127,65,1,6236622,263211737,269448359,1,1,1,256975115,In > Out
Sept 2021,127,66,1,13684665,8033741,21718406,1,1,1,5650924,Out > In
Sept 2021,127,67,3,2306689900,2709219873,5015909773,3,2,2,402529973,In > Out
Sept 2021,127,7,2,4227969,6386968,10614937,1,2,2,2158999,In > Out
Sept 2021,127,73,5,66454682,180793297,247247979,3,2,5,114338615,In > Out
Sept 2021,127,77,5,105352883,130863431,236216314,4,5,5,25510548,In > Out
Sept 2021,127,8,3,37196265,158062074,195258339,2,2,3,120865809,In > Out
Sept 2021,127,80,1,27778,107929,135707,1,1,1,80151,In > Out
Sept 2021,127,81,7,13266851,363199617,376466468,4,2,7,349932766,In > Out
Sept 2021,127,82,3,198828099,279220745,478048844,2,2,3,80392646,In > Out
Sept 2021,127,89,14,15088987,53688166,68777153,4,4,14,38599179,In > Out
Sept 2021,127,92,1,995346275,938368465,1933714740,1,1,1,56977810,Out > In
Sept 2021,127,93,2,4315413,15889250,20204663,1,2,2,11573837,In > Out
Sept 2021,127,99,1,1420303792,671240126,2091543918,1,1,1,749063666,Out > In
Sept 2021,128,103,2,63641322,122572796,186214118,2,2,2,58931474,In > Out
Sept 2021,128,105,4,134186096,131714707,265900803,3,4,1,2471389,Out > In
Sept 2021,128,107,1,571636119,596752727,1168388846,1,1,1,25116608,In > Out
Sept 2021,128,111,150,78445110,223719425,302164535,130,142,15,145274315,In > Out
Sept 2021,128,112,2,1546828557,1555714104,3102542661,2,2,1,8885547,In > Out
Sept 2021,128,116,4,1510718375,235693292,1746411667,4,4,3,1275025083,Out > In
Sept 2021,128,124,3,1067285579,493180214,1560465793,3,2,1,574105365,Out > In
Sept 2021,128,125,1,302008502,150402652,452411154,1,1,1,151605850,Out > In
Sept 2021,128,126,24,6226479,17944750,24171229,6,5,23,11718271,In > Out
Sept 2021,128,127,1,43030,319216,362246,1,1,1,276186,In > Out
Sept 2021,128,130,37,5196991,122799940,127996931,33,37,15,117602949,In > Out
Sept 2021,128,139,3,16059598,291153732,307213330,2,2,3,275094134,In > Out
Sept 2021,128,14,1,2812995,182765576,185578571,1,1,1,179952581,In > Out
Sept 2021,128,142,7,1547177157,2225751287,3772928444,5,7,4,678574130,In > Out
Sept 2021,128,146,1,484360,485024,969384,1,1,1,664,In > Out
Sept 2021,128,147,6,324964434,328675349,653639783,4,4,5,3710915,In > Out
Sept 2021,128,149,1,316171990,506090598,822262588,1,1,1,189918608,In > Out
Sept 2021,128,151,3,56382470,58580049,114962519,3,3,3,2197579,In > Out
Sept 2021,128,152,1,221786,105191351,105413137,1,1,1,104969565,In > Out
Sept 2021,128,153,1,159397,5728137,5887534,1,1,1,5568740,In > Out
Sept 2021,128,155,3,192362083,184093967,376456050,3,3,2,8268116,Out > In
Sept 2021,128,16,3,465787947,677880312,1143668259,3,3,2,212092365,In > Out
Sept 2021,128,162,2,58966380,86922700,145889080,2,2,2,27956320,In > Out
Sept 2021,128,163,3,630186270,412790088,1042976358,3,3,2,217396182,Out > In
Sept 2021,128,165,4,3226621424,2206988478,5433609902,4,4,1,1019632946,Out > In
Sept 2021,128,171,3,71094142,187800036,258894178,2,1,3,116705894,In > Out
Sept 2021,128,177,4,1027031745,1253311390,2280343135,3,2,4,226279645,In > Out
Sept 2021,128,178,4,46746256,55192607,101938863,1,4,4,8446351,In > Out
Sept 2021,128,18,1,34313,107394,141707,1,1,1,73081,In > Out
Sept 2021,128,181,1,139498494,147496910,286995404,1,1,1,7998416,In > Out
Sept 2021,128,186,26,6419264,56793364,63212628,2,2,26,50374100,In > Out
Sept 2021,128,187,8,377010384,883706549,1260716933,4,2,6,506696165,In > Out
Sept 2021,128,189,10,173274349,179503937,352778286,5,6,9,6229588,In > Out
Sept 2021,128,191,2,7297463,550356,7847819,1,2,2,6747107,Out > In
Sept 2021,128,192,2,15817121,12869066,28686187,2,2,2,2948055,Out > In
Sept 2021,128,193,8,4530278087,4038172364,8568450451,5,8,4,492105723,Out > In
Sept 2021,128,194,1,104671,114897,219568,1,1,1,10226,In > Out
Sept 2021,128,195,12,6536059401,6767593131,13303652532,9,10,7,231533730,In > Out
Sept 2021,128,197,1,7991057,159725080,167716137,1,1,1,151734023,In > Out
Sept 2021,128,198,7,191615923,1176218620,1367834543,2,6,6,984602697,In > Out
Sept 2021,128,200,37,616723,19194160,19810883,36,36,2,18577437,In > Out
Sept 2021,128,206,2,6630592,297964283,304594875,1,1,2,291333691,In > Out
Sept 2021,128,21,2,776720396,758851238,1535571634,1,2,1,17869158,Out > In
Sept 2021,128,210,1,57266448,141222521,198488969,1,1,1,83956073,In > Out
Sept 2021,128,211,7,813668912,570544547,1384213459,5,6,6,243124365,Out > In
Sept 2021,128,212,2,2505156,65581716,68086872,1,1,2,63076560,In > Out
Sept 2021,128,214,6,22932068,225106438,248038506,4,3,6,202174370,In > Out
Sept 2021,128,215,12,74525851,80072003,154597854,6,6,10,5546152,In > Out
Sept 2021,128,216,1,26046203,36004768,62050971,1,1,1,9958565,In > Out
Sept 2021,128,22,1,51942328,127105299,179047627,1,1,1,75162971,In > Out
Sept 2021,128,220,1,76776,232797,309573,1,1,1,156021,In > Out
Sept 2021,128,223,1,206603963,202291919,408895882,1,1,1,4312044,Out > In
Sept 2021,128,23,3,114939987,121392460,236332447,2,1,1,6452473,In > Out
Sept 2021,128,25,5,2451516,5306019,7757535,3,3,5,2854503,In > Out
Sept 2021,128,29,4,184969733,94741575,279711308,4,4,1,90228158,Out > In
Sept 2021,128,31,3,413269549,786246099,1199515648,3,3,2,372976550,In > Out
Sept 2021,128,36,3,10278389,762695363,772973752,3,2,3,752416974,In > Out
Sept 2021,128,37,6,4067635495,4776217251,8843852746,4,4,2,708581756,In > Out
Sept 2021,128,38,1,25402908,34064653,59467561,1,1,1,8661745,In > Out
Sept 2021,128,4,1,680861640,595484299,1276345939,1,1,1,85377341,Out > In
Sept 2021,128,44,5,1914060,2593029,4507089,1,5,1,678969,In > Out
Sept 2021,128,45,1,200866,1304437,1505303,1,1,1,1103571,In > Out
Sept 2021,128,46,1,3475589,54132009,57607598,1,1,1,50656420,In > Out
Sept 2021,128,48,1,96729,1815927,1912656,1,1,1,1719198,In > Out
Sept 2021,128,50,2,107198708,67610152,174808860,2,2,1,39588556,Out > In
Sept 2021,128,51,2,11380285,38859514,50239799,2,2,2,27479229,In > Out
Sept 2021,128,54,43,31034992,387009861,418044853,5,5,43,355974869,In > Out
Sept 2021,128,57,3,667298731,649976455,1317275186,3,3,3,17322276,Out > In
Sept 2021,128,60,10,181652382,607526332,789178714,5,6,9,425873950,In > Out
Sept 2021,128,62,2,253689791,237003893,490693684,2,2,2,16685898,Out > In
Sept 2021,128,71,1,3056732,2027661,5084393,1,1,1,1029071,Out > In
Sept 2021,128,72,3,325734432,695698160,1021432592,2,2,3,369963728,In > Out
Sept 2021,128,76,4,210961666,764292332,975253998,3,3,3,553330666,In > Out
Sept 2021,128,79,4,27116198,33329163,60445361,4,4,2,6212965,In > Out
Sept 2021,128,8,2,1204678139,2278259757,3482937896,2,2,2,1073581618,In > Out
Sept 2021,128,80,19,1432994,50258962,51691956,19,19,4,48825968,In > Out
Sept 2021,128,87,48,19419401,589936286,609355687,11,7,48,570516885,In > Out
Sept 2021,128,89,1,1316059741,1328654306,2644714047,1,1,1,12594565,In > Out
Sept 2021,128,99,9,357245533,3642297782,3999543315,2,2,3,3285052249,In > Out
Sept 2021,129,153,1,602858,3618422,4221280,1,1,1,3015564,In > Out
Sept 2021,129,158,1,457268,15155,472423,1,1,1,442113,Out > In
Sept 2021,129,160,3870,785746489,65277482,851023971,789,3656,1,720469007,Out > In
Sept 2021,129,175,68,15181693,312789,15494482,55,68,2,14868904,Out > In
Sept 2021,129,189,82,23483432,483202,23966634,49,82,2,23000230,Out > In
Sept 2021,129,218,6,659266,30441,689707,1,6,1,628825,Out > In
Sept 2021,129,230,74,70488822,6468386,76957208,53,24,1,64020436,Out > In
Sept 2021,129,236,6,742161,749064,1491225,6,3,1,6903,In > Out
Sept 2021,129,242,111,360849784,150447180,511296964,78,42,1,210402604,Out > In
Sept 2021,129,46,2,2581511,118137545,120719056,1,1,2,115556034,In > Out
Sept 2021,129,56,1,119751,52646,172397,1,1,1,67105,Out > In
Sept 2021,129,97,3,2866937,23170168,26037105,2,3,3,20303231,In > Out
Sept 2021,130,107,3,488456372,1220120870,1708577242,2,3,3,731664498,In > Out
Sept 2021,130,135,2,20168095,61091194,81259289,2,2,2,40923099,In > Out
Sept 2021,130,174,3,55701176,528676815,584377991,3,2,3,472975639,In > Out
Sept 2021,130,56,1,18917239,50358223,69275462,1,1,1,31440984,In > Out
Sept 2021,130,60,1,2005501,15735448,17740949,1,1,1,13729947,In > Out
Sept 2021,130,61,4,35260773,45209833,80470606,2,2,4,9949060,In > Out
Sept 2021,130,64,7,2743661,1285052,4028713,1,1,7,1458609,Out > In
Sept 2021,130,77,1,51394,75050,126444,1,1,1,23656,In > Out
Sept 2021,130,79,1,3671079,50043885,53714964,1,1,1,46372806,In > Out
Sept 2021,131,100,2,1970638,4404681,6375319,2,2,1,2434043,In > Out
Sept 2021,131,105,4,1090565506,1167770401,2258335907,3,3,3,77204895,In > Out
Sept 2021,131,108,1,5440528,34193181,39633709,1,1,1,28752653,In > Out
Sept 2021,131,110,1,517008369,766036508,1283044877,1,1,1,249028139,In > Out
Sept 2021,131,113,11,849180923,805015731,1654196654,2,11,11,44165192,Out > In
Sept 2021,131,114,1,99796,144348,244144,1,1,1,44552,In > Out
Sept 2021,131,12,10,1901757429,1685598367,3587355796,8,10,4,216159062,Out > In
Sept 2021,131,121,1,262639,261401,524040,1,1,1,1238,Out > In
Sept 2021,131,123,1,1117590,1332318,2449908,1,1,1,214728,In > Out
Sept 2021,131,124,2,230155979,210143889,440299868,2,2,2,20012090,Out > In
Sept 2021,131,127,5,197466592,265181286,462647878,5,5,5,67714694,In > Out
Sept 2021,131,128,7,142808370,256854538,399662908,2,4,7,114046168,In > Out
Sept 2021,131,130,2,772659117,471416665,1244075782,2,2,2,301242452,Out > In
Sept 2021,131,131,2,77882354,153961875,231844229,2,2,2,76079521,In > Out
Sept 2021,131,134,2,2758577700,2330089653,5088667353,2,2,1,428488047,Out > In
Sept 2021,131,136,2,5586901,27420479,33007380,1,1,2,21833578,In > Out
Sept 2021,131,137,4,24662160,122893377,147555537,4,2,4,98231217,In > Out
Sept 2021,131,14,3,3014117879,2435943793,5450061672,1,2,1,578174086,Out > In
Sept 2021,131,140,1,413559223,472270783,885830006,1,1,1,58711560,In > Out
Sept 2021,131,145,16,1015851552,375883425,1391734977,10,15,15,639968127,Out > In
Sept 2021,131,147,10,494746159,350123117,844869276,8,3,10,144623042,Out > In
Sept 2021,131,151,1,116389,15634694,15751083,1,1,1,15518305,In > Out
Sept 2021,131,156,4,248729833,181533213,430263046,4,4,4,67196620,Out > In
Sept 2021,131,159,7,46214411,309705962,355920373,5,4,7,263491551,In > Out
Sept 2021,131,162,1,371936049,329472149,701408198,1,1,1,42463900,Out > In
Sept 2021,131,175,4,250271,710415,960686,4,3,4,460144,In > Out
Sept 2021,131,178,2,94445136,97990942,192436078,2,2,2,3545806,In > Out
Sept 2021,131,179,1,1132668975,1137645573,2270314548,1,1,1,4976598,In > Out
Sept 2021,131,18,3,17793302,17303992,35097294,1,1,3,489310,Out > In
Sept 2021,131,181,2,1965669225,1926895456,3892564681,2,2,2,38773769,Out > In
Sept 2021,131,183,29,2839524445,2491030686,5330555131,17,27,29,348493759,Out > In
Sept 2021,131,186,614,321334687,2550412082,2871746769,212,265,9,2229077395,In > Out
Sept 2021,131,188,2,298335,408653,706988,2,2,2,110318,In > Out
Sept 2021,131,192,1,2468401,3901521,6369922,1,1,1,1433120,In > Out
Sept 2021,131,194,10,12474790,22219121,34693911,2,2,10,9744331,In > Out
Sept 2021,131,196,1,5520339,15780135,21300474,1,1,1,10259796,In > Out
Sept 2021,131,199,2,25123375,23782561,48905936,2,2,2,1340814,Out > In
Sept 2021,131,20,2,386066,27295667,27681733,2,2,2,26909601,In > Out
Sept 2021,131,201,4,38792485,25546710,64339195,4,4,3,13245775,Out > In
Sept 2021,131,203,12,2938175850,4960179375,7898355225,7,7,10,2022003525,In > Out
Sept 2021,131,205,2,14744778,24704574,39449352,2,2,2,9959796,In > Out
Sept 2021,131,208,1,3946299,78513211,82459510,1,1,1,74566912,In > Out
Sept 2021,131,21,7,835698662,1475601941,2311300603,3,6,3,639903279,In > Out
Sept 2021,131,210,3,1044815656,1544455843,2589271499,2,3,3,499640187,In > Out
Sept 2021,131,212,1,32189,109725,141914,1,1,1,77536,In > Out
Sept 2021,131,214,1,6636,435926,442562,1,1,1,429290,In > Out
Sept 2021,131,218,2,3723947,112490863,116214810,2,2,2,108766916,In > Out
Sept 2021,131,219,5,8074669,58547823,66622492,2,2,2,50473154,In > Out
Sept 2021,131,220,116,1191712758,1708930093,2900642851,110,115,14,517217335,In > Out
Sept 2021,131,23,4,102104377,98888543,200992920,3,4,4,3215834,Out > In
Sept 2021,131,24,1,107225,45498,152723,1,1,1,61727,Out > In
Sept 2021,131,26,1,24028,2102704,2126732,1,1,1,2078676,In > Out
Sept 2021,131,27,1,27123824,56019192,83143016,1,1,1,28895368,In > Out
Sept 2021,131,29,4,2987542774,2949917881,5937460655,4,3,3,37624893,Out > In
Sept 2021,131,30,1,57847,53807,111654,1,1,1,4040,Out > In
Sept 2021,131,32,4,102437116,718284023,820721139,3,3,3,615846907,In > Out
Sept 2021,131,33,2,2433045,19376194,21809239,2,1,2,16943149,In > Out
Sept 2021,131,34,2,37999071,128470741,166469812,1,2,2,90471670,In > Out
Sept 2021,131,36,3,168516279,364477616,532993895,2,3,1,195961337,In > Out
Sept 2021,131,37,2,3375792,44873355,48249147,2,1,2,41497563,In > Out
Sept 2021,131,39,1,127374,66058148,66185522,1,1,1,65930774,In > Out
Sept 2021,131,40,1,12983436,15290845,28274281,1,1,1,2307409,In > Out
Sept 2021,131,41,2,436344,534263,970607,2,2,2,97919,In > Out
Sept 2021,131,42,2,5317161,128157728,133474889,2,1,2,122840567,In > Out
Sept 2021,131,46,4,166669924,1583041936,1749711860,4,2,4,1416372012,In > Out
Sept 2021,131,48,2,788969688,532883474,1321853162,2,2,2,256086214,Out > In
Sept 2021,131,49,2,6680867360,8028483413,14709350773,2,2,1,1347616053,In > Out
Sept 2021,131,52,1,591055,2462676,3053731,1,1,1,1871621,In > Out
Sept 2021,131,53,2,5656674,620946,6277620,2,1,2,5035728,Out > In
Sept 2021,131,55,2,59962321,91180382,151142703,2,2,1,31218061,In > Out
Sept 2021,131,56,2,495722,373963,869685,1,2,2,121759,Out > In
Sept 2021,131,57,5,92013958,68188212,160202170,5,5,4,23825746,Out > In
Sept 2021,131,59,8,234377620,326908563,561286183,6,4,8,92530943,In > Out
Sept 2021,131,61,3,30164256,31231689,61395945,1,3,3,1067433,In > Out
Sept 2021,131,62,9,1256255840,1355175135,2611430975,7,6,1,98919295,In > Out
Sept 2021,131,64,6,9344210,22782717,32126927,3,4,6,13438507,In > Out
Sept 2021,131,67,1,110616,627532,738148,1,1,1,516916,In > Out
Sept 2021,131,73,7,178594319,288857932,467452251,4,2,7,110263613,In > Out
Sept 2021,131,75,5,317415668,210864032,528279700,2,5,5,106551636,Out > In
Sept 2021,131,76,10,799260588,355356318,1154616906,4,4,10,443904270,Out > In
Sept 2021,131,78,2,201365,257076,458441,2,2,2,55711,In > Out
Sept 2021,131,83,8,1520804240,1431814502,2952618742,5,8,8,88989738,Out > In
Sept 2021,131,85,2,1044000,2356451,3400451,2,2,2,1312451,In > Out
Sept 2021,131,90,1,114746819,192410705,307157524,1,1,1,77663886,In > Out
Sept 2021,131,92,10,35625904,65639413,101265317,7,4,10,30013509,In > Out
Sept 2021,131,98,3,5829126,55015653,60844779,3,3,3,49186527,In > Out
Sept 2021,132,100,2,106085,347786,453871,2,1,2,241701,In > Out
Sept 2021,132,102,1,217830,88044159,88261989,1,1,1,87826329,In > Out
Sept 2021,132,106,5,8605565,11512843,20118408,5,5,5,2907278,In > Out
Sept 2021,132,11,1,3025297,3645828,6671125,1,1,1,620531,In > Out
Sept 2021,132,110,3,11731336,12544378,24275714,3,3,3,813042,In > Out
Sept 2021,132,112,1,263411,870027,1133438,1,1,1,606616,In > Out
Sept 2021,132,117,1,12458874,48537457,60996331,1,1,1,36078583,In > Out
Sept 2021,132,119,2,51476861,81235273,132712134,1,1,2,29758412,In > Out
Sept 2021,132,12,2,363342274,435201343,798543617,2,2,1,71859069,In > Out
Sept 2021,132,121,1,4810644,5818836,10629480,1,1,1,1008192,In > Out
Sept 2021,132,122,4,146851759,194946583,341798342,4,4,2,48094824,In > Out
Sept 2021,132,124,3,88628697,176713336,265342033,3,3,3,88084639,In > Out
Sept 2021,132,127,1,282282755,100896543,383179298,1,1,1,181386212,Out > In
Sept 2021,132,128,1,54703420,43086305,97789725,1,1,1,11617115,Out > In
Sept 2021,132,129,3,52110062,67160373,119270435,3,3,3,15050311,In > Out
Sept 2021,132,137,2,203167891,131925135,335093026,2,2,2,71242756,Out > In
Sept 2021,132,140,2,736322372,624146401,1360468773,1,2,2,112175971,Out > In
Sept 2021,132,143,10,43771099,111946136,155717235,6,4,9,68175037,In > Out
Sept 2021,132,145,1,13880,133870,147750,1,1,1,119990,In > Out
Sept 2021,132,147,51,19573755,169957568,189531323,12,9,51,150383813,In > Out
Sept 2021,132,151,3,2831301598,2440961381,5272262979,2,2,1,390340217,Out > In
Sept 2021,132,153,708,880819932,216000391,1096820323,593,668,4,664819541,Out > In
Sept 2021,132,154,2,413325483,412254935,825580418,2,2,1,1070548,Out > In
Sept 2021,132,158,4,86463566,174776289,261239855,4,4,4,88312723,In > Out
Sept 2021,132,164,1,182492,192304,374796,1,1,1,9812,In > Out
Sept 2021,132,166,5,1759683221,1383945688,3143628909,4,4,4,375737533,Out > In
Sept 2021,132,168,2,389829,1349530,1739359,1,1,2,959701,In > Out
Sept 2021,132,169,8,1329479,7065981,8395460,5,5,8,5736502,In > Out
Sept 2021,132,171,1,702141,3185434,3887575,1,1,1,2483293,In > Out
Sept 2021,132,172,7,698086849,546575776,1244662625,4,4,7,151511073,Out > In
Sept 2021,132,173,6,846914122,343123622,1190037744,4,5,6,503790500,Out > In
Sept 2021,132,174,1,8070483,125037,8195520,1,1,1,7945446,Out > In
Sept 2021,132,175,3,1066148,900112,1966260,2,3,3,166036,Out > In
Sept 2021,132,176,1,384327614,298910606,683238220,1,1,1,85417008,Out > In
Sept 2021,132,178,3,10729861,197073644,207803505,2,2,3,186343783,In > Out
Sept 2021,132,179,2,6069045,318660006,324729051,2,1,2,312590961,In > Out
Sept 2021,132,181,3,19259839,61672956,80932795,2,2,3,42413117,In > Out
Sept 2021,132,183,1,3079096,9298769,12377865,1,1,1,6219673,In > Out
Sept 2021,132,186,41,6260428835,6371094314,12631523149,10,10,39,110665479,In > Out
Sept 2021,132,187,1,225198,330909,556107,1,1,1,105711,In > Out
Sept 2021,132,19,1,707569,231151,938720,1,1,1,476418,Out > In
Sept 2021,132,191,3,129850,1323820,1453670,3,1,3,1193970,In > Out
Sept 2021,132,194,6,13991486,17662195,31653681,5,6,6,3670709,In > Out
Sept 2021,132,197,3,1664145,69447279,71111424,2,2,3,67783134,In > Out
Sept 2021,132,200,2,79590027,303173712,382763739,1,2,2,223583685,In > Out
Sept 2021,132,201,2,566388654,348508010,914896664,2,2,2,217880644,Out > In
Sept 2021,132,203,3,3526894,106871934,110398828,2,2,3,103345040,In > Out
Sept 2021,132,205,14,1052511278,1278069406,2330580684,10,6,14,225558128,In > Out
Sept 2021,132,216,7,63772705,151164806,214937511,5,5,7,87392101,In > Out
Sept 2021,132,219,1,142853965,178939764,321793729,1,1,1,36085799,In > Out
Sept 2021,132,221,1,183188335,82564823,265753158,1,1,1,100623512,Out > In
Sept 2021,132,222,1,393086,493013,886099,1,1,1,99927,In > Out
Sept 2021,132,25,2,489337980,539436666,1028774646,2,2,2,50098686,In > Out
Sept 2021,132,26,2,35453013,15919750,51372763,1,2,2,19533263,Out > In
Sept 2021,132,27,17,73026947,115463871,188490818,2,12,17,42436924,In > Out
Sept 2021,132,28,5,230727605,223959284,454686889,5,3,1,6768321,Out > In
Sept 2021,132,29,1,3298690,3446784,6745474,1,1,1,148094,In > Out
Sept 2021,132,30,14,237821571,263474661,501296232,1,14,1,25653090,In > Out
Sept 2021,132,31,4,1002110,1845656,2847766,3,4,4,843546,In > Out
Sept 2021,132,32,3,303112720,274701775,577814495,3,3,3,28410945,Out > In
Sept 2021,132,33,1,164686124,221784561,386470685,1,1,1,57098437,In > Out
Sept 2021,132,35,1,29010185,51379249,80389434,1,1,1,22369064,In > Out
Sept 2021,132,40,3,173063752,281629305,454693057,2,3,2,108565553,In > Out
Sept 2021,132,41,3,7898958,11670371,19569329,2,3,3,3771413,In > Out
Sept 2021,132,43,2,19422334,61041642,80463976,1,1,2,41619308,In > Out
Sept 2021,132,44,3,12738280,940091,13678371,2,2,3,11798189,Out > In
Sept 2021,132,46,4,1066639943,734251113,1800891056,4,4,3,332388830,Out > In
Sept 2021,132,48,3,11364053,353020229,364384282,1,1,3,341656176,In > Out
Sept 2021,132,49,3,795399093,981624210,1777023303,3,2,3,186225117,In > Out
Sept 2021,132,5,2,38966935,41856642,80823577,1,2,1,2889707,In > Out
Sept 2021,132,54,1,3241864,85336623,88578487,1,1,1,82094759,In > Out
Sept 2021,132,56,1,336464,151560,488024,1,1,1,184904,Out > In
Sept 2021,132,58,4,4253870,28689698,32943568,4,4,4,24435828,In > Out
Sept 2021,132,59,2,12943019,133873418,146816437,2,1,2,120930399,In > Out
Sept 2021,132,60,1,174394,592479,766873,1,1,1,418085,In > Out
Sept 2021,132,63,5,520848381,208978905,729827286,5,5,4,311869476,Out > In
Sept 2021,132,65,3,84583310,95185734,179769044,3,2,2,10602424,In > Out
Sept 2021,132,66,3,6503325,103700260,110203585,2,2,3,97196935,In > Out
Sept 2021,132,71,1,1252493,1989733,3242226,1,1,1,737240,In > Out
Sept 2021,132,77,2,384965537,306589167,691554704,2,2,2,78376370,Out > In
Sept 2021,132,83,4,335165970,393264853,728430823,3,4,3,58098883,In > Out
Sept 2021,132,86,2,14527588,198069829,212597417,2,2,2,183542241,In > Out
Sept 2021,132,88,1,20245004,17973032,38218036,1,1,1,2271972,Out > In
Sept 2021,132,89,5,26101246,213841346,239942592,3,3,5,187740100,In > Out
Sept 2021,132,95,2,601746,14409079,15010825,1,1,2,13807333,In > Out
Sept 2021,132,99,7,2420432118,2927325937,5347758055,5,3,5,506893819,In > Out
Sept 2021,133,100,1,802577,1426691,2229268,1,1,1,624114,In > Out
Sept 2021,133,104,5,26955548,37790065,64745613,2,5,2,10834517,In > Out
Sept 2021,133,107,3,115809,10650353,10766162,3,2,3,10534544,In > Out
Sept 2021,133,11,4,456641285,323449724,780091009,4,3,3,133191561,Out > In
Sept 2021,133,114,6,35720189,27464277,63184466,5,5,5,8255912,Out > In
Sept 2021,133,118,4,1724270,5060010,6784280,2,2,4,3335740,In > Out
Sept 2021,133,119,3,4387388,99227388,103614776,3,2,3,94840000,In > Out
Sept 2021,133,121,1,207660,87867,295527,1,1,1,119793,Out > In
Sept 2021,133,125,8,868378331,960615675,1828994006,7,4,5,92237344,In > Out
Sept 2021,133,126,3,19747580,22706152,42453732,3,3,3,2958572,In > Out
Sept 2021,133,127,1,29752,109462,139214,1,1,1,79710,In > Out
Sept 2021,133,128,1,3548464,61650732,65199196,1,1,1,58102268,In > Out
Sept 2021,133,130,13,18185331,143686687,161872018,9,5,13,125501356,In > Out
Sept 2021,133,131,1,134962540,143444231,278406771,1,1,1,8481691,In > Out
Sept 2021,133,132,5,677268814,686890825,1364159639,4,5,3,9622011,In > Out
Sept 2021,133,135,4,247218441,192029953,439248394,2,2,4,55188488,Out > In
Sept 2021,133,136,2,24226173,235796972,260023145,2,2,2,211570799,In > Out
Sept 2021,133,137,3,1956373715,2415641336,4372015051,3,3,3,459267621,In > Out
Sept 2021,133,138,1,16922043,12760737,29682780,1,1,1,4161306,Out > In
Sept 2021,133,139,3,26203585,17502004,43705589,1,3,3,8701581,Out > In
Sept 2021,133,147,10,300547622,282037085,582584707,2,4,9,18510537,Out > In
Sept 2021,133,15,142,118439147,215594306,334033453,16,12,140,97155159,In > Out
Sept 2021,133,150,1,1621859,4395,1626254,1,1,1,1617464,Out > In
Sept 2021,133,153,4,389280064,816889968,1206170032,2,2,4,427609904,In > Out
Sept 2021,133,16,1,116580,48500,165080,1,1,1,68080,Out > In
Sept 2021,133,160,5,12371739,108808017,121179756,3,2,5,96436278,In > Out
Sept 2021,133,163,1,3289248851,3342756316,6632005167,1,1,1,53507465,In > Out
Sept 2021,133,164,5,185577,1113536,1299113,4,1,5,927959,In > Out
Sept 2021,133,165,30,211281969,362877812,574159781,29,30,9,151595843,In > Out
Sept 2021,133,168,1,1300678,947325,2248003,1,1,1,353353,Out > In
Sept 2021,133,175,2,3983630,82102035,86085665,2,2,2,78118405,In > Out
Sept 2021,133,176,3,1866944,6554001,8420945,1,1,3,4687057,In > Out
Sept 2021,133,178,9,40153804,80962526,121116330,8,7,9,40808722,In > Out
Sept 2021,133,179,4,60591567,7957860,68549427,3,4,2,52633707,Out > In
Sept 2021,133,18,1,31895,180174,212069,1,1,1,148279,In > Out
Sept 2021,133,183,2,836390150,788735933,1625126083,2,2,1,47654217,Out > In
Sept 2021,133,186,2,175935,259579,435514,2,2,2,83644,In > Out
Sept 2021,133,188,1,207484,56454554,56662038,1,1,1,56247070,In > Out
Sept 2021,133,189,2,666615,28506470,29173085,1,1,2,27839855,In > Out
Sept 2021,133,19,2,818165,1207848,2026013,2,2,2,389683,In > Out
Sept 2021,133,192,18,5424744,1091417009,1096841753,2,2,18,1085992265,In > Out
Sept 2021,133,193,3,3568151,121828428,125396579,2,1,3,118260277,In > Out
Sept 2021,133,195,46,193587368,2384400464,2577987832,46,46,3,2190813096,In > Out
Sept 2021,133,199,1,293639,300110,593749,1,1,1,6471,In > Out
Sept 2021,133,201,3,85710541,37570325,123280866,3,3,2,48140216,Out > In
Sept 2021,133,203,2,110587700,111998408,222586108,2,2,2,1410708,In > Out
Sept 2021,133,204,6,2563758045,2556008262,5119766307,6,5,5,7749783,Out > In
Sept 2021,133,207,9,566959792,569960122,1136919914,7,8,5,3000330,In > Out
Sept 2021,133,21,15,123061481,252113919,375175400,3,3,15,129052438,In > Out
Sept 2021,133,211,1,4380,29660424,29664804,1,1,1,29656044,In > Out
Sept 2021,133,213,3,70122863,69059581,139182444,3,3,3,1063282,Out > In
Sept 2021,133,220,2,6620094,7085404,13705498,2,2,2,465310,In > Out
Sept 2021,133,221,2,4444222,270934672,275378894,1,1,2,266490450,In > Out
Sept 2021,133,222,5,1471723,2776290,4248013,3,5,5,1304567,In > Out
Sept 2021,133,223,2,1248155,28380858,29629013,2,2,2,27132703,In > Out
Sept 2021,133,25,6,27040334,42239859,69280193,2,6,6,15199525,In > Out
Sept 2021,133,26,2,46717383,184709578,231426961,2,2,2,137992195,In > Out
Sept 2021,133,30,3,7015494,8097394,15112888,3,3,3,1081900,In > Out
Sept 2021,133,33,6,958899668,1113243369,2072143037,3,6,2,154343701,In > Out
Sept 2021,133,36,1,53633,72749,126382,1,1,1,19116,In > Out
Sept 2021,133,37,52,588071,11369740,11957811,52,51,52,10781669,In > Out
Sept 2021,133,4,2,1404335564,1449434861,2853770425,2,2,1,45099297,In > Out
Sept 2021,133,44,1,135475817,130918901,266394718,1,1,1,4556916,Out > In
Sept 2021,133,46,1,335919,6488866,6824785,1,1,1,6152947,In > Out
Sept 2021,133,48,3,2996386,18848726,21845112,3,3,3,15852340,In > Out
Sept 2021,133,56,1,1988754,1875032,3863786,1,1,1,113722,Out > In
Sept 2021,133,57,1,22725413,24967748,47693161,1,1,1,2242335,In > Out
Sept 2021,133,59,2,17548929,74934250,92483179,2,2,2,57385321,In > Out
Sept 2021,133,62,1,2716601,811504,3528105,1,1,1,1905097,Out > In
Sept 2021,133,63,1,106209,49507353,49613562,1,1,1,49401144,In > Out
Sept 2021,133,64,9,103451482,115720412,219171894,8,8,6,12268930,In > Out
Sept 2021,133,70,7,101014087,145706954,246721041,5,4,7,44692867,In > Out
Sept 2021,133,75,3,3347430,7633475,10980905,3,3,3,4286045,In > Out
Sept 2021,133,77,2,10297393,10493010,20790403,1,2,2,195617,In > Out
Sept 2021,133,81,6,188209,18705386,18893595,2,1,6,18517177,In > Out
Sept 2021,133,84,1,9392202,16262159,25654361,1,1,1,6869957,In > Out
Sept 2021,133,87,1,65991455,91336400,157327855,1,1,1,25344945,In > Out
Sept 2021,133,95,8,334514171,46426411,380940582,1,1,8,288087760,Out > In
Sept 2021,133,98,4,147111365,128252805,275364170,3,4,4,18858560,Out > In
Sept 2021,134,102,1,221543,2745704,2967247,1,1,1,2524161,In > Out
Sept 2021,134,103,2,4105411,112192748,116298159,1,1,2,108087337,In > Out
Sept 2021,134,105,8,22963050,102941302,125904352,5,7,5,79978252,In > Out
Sept 2021,134,107,3,7409127,8072324,15481451,2,3,3,663197,In > Out
Sept 2021,134,110,1,25277368,19090396,44367764,1,1,1,6186972,Out > In
Sept 2021,134,113,3,31121243,83541899,114663142,2,2,3,52420656,In > Out
Sept 2021,134,115,4,14308754,52896595,67205349,2,1,4,38587841,In > Out
Sept 2021,134,116,1,338667540,486955681,825623221,1,1,1,148288141,In > Out
Sept 2021,134,122,4,208924831,283268327,492193158,4,3,4,74343496,In > Out
Sept 2021,134,123,10,6193866,164823856,171017722,4,5,10,158629990,In > Out
Sept 2021,134,124,8,79174666,91945582,171120248,5,7,4,12770916,In > Out
Sept 2021,134,125,1,4070,1536451,1540521,1,1,1,1532381,In > Out
Sept 2021,134,126,2,10973733,29915585,40889318,2,2,2,18941852,In > Out
Sept 2021,134,128,3,927262,22177711,23104973,1,1,3,21250449,In > Out
Sept 2021,134,130,2,4045493836,3854402361,7899896197,2,2,1,191091475,Out > In
Sept 2021,134,132,5,5132849655,5144175242,10277024897,2,5,1,11325587,In > Out
Sept 2021,134,133,1,499017,100212,599229,1,1,1,398805,Out > In
Sept 2021,134,134,1,5212464,1873129,7085593,1,1,1,3339335,Out > In
Sept 2021,134,136,1,528979811,58149988,587129799,1,1,1,470829823,Out > In
Sept 2021,134,139,9,5682059,224739067,230421126,2,2,9,219057008,In > Out
Sept 2021,134,141,4,156820435,13546510,170366945,2,2,4,143273925,Out > In
Sept 2021,134,145,36,10169552,28917743,39087295,2,2,36,18748191,In > Out
Sept 2021,134,146,3,266025908,174622392,440648300,2,3,1,91403516,Out > In
Sept 2021,134,152,1,5726405,5925662,11652067,1,1,1,199257,In > Out
Sept 2021,134,155,10,25146124,328973610,354119734,7,7,10,303827486,In > Out
Sept 2021,134,156,3,134322,1226529,1360851,3,1,3,1092207,In > Out
Sept 2021,134,157,1,62180798,60413085,122593883,1,1,1,1767713,Out > In
Sept 2021,134,158,5,58257,3927263,3985520,4,4,5,3869006,In > Out
Sept 2021,134,163,2,23618152,23689203,47307355,1,2,2,71051,In > Out
Sept 2021,134,164,3,114853162,123894993,238748155,2,3,3,9041831,In > Out
Sept 2021,134,168,1,5071034,6005592,11076626,1,1,1,934558,In > Out
Sept 2021,134,174,3,75646373,33638528,109284901,1,3,3,42007845,Out > In
Sept 2021,134,175,2,41275562,144576638,185852200,2,2,2,103301076,In > Out
Sept 2021,134,180,1,4237858,37517631,41755489,1,1,1,33279773,In > Out
Sept 2021,134,182,6,53485518,133334563,186820081,3,3,6,79849045,In > Out
Sept 2021,134,188,3,954614998,1042233964,1996848962,1,1,1,87618966,In > Out
Sept 2021,134,19,6,1107468219,1131678049,2239146268,4,5,2,24209830,In > Out
Sept 2021,134,190,4,291068848,123284065,414352913,4,3,4,167784783,Out > In
Sept 2021,134,194,6,19704538,309111997,328816535,3,2,6,289407459,In > Out
Sept 2021,134,201,1,448207221,498171170,946378391,1,1,1,49963949,In > Out
Sept 2021,134,204,14,33097878,989128,34087006,11,3,1,32108750,Out > In
Sept 2021,134,209,1,233444,191156,424600,1,1,1,42288,Out > In
Sept 2021,134,212,1,1032225,1796307,2828532,1,1,1,764082,In > Out
Sept 2021,134,220,2,93987598,91796790,185784388,2,2,2,2190808,Out > In
Sept 2021,134,23,1,101400,495157,596557,1,1,1,393757,In > Out
Sept 2021,134,24,7,10396263,15890272,26286535,7,7,7,5494009,In > Out
Sept 2021,134,39,2,1671674783,1689026377,3360701160,2,2,1,17351594,In > Out
Sept 2021,134,4,1,5576380,140079749,145656129,1,1,1,134503369,In > Out
Sept 2021,134,43,1,6621596,213924270,220545866,1,1,1,207302674,In > Out
Sept 2021,134,44,2,2422149,187095303,189517452,1,1,2,184673154,In > Out
Sept 2021,134,52,5,7049127,125142668,132191795,4,2,5,118093541,In > Out
Sept 2021,134,54,2,41197810,30687416,71885226,1,1,2,10510394,Out > In
Sept 2021,134,56,1,784546,1025286,1809832,1,1,1,240740,In > Out
Sept 2021,134,58,1,43577,1245546,1289123,1,1,1,1201969,In > Out
Sept 2021,134,61,1,9165497,15868641,25034138,1,1,1,6703144,In > Out
Sept 2021,134,63,2,31258133,42210050,73468183,2,2,2,10951917,In > Out
Sept 2021,134,67,1,383872,1046748,1430620,1,1,1,662876,In > Out
Sept 2021,134,69,1,34919910,40199981,75119891,1,1,1,5280071,In > Out
Sept 2021,134,74,12,1137175144,1921516222,3058691366,8,11,10,784341078,In > Out
Sept 2021,134,75,4,10124278,36723129,46847407,4,4,4,26598851,In > Out
Sept 2021,134,77,1,41932571,50379357,92311928,1,1,1,8446786,In > Out
Sept 2021,134,78,1,610082,520267,1130349,1,1,1,89815,Out > In
Sept 2021,134,80,4,275620136,6762989351,7038609487,4,4,4,6487369215,In > Out
Sept 2021,134,81,3,9030597,28552159,37582756,2,2,2,19521562,In > Out
Sept 2021,134,88,2,5118496,10363111,15481607,1,1,2,5244615,In > Out
Sept 2021,134,89,10,26304837,130697202,157002039,3,2,10,104392365,In > Out
Sept 2021,134,90,7,9924150,46898471,56822621,4,3,7,36974321,In > Out
Sept 2021,134,92,3,16424800,245039033,261463833,3,1,3,228614233,In > Out
Sept 2021,134,94,2,317570214,283760903,601331117,1,2,1,33809311,Out > In
Sept 2021,134,99,4,125996346,120009791,246006137,2,4,4,5986555,Out > In
Sept 2021,14,12,4,6443295,67855,6511150,1,4,1,6375440,Out > In
Sept 2021,14,16,2,1970052,71160394,73130446,1,2,1,69190342,In > Out
Sept 2021,14,40,14,1585272575,18276877,1603549452,4,14,2,1566995698,Out > In
Sept 2021,141,111,6,139546475,244602873,384149348,5,2,6,105056398,In > Out
Sept 2021,141,113,7,242826390,498560354,741386744,3,3,7,255733964,In > Out
Sept 2021,141,133,1,64053,83526,147579,1,1,1,19473,In > Out
Sept 2021,141,148,1,174597919,253362278,427960197,1,1,1,78764359,In > Out
Sept 2021,141,182,1,16872485,56917060,73789545,1,1,1,40044575,In > Out
Sept 2021,141,40,3,236518743,475865121,712383864,3,2,3,239346378,In > Out
Sept 2021,142,38,1,330365,3350,333715,1,1,1,327015,Out > In
Sept 2021,142,4,1,53631,81007,134638,1,1,1,27376,In > Out
Sept 2021,142,43,46,9143278,297485,9440763,44,45,1,8845793,Out > In
Sept 2021,143,148,16,1644574183,1516368932,3160943115,9,8,13,128205251,Out > In
Sept 2021,143,152,9,2062934217,2721211291,4784145508,6,6,9,658277074,In > Out
Sept 2021,143,157,16,872092,93281484,94153576,4,2,16,92409392,In > Out
Sept 2021,143,205,1,291355335,378496303,669851638,1,1,1,87140968,In > Out
Sept 2021,145,163,1,114948,110817,225765,1,1,1,4131,Out > In
Sept 2021,145,3,1,63093,42755,105848,1,1,1,20338,Out > In
Sept 2021,146,143,3,223737692,790171340,1013909032,2,3,3,566433648,In > Out
Sept 2021,146,193,1,26352,653020,679372,1,1,1,626668,In > Out
Sept 2021,149,16,3,62609409,68456513,131065922,2,1,3,5847104,In > Out
Sept 2021,149,160,229,262125324,56502447,318627771,103,189,1,205622877,Out > In
Sept 2021,149,187,7,5924699,1038872,6963571,4,1,1,4885827,Out > In
Sept 2021,149,211,2,165784,39766595,39932379,1,1,2,39600811,In > Out
Sept 2021,149,51,1,680572226,633986120,1314558346,1,1,1,46586106,Out > In
Sept 2021,149,63,1329,535850111,4198048818,4733898929,165,1106,3,3662198707,In > Out
Sept 2021,149,65,1,36820,76995,113815,1,1,1,40175,In > Out
Sept 2021,150,171,1,3412272,162158586,165570858,1,1,1,158746314,In > Out
Sept 2021,150,173,4,919953183,769729240,1689682423,4,4,4,150223943,Out > In
Sept 2021,150,235,2,178780248,317240509,496020757,2,2,2,138460261,In > Out
Sept 2021,150,237,2,117956,750756,868712,1,1,2,632800,In > Out
Sept 2021,153,60,1,1142757,3821392,4964149,1,1,1,2678635,In > Out
Sept 2021,154,101,2,134821,317049,451870,1,2,2,182228,In > Out
Sept 2021,154,102,1,93181,67718,160899,1,1,1,25463,Out > In
Sept 2021,154,155,4,12853100,55916506,68769606,2,1,4,43063406,In > Out
Sept 2021,154,162,1,1480703,1730861,3211564,1,1,1,250158,In > Out
Sept 2021,154,164,9,655159314,1128397248,1783556562,9,2,9,473237934,In > Out
Sept 2021,154,20,1,479,451779,452258,1,1,1,451300,In > Out
Sept 2021,154,6,7,358841650,844275153,1203116803,4,3,7,485433503,In > Out
Sept 2021,154,67,4,18986513,230877586,249864099,1,4,4,211891073,In > Out
Sept 2021,155,135,3918,22558510780,254327976,22812838756,309,3590,346,22304182804,Out > In
Sept 2021,155,136,86,103436545,3268168,106704713,20,86,2,100168377,Out > In
Sept 2021,155,137,1627,4957382954,53649422,5011032376,165,1557,2,4903733532,Out > In
Sept 2021,155,142,52349,17684319949,380287881,18064607830,404,23779,4,17304032068,Out > In
Sept 2021,155,143,117,42721896,3878436,46600332,34,117,2,38843460,Out > In
Sept 2021,155,145,61,63707724,4829094,68536818,1,61,2,58878630,Out > In
Sept 2021,155,146,8,5625958,335337888,340963846,5,8,3,329711930,In > Out
Sept 2021,155,148,5,1053554,165385,1218939,2,5,1,888169,Out > In
Sept 2021,155,149,567610,175646046863,3997175068,179643221931,8190,44618,4,171648871795,Out > In
Sept 2021,155,150,24866,4917727576,150043242,5067770818,925,13539,2,4767684334,Out > In
Sept 2021,155,151,1116,16488145310,119246918,16607392228,216,1096,13,16368898392,Out > In
Sept 2021,155,153,19,15665528,153457,15818985,8,17,1,15512071,Out > In
Sept 2021,155,154,285,97227739,4178891,101406630,67,285,2,93048848,Out > In
Sept 2021,155,167,14204,72777243410,5343281517,78120524927,695,7659,2,67433961893,Out > In
Sept 2021,155,169,246,340609691,98944338,439554029,113,199,3,241665353,Out > In
Sept 2021,155,170,310,482876858,86613615,569490473,166,218,2,396263243,Out > In
Sept 2021,155,198,517,175367771,3923140,179290911,125,514,2,171444631,Out > In
Sept 2021,155,199,250,12002796749,74530484,12077327233,137,250,6,11928266265,Out > In
Sept 2021,155,201,497,803076617,10974834,814051451,101,494,2,792101783,Out > In
Sept 2021,155,202,966,560068066,13141052,573209118,284,949,2,546927014,Out > In
Sept 2021,155,205,37355,11754014850,381077685,12135092535,617,22950,3,11372937165,Out > In
Sept 2021,155,207,10,13220206,688006,13908212,1,10,1,12532200,Out > In
Sept 2021,155,74,1,399958,13388,413346,1,1,1,386570,Out > In
Sept 2021,155,75,7,1930183,49624,1979807,7,7,2,1880559,Out > In
Sept 2021,156,159,13,2061540,903148,2964688,11,8,1,1158392,Out > In
Sept 2021,156,243,1,73150,35635,108785,1,1,1,37515,Out > In
Sept 2021,159,145,1,829780,1065247,1895027,1,1,1,235467,In > Out
Sept 2021,159,201,1,570126,34519,604645,1,1,1,535607,Out > In
Sept 2021,159,217,7,612016721,706121783,1318138504,7,4,7,94105062,In > Out
Sept 2021,16,14,32,427728439,1691320572,2119049011,24,11,31,1263592133,In > Out
Sept 2021,16,16,1,3882213,72270875,76153088,1,1,1,68388662,In > Out
Sept 2021,16,20,6,84640486,43160497,127800983,5,5,6,41479989,Out > In
Sept 2021,16,240,7,557256905,153052818,710309723,2,3,7,404204087,Out > In
Sept 2021,16,4,9,5825421,37860846,43686267,5,3,9,32035425,In > Out
Sept 2021,16,7,17,47317444,485735116,533052560,7,1,17,438417672,In > Out
Sept 2021,160,10,1,82210,76684,158894,1,1,1,5526,Out > In
Sept 2021,160,105,1,116666,30467,147133,1,1,1,86199,Out > In
Sept 2021,160,109,6,1567859,2650643,4218502,1,1,6,1082784,In > Out
Sept 2021,160,121,665,28904883750,63623474459,92528358209,369,121,464,34718590709,In > Out
Sept 2021,160,122,754,27011777095,52217815588,79229592683,472,269,579,25206038493,In > Out
Sept 2021,160,123,669,29557523018,55955364861,85512887879,398,91,422,26397841843,In > Out
Sept 2021,160,124,738,26697853524,63985180091,90683033615,450,177,485,37287326567,In > Out
Sept 2021,160,125,758,33103390859,68976007772,102079398631,429,228,590,35872616913,In > Out
Sept 2021,160,126,730,29706254569,56726353648,86432608217,428,160,506,27020099079,In > Out
Sept 2021,160,127,636,34951738835,44729241666,79680980501,371,137,475,9777502831,In > Out
Sept 2021,160,128,245,10647023757,22426109703,33073133460,124,55,186,11779085946,In > Out
Sept 2021,160,130,2,275684,870066,1145750,2,2,2,594382,In > Out
Sept 2021,160,132,66,1309531587,1104572367,2414103954,18,6,65,204959220,Out > In
Sept 2021,160,15,1,126125,78956,205081,1,1,1,47169,Out > In
Sept 2021,160,152,37,206845060,724596137,931441197,32,35,37,517751077,In > Out
Sept 2021,160,153,23,143197940,515213728,658411668,20,22,23,372015788,In > Out
Sept 2021,160,154,30,184860248,617751860,802612108,27,30,30,432891612,In > Out
Sept 2021,160,155,27,171526649,567356097,738882746,23,25,27,395829448,In > Out
Sept 2021,160,156,31,181799523,644286697,826086220,27,27,31,462487174,In > Out
Sept 2021,160,157,27,175088898,574546632,749635530,26,26,27,399457734,In > Out
Sept 2021,160,16,3,1429136,1553867,2983003,1,1,3,124731,In > Out
Sept 2021,160,200,825,17190386099,43943802129,61134188228,421,143,276,26753416030,In > Out
Sept 2021,160,201,1016,16767990898,45431348390,62199339288,608,300,488,28663357492,In > Out
Sept 2021,160,202,877,17244523765,42392118216,59636641981,452,158,295,25147594451,In > Out
Sept 2021,160,203,779,16085549760,39247625731,55333175491,414,129,263,23162075971,In > Out
Sept 2021,160,216,1,941110,23678,964788,1,1,1,917432,Out > In
Sept 2021,160,238,14,1523792293,1307501499,2831293792,8,10,14,216290794,Out > In
Sept 2021,160,240,1,35385,93886,129271,1,1,1,58501,In > Out
Sept 2021,160,241,5,264737660,233789738,498527398,5,4,5,30947922,Out > In
Sept 2021,160,244,6,11710902,51975443,63686345,4,4,6,40264541,In > Out
Sept 2021,160,245,3,5831422,344361553,350192975,1,1,3,338530131,In > Out
Sept 2021,160,247,5,164903,3801977,3966880,2,2,5,3637074,In > Out
Sept 2021,160,249,3,4596949,99699144,104296093,2,1,3,95102195,In > Out
Sept 2021,160,33,6,16883252,32406297,49289549,2,4,6,15523045,In > Out
Sept 2021,160,34,95,9481321,1039988897,1049470218,3,3,94,1030507576,In > Out
Sept 2021,160,35,1,172995,94928,267923,1,1,1,78067,Out > In
Sept 2021,160,40,20,244188,58440066,58684254,1,17,20,58195878,In > Out
Sept 2021,160,57,18,2042893813,2507509801,4550403614,13,9,18,464615988,In > Out
Sept 2021,160,58,14,702967422,1393298514,2096265936,10,3,14,690331092,In > Out
Sept 2021,160,59,4,66410589,104492262,170902851,2,3,4,38081673,In > Out
Sept 2021,160,60,7,208711111,580388706,789099817,5,2,7,371677595,In > Out
Sept 2021,160,61,2,176967604,146466326,323433930,1,1,2,30501278,Out > In
Sept 2021,160,62,15,3578542132,472425949,4050968081,5,10,15,3106116183,Out > In
Sept 2021,160,63,6,114527169,60924315,175451484,4,3,6,53602854,Out > In
Sept 2021,160,65,152,1702330525,7688135222,9390465747,49,36,150,5985804697,In > Out
Sept 2021,160,66,82,1610863247,7442845860,9053709107,39,35,82,5831982613,In > Out
Sept 2021,160,67,85,11294150868,1516194217,12810345085,29,68,85,9777956651,Out > In
Sept 2021,160,68,91,1633755336,4508213311,6141968647,49,20,90,2874457975,In > Out
Sept 2021,160,69,30,2150823579,6155259241,8306082820,20,9,28,4004435662,In > Out
Sept 2021,160,70,55,463179676,1468467523,1931647199,34,32,54,1005287847,In > Out
Sept 2021,160,71,16,202578223,1008004928,1210583151,11,6,16,805426705,In > Out
Sept 2021,160,72,36,2354341875,4949614165,7303956040,20,7,36,2595272290,In > Out
Sept 2021,160,73,10,27964300,1028627447,1056591747,8,5,10,1000663147,In > Out
Sept 2021,160,74,7,317795943,1922397395,2240193338,3,1,7,1604601452,In > Out
Sept 2021,160,75,8,388906646,134315324,523221970,5,2,8,254591322,Out > In
Sept 2021,160,76,15,810107861,1022073211,1832181072,10,4,15,211965350,In > Out
Sept 2021,160,77,11,74659486,170704564,245364050,9,1,11,96045078,In > Out
Sept 2021,160,78,12,842539801,142964787,985504588,10,2,12,699575014,Out > In
Sept 2021,160,79,77,253093665,3376418180,3629511845,59,25,77,3123324515,In > Out
Sept 2021,160,80,106,592086369,6234666603,6826752972,61,6,106,5642580234,In > Out
Sept 2021,160,81,11,11044599,694882041,705926640,5,7,11,683837442,In > Out
Sept 2021,160,87,1,137746,105508,243254,1,1,1,32238,Out > In
Sept 2021,161,10,2,10541648,30311379,40853027,2,2,2,19769731,In > Out
Sept 2021,161,100,5,3398777,20687530,24086307,3,2,5,17288753,In > Out
Sept 2021,161,105,2,118519298,145878950,264398248,2,2,2,27359652,In > Out
Sept 2021,161,107,2,11116252,17041894,28158146,2,2,1,5925642,In > Out
Sept 2021,161,112,2,38599332,29594564,68193896,1,2,2,9004768,Out > In
Sept 2021,161,113,1,111450,276839,388289,1,1,1,165389,In > Out
Sept 2021,161,117,2,791425977,736145881,1527571858,2,2,1,55280096,Out > In
Sept 2021,161,121,2,3977728,28482309,32460037,2,2,2,24504581,In > Out
Sept 2021,161,124,1,56220,56744,112964,1,1,1,524,In > Out
Sept 2021,161,127,2,1796962343,723552469,2520514812,2,2,1,1073409874,Out > In
Sept 2021,161,129,1,806537,1127951,1934488,1,1,1,321414,In > Out
Sept 2021,161,130,6,98015617,69515813,167531430,3,6,6,28499804,Out > In
Sept 2021,161,132,4,1327282936,1112778009,2440060945,4,4,4,214504927,Out > In
Sept 2021,161,133,1,67537,342438,409975,1,1,1,274901,In > Out
Sept 2021,161,135,5,179573064,1548567907,1728140971,3,3,5,1368994843,In > Out
Sept 2021,161,138,6,1246050043,1440184256,2686234299,5,5,3,194134213,In > Out
Sept 2021,161,139,3,2152159663,1707348774,3859508437,3,3,2,444810889,Out > In
Sept 2021,161,14,1,191496894,207559116,399056010,1,1,1,16062222,In > Out
Sept 2021,161,144,6,164870983,201876703,366747686,5,3,1,37005720,In > Out
Sept 2021,161,145,3,88926376,42266712,131193088,2,3,3,46659664,Out > In
Sept 2021,161,148,1,121201893,355815781,477017674,1,1,1,234613888,In > Out
Sept 2021,161,151,1,80401,156652,237053,1,1,1,76251,In > Out
Sept 2021,161,153,1,304599216,310929876,615529092,1,1,1,6330660,In > Out
Sept 2021,161,157,1,190176,44983180,45173356,1,1,1,44793004,In > Out
Sept 2021,161,16,4,903432,1188510,2091942,2,2,4,285078,In > Out
Sept 2021,161,162,3,143021141,77260673,220281814,3,3,2,65760468,Out > In
Sept 2021,161,165,2,1341948,5982522,7324470,2,2,2,4640574,In > Out
Sept 2021,161,169,4,33039282,52466867,85506149,3,2,1,19427585,In > Out
Sept 2021,161,17,1,67536,128858,196394,1,1,1,61322,In > Out
Sept 2021,161,171,1,540625,1917911,2458536,1,1,1,1377286,In > Out
Sept 2021,161,173,2,470538421,887972555,1358510976,2,2,2,417434134,In > Out
Sept 2021,161,176,8,949083837,876412999,1825496836,4,8,5,72670838,Out > In
Sept 2021,161,178,54,558500395,1275459796,1833960191,1,1,54,716959401,In > Out
Sept 2021,161,182,3,94389882,141990927,236380809,3,3,3,47601045,In > Out
Sept 2021,161,187,2,105774380,113703616,219477996,1,1,2,7929236,In > Out
Sept 2021,161,188,1,52704,137516,190220,1,1,1,84812,In > Out
Sept 2021,161,193,2,23219915,43204601,66424516,1,1,2,19984686,In > Out
Sept 2021,161,196,1,338826564,314098250,652924814,1,1,1,24728314,Out > In
Sept 2021,161,20,8,127835881,668190484,796026365,6,6,8,540354603,In > Out
Sept 2021,161,201,6,8715698,14930218,23645916,1,6,6,6214520,In > Out
Sept 2021,161,202,1,298009314,329103513,627112827,1,1,1,31094199,In > Out
Sept 2021,161,209,1,8332326,10817215,19149541,1,1,1,2484889,In > Out
Sept 2021,161,21,6,7859759,6086161,13945920,6,4,6,1773598,Out > In
Sept 2021,161,210,8,983598,14091058,15074656,3,1,8,13107460,In > Out
Sept 2021,161,212,2,2042677354,2041942604,4084619958,2,2,1,734750,Out > In
Sept 2021,161,217,2,21238007,34377646,55615653,2,2,2,13139639,In > Out
Sept 2021,161,220,2,298508504,367944724,666453228,2,2,2,69436220,In > Out
Sept 2021,161,221,2,227244,107052,334296,2,2,2,120192,Out > In
Sept 2021,161,24,6,17442737,307725191,325167928,3,1,6,290282454,In > Out
Sept 2021,161,25,1,5861,98492,104353,1,1,1,92631,In > Out
Sept 2021,161,26,1,32276,78957,111233,1,1,1,46681,In > Out
Sept 2021,161,28,1,53666,50356,104022,1,1,1,3310,Out > In
Sept 2021,161,30,2,542896,152983,695879,2,1,2,389913,Out > In
Sept 2021,161,31,6,2341479,12064872,14406351,4,6,6,9723393,In > Out
Sept 2021,161,32,3,2402381,193457226,195859607,3,3,3,191054845,In > Out
Sept 2021,161,33,1,348923,207916,556839,1,1,1,141007,Out > In
Sept 2021,161,34,1,4622071,2074779,6696850,1,1,1,2547292,Out > In
Sept 2021,161,35,1,5388380,79234601,84622981,1,1,1,73846221,In > Out
Sept 2021,161,37,1,63090978,71971050,135062028,1,1,1,8880072,In > Out
Sept 2021,161,38,3,451900683,443753203,895653886,2,3,2,8147480,Out > In
Sept 2021,161,40,2,1187776,1730803,2918579,1,2,2,543027,In > Out
Sept 2021,161,42,40,171883242,413512582,585395824,11,14,40,241629340,In > Out
Sept 2021,161,44,1,998229,446744,1444973,1,1,1,551485,Out > In
Sept 2021,161,46,1,632584,1496257,2128841,1,1,1,863673,In > Out
Sept 2021,161,49,3,123401635,791279478,914681113,3,2,3,667877843,In > Out
Sept 2021,161,51,5,221291164,120792467,342083631,4,4,5,100498697,Out > In
Sept 2021,161,54,1,7882312,3262498,11144810,1,1,1,4619814,Out > In
Sept 2021,161,55,2,8267832,27275714,35543546,2,2,2,19007882,In > Out
Sept 2021,161,57,6,74069367,83643358,157712725,2,1,6,9573991,In > Out
Sept 2021,161,6,3,19610931,196633747,216244678,2,2,3,177022816,In > Out
Sept 2021,161,62,1,5174478,3894421,9068899,1,1,1,1280057,Out > In
Sept 2021,161,67,2,286471613,274241868,560713481,2,2,2,12229745,Out > In
Sept 2021,161,68,54,13961643,41370334,55331977,2,2,53,27408691,In > Out
Sept 2021,161,7,1,214065,18142,232207,1,1,1,195923,Out > In
Sept 2021,161,70,1,181581,172893,354474,1,1,1,8688,Out > In
Sept 2021,161,75,5,10824664,223584629,234409293,3,2,5,212759965,In > Out
Sept 2021,161,8,1,234231308,671686827,905918135,1,1,1,437455519,In > Out
Sept 2021,161,80,1,2306418811,1675437348,3981856159,1,1,1,630981463,Out > In
Sept 2021,161,83,1,68644982,77903532,146548514,1,1,1,9258550,In > Out
Sept 2021,161,84,8,134565,2635366,2769931,8,8,2,2500801,In > Out
Sept 2021,161,86,2,4740253,59885682,64625935,2,1,2,55145429,In > Out
Sept 2021,161,88,2,667902872,478944274,1146847146,2,2,2,188958598,Out > In
Sept 2021,161,91,2,3673890,3544432,7218322,1,2,2,129458,Out > In
Sept 2021,161,94,7,56060649,75251579,131312228,3,3,7,19190930,In > Out
Sept 2021,161,99,1,100520177,60349468,160869645,1,1,1,40170709,Out > In
Sept 2021,164,158,3,3685112,2182216,5867328,1,3,1,1502896,Out > In
Sept 2021,165,106,29,13996932,2681544,16678476,11,29,1,11315388,Out > In
Sept 2021,165,108,5,404474409,461818677,866293086,4,4,5,57344268,In > Out
Sept 2021,165,152,2,2702176,44152564,46854740,2,2,2,41450388,In > Out
Sept 2021,165,165,7,623192399,1658091818,2281284217,6,2,7,1034899419,In > Out
Sept 2021,165,189,1,4737,155974,160711,1,1,1,151237,In > Out
Sept 2021,165,234,2,345900967,288533174,634434141,1,1,2,57367793,Out > In
Sept 2021,165,39,1214,5611848443,1778768494,7390616937,68,1181,3,3833079949,Out > In
Sept 2021,165,43,9,344926698,1018024908,1362951606,6,1,9,673098210,In > Out
Sept 2021,166,192,1,938314,1258009,2196323,1,1,1,319695,In > Out
Sept 2021,168,123,1,6422,202531,208953,1,1,1,196109,In > Out
Sept 2021,168,132,5,6371306,189691349,196062655,3,3,5,183320043,In > Out
Sept 2021,168,153,49,974120075,41581509384,42555629459,1,37,1,40607389309,In > Out
Sept 2021,168,155,17571,229759817732,11627566623,241387384355,2379,9376,2,218132251109,Out > In
Sept 2021,168,186,130,695811438,9040545,704851983,50,130,1,686770893,Out > In
Sept 2021,168,195,1,21568,275780,297348,1,1,1,254212,In > Out
Sept 2021,168,219,5,817912,23847,841759,3,5,1,794065,Out > In
Sept 2021,168,37,8,215724567,396106736,611831303,5,3,8,180382169,In > Out
Sept 2021,169,6,9,7163223,8656965,15820188,4,9,3,1493742,In > Out
Sept 2021,169,8,15,43114350,20015257,63129607,3,15,1,23099093,Out > In
Sept 2021,169,85,1,51804,65605,117409,1,1,1,13801,In > Out
Sept 2021,169,87,12,3948972,82515,4031487,9,12,1,3866457,Out > In
Sept 2021,170,15,2142,6414855622,2106908672,8521764294,264,1887,3,4307946950,Out > In
Sept 2021,170,164,1,22637521,1145908,23783429,1,1,1,21491613,Out > In
Sept 2021,170,187,3,1837707152,5340395956,7178103108,1,3,3,3502688804,In > Out
Sept 2021,170,190,13591,154531694,2778943808,2933475502,3,9378,8,2624412114,In > Out
Sept 2021,170,198,1,87711843,3628029,91339872,1,1,1,84083814,Out > In
Sept 2021,170,227,5,5647098,66976,5714074,5,5,1,5580122,Out > In
Sept 2021,170,236,3,10921655,684717556,695639211,1,1,3,673795901,In > Out
Sept 2021,170,240,1,208323024,11991075,220314099,1,1,1,196331949,Out > In
Sept 2021,170,45,6,67180864,2901965,70082829,2,5,4,64278899,Out > In
Sept 2021,171,101,3,8186592,154614329,162800921,3,3,3,146427737,In > Out
Sept 2021,171,104,3,3090760,180602757,183693517,2,1,3,177511997,In > Out
Sept 2021,171,105,1,1311191,1502560,2813751,1,1,1,191369,In > Out
Sept 2021,171,114,1,3088731,2024346,5113077,1,1,1,1064385,Out > In
Sept 2021,171,116,3,5609463,215722031,221331494,1,1,3,210112568,In > Out
Sept 2021,171,118,1,4253314,34541121,38794435,1,1,1,30287807,In > Out
Sept 2021,171,119,7,7862631691,10418476947,18281108638,4,4,3,2555845256,In > Out
Sept 2021,171,123,2,276589532,307335647,583925179,2,2,1,30746115,In > Out
Sept 2021,171,125,1,468504,2153477,2621981,1,1,1,1684973,In > Out
Sept 2021,171,128,1,4882826,12411617,17294443,1,1,1,7528791,In > Out
Sept 2021,171,130,1,31811,248909,280720,1,1,1,217098,In > Out
Sept 2021,171,131,1,707191,208918,916109,1,1,1,498273,Out > In
Sept 2021,171,132,3,715310962,804109641,1519420603,3,2,1,88798679,In > Out
Sept 2021,171,133,3,1670884,289625877,291296761,2,2,3,287954993,In > Out
Sept 2021,171,134,6,3758133290,3741324671,7499457961,6,5,4,16808619,Out > In
Sept 2021,171,136,2,34270,528694,562964,2,1,2,494424,In > Out
Sept 2021,171,139,4,3914337,16563574,20477911,2,1,4,12649237,In > Out
Sept 2021,171,141,1,205765,3966012,4171777,1,1,1,3760247,In > Out
Sept 2021,171,142,11,4928569,155047420,159975989,3,2,11,150118851,In > Out
Sept 2021,171,143,2,145612,80962,226574,2,1,2,64650,Out > In
Sept 2021,171,144,4,257267085,233342401,490609486,3,3,3,23924684,Out > In
Sept 2021,171,147,3,1058678,1805845,2864523,2,2,3,747167,In > Out
Sept 2021,171,148,2,64004938,41857313,105862251,2,2,1,22147625,Out > In
Sept 2021,171,15,11,24117080,369217586,393334666,8,5,11,345100506,In > Out
Sept 2021,171,150,1,71586,518798,590384,1,1,1,447212,In > Out
Sept 2021,171,154,2,30822139,347389202,378211341,1,1,2,316567063,In > Out
Sept 2021,171,157,1,3045,1289311,1292356,1,1,1,1286266,In > Out
Sept 2021,171,16,1,458162471,453291704,911454175,1,1,1,4870767,Out > In
Sept 2021,171,161,4,13404029,144173784,157577813,4,4,4,130769755,In > Out
Sept 2021,171,163,2,70249900,38961925,109211825,1,2,1,31287975,Out > In
Sept 2021,171,165,13,715026661,1329216258,2044242919,9,9,9,614189597,In > Out
Sept 2021,171,166,2,6068812,140494920,146563732,1,1,2,134426108,In > Out
Sept 2021,171,168,4,854530407,1212381842,2066912249,2,4,1,357851435,In > Out
Sept 2021,171,17,1,93146,195768,288914,1,1,1,102622,In > Out
Sept 2021,171,172,623,653647111,278279879,931926990,567,595,13,375367232,Out > In
Sept 2021,171,174,906,8990096171,313738647,9303834818,623,900,2,8676357524,Out > In
Sept 2021,171,177,1,104470,16070,120540,1,1,1,88400,Out > In
Sept 2021,171,181,1,313364480,320821986,634186466,1,1,1,7457506,In > Out
Sept 2021,171,184,2,6151898496,6150683912,12302582408,2,2,1,1214584,Out > In
Sept 2021,171,186,1,3456,196473,199929,1,1,1,193017,In > Out
Sept 2021,171,187,9,7805873,20229630,28035503,8,4,9,12423757,In > Out
Sept 2021,171,190,2,201368596,530623964,731992560,2,1,2,329255368,In > Out
Sept 2021,171,194,5,285897245,590616691,876513936,4,3,5,304719446,In > Out
Sept 2021,171,205,1,132342418,32748287,165090705,1,1,1,99594131,Out > In
Sept 2021,171,206,3,1734305,7752023,9486328,2,2,3,6017718,In > Out
Sept 2021,171,208,8,28168390965,28432769994,56601160959,3,3,1,264379029,In > Out
Sept 2021,171,209,4,2482592,7372638,9855230,1,1,4,4890046,In > Out
Sept 2021,171,210,1,86066810,13814273,99881083,1,1,1,72252537,Out > In
Sept 2021,171,211,8,1124484,31812168,32936652,8,7,4,30687684,In > Out
Sept 2021,171,222,2,675151323,144585603,819736926,2,2,2,530565720,Out > In
Sept 2021,171,23,6,48234447,38606830,86841277,4,4,6,9627617,Out > In
Sept 2021,171,30,2,81154773,236162733,317317506,2,2,2,155007960,In > Out
Sept 2021,171,31,2,1519119726,658769804,2177889530,2,2,2,860349922,Out > In
Sept 2021,171,35,3,6943797,22422059,29365856,3,3,3,15478262,In > Out
Sept 2021,171,36,4,2335105346,2736910068,5072015414,3,3,3,401804722,In > Out
Sept 2021,171,41,2,2116095,35989246,38105341,1,1,2,33873151,In > Out
Sept 2021,171,42,1,252590,804726,1057316,1,1,1,552136,In > Out
Sept 2021,171,46,1,90362987,92940456,183303443,1,1,1,2577469,In > Out
Sept 2021,171,47,2,972736945,1004480837,1977217782,2,1,1,31743892,In > Out
Sept 2021,171,57,1,2890744,32671692,35562436,1,1,1,29780948,In > Out
Sept 2021,171,58,4,5928544,13683871,19612415,4,4,4,7755327,In > Out
Sept 2021,171,59,1,15480818,15731371,31212189,1,1,1,250553,In > Out
Sept 2021,171,60,1,3734559,144226558,147961117,1,1,1,140491999,In > Out
Sept 2021,171,65,2,750282,31153063,31903345,1,1,2,30402781,In > Out
Sept 2021,171,74,2,134167415,231473456,365640871,2,2,2,97306041,In > Out
Sept 2021,171,76,2,1448994,943569,2392563,1,2,2,505425,Out > In
Sept 2021,171,79,1,48487,249765,298252,1,1,1,201278,In > Out
Sept 2021,171,81,3,4369968,3930435,8300403,2,2,3,439533,Out > In
Sept 2021,171,82,1,44636545,9328820,53965365,1,1,1,35307725,Out > In
Sept 2021,171,86,4,189513904,231828470,421342374,4,3,2,42314566,In > Out
Sept 2021,171,87,1,17831950,18835136,36667086,1,1,1,1003186,In > Out
Sept 2021,171,88,1,2897513,56912012,59809525,1,1,1,54014499,In > Out
Sept 2021,171,98,7,34048546,8888845,42937391,5,4,4,25159701,Out > In
Sept 2021,174,195,3,33779276,88319368,122098644,3,1,3,54540092,In > Out
Sept 2021,175,192,18,1253153908,199783165,1452937073,3,18,1,1053370743,Out > In
Sept 2021,176,168,2,343932,18710,362642,2,2,1,325222,Out > In
Sept 2021,178,185,1,13228,231880,245108,1,1,1,218652,In > Out
Sept 2021,179,160,16014,188668625812,20141432320,208810058132,2329,7948,2,168527193492,Out > In
Sept 2021,179,222,2,2430369,11937818,14368187,1,2,2,9507449,In > Out
Sept 2021,179,44,22,6371599,662432,7034031,5,22,1,5709167,Out > In
Sept 2021,180,138,1,12963165,6347121,19310286,1,1,1,6616044,Out > In
Sept 2021,180,189,214,443855046,8704123,452559169,144,214,2,435150923,Out > In
Sept 2021,180,193,3,429246248,1161569972,1590816220,2,2,3,732323724,In > Out
Sept 2021,180,96,3,3693374,12704436,16397810,2,1,3,9011062,In > Out
Sept 2021,181,127,2,909147580,9463092,918610672,1,2,2,899684488,Out > In
Sept 2021,181,139,1,407327,64865,472192,1,1,1,342462,Out > In
Sept 2021,181,158,325,1597761616,109082150,1706843766,114,226,1,1488679466,Out > In
Sept 2021,181,162,2,388110,398612,786722,2,2,2,10502,In > Out
Sept 2021,181,164,1,151029,407106,558135,1,1,1,256077,In > Out
Sept 2021,181,175,3,10042932,79824339,89867271,3,2,3,69781407,In > Out
Sept 2021,181,20,5,1450965090,51811830,1502776920,2,5,5,1399153260,Out > In
Sept 2021,181,209,1,4882,273201,278083,1,1,1,268319,In > Out
Sept 2021,181,228,1,175425,28884,204309,1,1,1,146541,Out > In
Sept 2021,181,231,1,56365,108138,164503,1,1,1,51773,In > Out
Sept 2021,181,244,1,56781,55647,112428,1,1,1,1134,Out > In
Sept 2021,181,248,7,1154191165,2214074849,3368266014,7,5,7,1059883684,In > Out
Sept 2021,181,250,9,1108028448,16655089,1124683537,3,9,8,1091373359,Out > In
Sept 2021,181,251,2,44304923,149898805,194203728,1,1,2,105593882,In > Out
Sept 2021,181,64,332,742365376,342408995,1084774371,228,110,1,399956381,Out > In
Sept 2021,181,73,1,376503,1628862,2005365,1,1,1,1252359,In > Out
Sept 2021,181,74,26,24730178,1334642,26064820,16,13,1,23395536,Out > In
Sept 2021,181,77,1,30873953,28459474,59333427,1,1,1,2414479,Out > In
Sept 2021,181,78,3,4421191,12715296,17136487,3,3,3,8294105,In > Out
Sept 2021,183,17,26271,7179637401,76842981,7256480382,141,2152,1,7102794420,Out > In
Sept 2021,183,19,6,1167215,41890,1209105,6,6,1,1125325,Out > In
Sept 2021,184,134,150,37091520,33665309,70756829,56,150,2,3426211,Out > In
Sept 2021,184,135,37,225640934,90234240,315875174,6,37,1,135406694,Out > In
Sept 2021,184,136,13,107249216,114779090,222028306,7,10,13,7529874,In > Out
Sept 2021,184,137,13948,10136879498,1493632550,11630512048,1601,8778,163,8643246948,Out > In
Sept 2021,184,139,2,541423,1552527,2093950,2,1,2,1011104,In > Out
Sept 2021,184,140,4,3896021,234536664,238432685,2,2,4,230640643,In > Out
Sept 2021,184,188,68,9758559,21088965,30847524,12,7,67,11330406,In > Out
Sept 2021,184,216,5,503276,1545342,2048618,1,2,2,1042066,In > Out
Sept 2021,184,218,19,1012917419,56326800,1069244219,4,19,1,956590619,Out > In
Sept 2021,184,219,25,6889407,16171558,23060965,2,13,14,9282151,In > Out
Sept 2021,184,246,3,51721929,11346690,63068619,2,2,2,40375239,Out > In
Sept 2021,19,108,2,218316,291366,509682,2,2,2,73050,In > Out
Sept 2021,19,122,1,1896,154716,156612,1,1,1,152820,In > Out
Sept 2021,19,130,1,99396,5640,105036,1,1,1,93756,Out > In
Sept 2021,19,140,3,325377,17188,342565,1,3,1,308189,Out > In
Sept 2021,19,150,84248,37018227322,1862849185,38881076507,29520,30350,2,35155378137,Out > In
Sept 2021,19,160,195,106473482,3981771,110455253,169,194,2,102491711,Out > In
Sept 2021,19,165,124,37486731,5989510,43476241,77,123,1,31497221,Out > In
Sept 2021,19,168,14922,93713959,3699353389,3793067348,23,9145,2,3605639430,In > Out
Sept 2021,19,169,18,9490210,10181670,19671880,11,17,1,691460,In > Out
Sept 2021,19,190,5,1549225,37384,1586609,2,5,1,1511841,Out > In
Sept 2021,19,191,529,1831092542,558115394,2389207936,75,524,1,1272977148,Out > In
Sept 2021,19,193,9,3261043,69710,3330753,1,9,1,3191333,Out > In
Sept 2021,19,196,6,1076147,2329248,3405395,2,6,1,1253101,In > Out
Sept 2021,19,87,2,365735,8630,374365,2,2,1,357105,Out > In
Sept 2021,190,125,34,10624119,553122,11177241,10,34,1,10070997,Out > In
Sept 2021,190,165,2,483113,263759,746872,2,2,2,219354,Out > In
Sept 2021,190,199,26463,32116039036,822575151,32938614187,9826,17994,2,31293463885,Out > In
Sept 2021,190,39,1,21006,4019344,4040350,1,1,1,3998338,In > Out
Sept 2021,190,43,5,2228310,39599,2267909,5,5,1,2188711,Out > In
Sept 2021,190,44,11379,2109380850,77266052,2186646902,1153,9401,2,2032114798,Out > In
Sept 2021,190,48,3718,427924003,5582144058,6010068061,2,2626,2,5154220055,In > Out
Sept 2021,190,78,1,87093,27911,115004,1,1,1,59182,Out > In
Sept 2021,190,91,132,14850649,807481,15658130,85,130,3,14043168,Out > In
Sept 2021,191,14,2,254450,52174,306624,1,2,1,202276,Out > In
Sept 2021,191,15,1,128965,142838,271803,1,1,1,13873,In > Out
Sept 2021,192,40,6,471844,10700945,11172789,1,6,1,10229101,In > Out
Sept 2021,195,10,1,3360143,392168061,395528204,1,1,1,388807918,In > Out
Sept 2021,195,104,13,92358131,348043840,440401971,6,6,13,255685709,In > Out
Sept 2021,195,105,2,3272063,126129314,129401377,1,1,2,122857251,In > Out
Sept 2021,195,109,3,1095647301,1193012411,2288659712,3,3,3,97365110,In > Out
Sept 2021,195,11,4,4324753,5779725,10104478,2,2,4,1454972,In > Out
Sept 2021,195,113,1,212631,62315941,62528572,1,1,1,62103310,In > Out
Sept 2021,195,114,3,4702453,58497654,63200107,3,2,3,53795201,In > Out
Sept 2021,195,115,2,120105887,116870138,236976025,2,2,2,3235749,Out > In
Sept 2021,195,116,1,2039946153,1719406347,3759352500,1,1,1,320539806,Out > In
Sept 2021,195,117,1,311578756,329439401,641018157,1,1,1,17860645,In > Out
Sept 2021,195,118,1,33783248,44021028,77804276,1,1,1,10237780,In > Out
Sept 2021,195,12,2,807335070,788828018,1596163088,2,2,2,18507052,Out > In
Sept 2021,195,120,1,20329840,182105132,202434972,1,1,1,161775292,In > Out
Sept 2021,195,125,2,103963914,182610688,286574602,2,2,1,78646774,In > Out
Sept 2021,195,129,2,437906618,339569300,777475918,2,2,2,98337318,Out > In
Sept 2021,195,131,2,80509272,62876623,143385895,2,2,2,17632649,Out > In
Sept 2021,195,133,1,423351,10893981,11317332,1,1,1,10470630,In > Out
Sept 2021,195,134,5,1428247360,1436279628,2864526988,5,5,3,8032268,In > Out
Sept 2021,195,14,8,398756784,577556496,976313280,3,3,8,178799712,In > Out
Sept 2021,195,140,4,3993784,42396335,46390119,3,1,4,38402551,In > Out
Sept 2021,195,141,1,1703850,1723227,3427077,1,1,1,19377,In > Out
Sept 2021,195,146,1,3062507,10933345,13995852,1,1,1,7870838,In > Out
Sept 2021,195,151,6,369003210,6082576514,6451579724,4,3,5,5713573304,In > Out
Sept 2021,195,153,46,2308716,229919535,232228251,40,21,33,227610819,In > Out
Sept 2021,195,156,3,5191773,119550496,124742269,2,1,3,114358723,In > Out
Sept 2021,195,163,2,11612337,42798658,54410995,2,2,2,31186321,In > Out
Sept 2021,195,172,11,18531552,70814884,89346436,6,6,9,52283332,In > Out
Sept 2021,195,174,2,48030922,53872810,101903732,2,2,2,5841888,In > Out
Sept 2021,195,175,2,9155558,9716481,18872039,2,2,2,560923,In > Out
Sept 2021,195,177,1,4834845,15092568,19927413,1,1,1,10257723,In > Out
Sept 2021,195,18,5,1664697,8346703,10011400,2,2,5,6682006,In > Out
Sept 2021,195,180,1,334889,263088,597977,1,1,1,71801,Out > In
Sept 2021,195,184,1,108954,2008943,2117897,1,1,1,1899989,In > Out
Sept 2021,195,185,3,8983638,27074461,36058099,2,2,1,18090823,In > Out
Sept 2021,195,186,8,1163455,6207979,7371434,8,2,8,5044524,In > Out
Sept 2021,195,188,3,3569505620,4733085634,8302591254,2,1,2,1163580014,In > Out
Sept 2021,195,19,1,538933477,214850033,753783510,1,1,1,324083444,Out > In
Sept 2021,195,193,1,626715186,965613005,1592328191,1,1,1,338897819,In > Out
Sept 2021,195,199,1,34456385,210689033,245145418,1,1,1,176232648,In > Out
Sept 2021,195,20,2,4351038,699304018,703655056,1,1,2,694952980,In > Out
Sept 2021,195,200,3,23747942,1724671,25472613,2,2,3,22023271,Out > In
Sept 2021,195,203,2,3016652213,3056272033,6072924246,2,2,1,39619820,In > Out
Sept 2021,195,205,8,625002,843752,1468754,8,4,1,218750,In > Out
Sept 2021,195,206,4,1843286764,903049588,2746336352,4,4,4,940237176,Out > In
Sept 2021,195,209,10,642858046,960789460,1603647506,9,7,5,317931414,In > Out
Sept 2021,195,210,2,4131524,171886024,176017548,1,1,2,167754500,In > Out
Sept 2021,195,212,1,385435763,359934675,745370438,1,1,1,25501088,Out > In
Sept 2021,195,214,1,1539709,48598,1588307,1,1,1,1491111,Out > In
Sept 2021,195,216,1,3104402,45314104,48418506,1,1,1,42209702,In > Out
Sept 2021,195,217,1,156248192,519513866,675762058,1,1,1,363265674,In > Out
Sept 2021,195,219,7,26123883,99132680,125256563,2,2,2,73008797,In > Out
Sept 2021,195,22,1,658201,8990496,9648697,1,1,1,8332295,In > Out
Sept 2021,195,220,2,4488502,431676,4920178,2,2,2,4056826,Out > In
Sept 2021,195,221,1,300036834,236441672,536478506,1,1,1,63595162,Out > In
Sept 2021,195,23,2,3559790,7647754,11207544,2,2,1,4087964,In > Out
Sept 2021,195,24,2,4475926900,4037489667,8513416567,2,2,2,438437233,Out > In
Sept 2021,195,29,4,776584464,1399580655,2176165119,2,4,2,622996191,In > Out
Sept 2021,195,31,5,13722458,45805588,59528046,2,5,5,32083130,In > Out
Sept 2021,195,35,2,333509,1118957,1452466,2,2,2,785448,In > Out
Sept 2021,195,36,6,70896182,31761613,102657795,4,4,4,39134569,Out > In
Sept 2021,195,37,1,6135714,3358887,9494601,1,1,1,2776827,Out > In
Sept 2021,195,39,4,7510835759,7429434817,14940270576,4,4,4,81400942,Out > In
Sept 2021,195,43,1,257057,77557019,77814076,1,1,1,77299962,In > Out
Sept 2021,195,45,1,1317446,23250244,24567690,1,1,1,21932798,In > Out
Sept 2021,195,46,1,169837,160643,330480,1,1,1,9194,Out > In
Sept 2021,195,47,2,575848174,813793142,1389641316,2,2,1,237944968,In > Out
Sept 2021,195,49,4,8574839,10035504,18610343,3,4,3,1460665,In > Out
Sept 2021,195,50,4,124500464,181689743,306190207,3,4,2,57189279,In > Out
Sept 2021,195,52,2,218465,23942169,24160634,1,1,2,23723704,In > Out
Sept 2021,195,54,2,494190,88231874,88726064,2,1,2,87737684,In > Out
Sept 2021,195,55,2,564675,750359,1315034,1,1,2,185684,In > Out
Sept 2021,195,56,3,1435546,137904468,139340014,2,1,3,136468922,In > Out
Sept 2021,195,57,1,941926,961467,1903393,1,1,1,19541,In > Out
Sept 2021,195,6,1,79878,365476,445354,1,1,1,285598,In > Out
Sept 2021,195,60,2,1107189,52661807,53768996,1,1,2,51554618,In > Out
Sept 2021,195,63,3,5862740,180953955,186816695,2,1,3,175091215,In > Out
Sept 2021,195,64,3,1166189554,1156745325,2322934879,2,1,1,9444229,Out > In
Sept 2021,195,65,1,1978009,2204008,4182017,1,1,1,225999,In > Out
Sept 2021,195,7,2,1437394,55973156,57410550,2,2,2,54535762,In > Out
Sept 2021,195,72,2,58185785,67261010,125446795,2,2,2,9075225,In > Out
Sept 2021,195,73,1,3352262927,3266805413,6619068340,1,1,1,85457514,Out > In
Sept 2021,195,77,1,3577554458,3667158763,7244713221,1,1,1,89604305,In > Out
Sept 2021,195,81,1,164348,252628,416976,1,1,1,88280,In > Out
Sept 2021,195,83,1,268220156,252873514,521093670,1,1,1,15346642,Out > In
Sept 2021,195,84,1,221364917,221211083,442576000,1,1,1,153834,Out > In
Sept 2021,195,87,3,2848574,2881333,5729907,3,3,3,32759,In > Out
Sept 2021,195,9,1,44397,1728566,1772963,1,1,1,1684169,In > Out
Sept 2021,195,91,1,23929686,28743285,52672971,1,1,1,4813599,In > Out
Sept 2021,195,92,1,754583,591589,1346172,1,1,1,162994,Out > In
Sept 2021,196,12,2,218154,12270,230424,1,2,1,205884,Out > In
Sept 2021,196,126,1,106050,5738,111788,1,1,1,100312,Out > In
Sept 2021,196,149,1,104299,5387,109686,1,1,1,98912,Out > In
Sept 2021,196,151,1,103312,5659,108971,1,1,1,97653,Out > In
Sept 2021,196,184,3,333351,22248,355599,2,3,1,311103,Out > In
Sept 2021,196,188,1,102602,5765,108367,1,1,1,96837,Out > In
Sept 2021,196,196,1,98712,5971,104683,1,1,1,92741,Out > In
Sept 2021,196,197,1,105998,6803,112801,1,1,1,99195,Out > In
Sept 2021,196,212,2,213653,12189,225842,2,2,1,201464,Out > In
Sept 2021,196,222,3,321502,18698,340200,2,3,1,302804,Out > In
Sept 2021,196,229,1,53948,56982,110930,1,1,1,3034,In > Out
Sept 2021,196,28,2,213834,14488,228322,2,2,1,199346,Out > In
Sept 2021,196,78,1,104706,6540,111246,1,1,1,98166,Out > In
Sept 2021,196,82,1,108987,5958,114945,1,1,1,103029,Out > In
Sept 2021,196,90,1,104706,6800,111506,1,1,1,97906,Out > In
Sept 2021,197,102,2,9620606,12034292,21654898,1,2,2,2413686,In > Out
Sept 2021,197,104,2,707689754,681385005,1389074759,1,2,1,26304749,Out > In
Sept 2021,197,105,1,5669303,80970281,86639584,1,1,1,75300978,In > Out
Sept 2021,197,108,3,7621701296,7363364797,14985066093,3,3,1,258336499,Out > In
Sept 2021,197,115,1,762484,1093292,1855776,1,1,1,330808,In > Out
Sept 2021,197,118,1,35012,1005986,1040998,1,1,1,970974,In > Out
Sept 2021,197,121,1,50520284,387259388,437779672,1,1,1,336739104,In > Out
Sept 2021,197,131,2,77008,164220,241228,2,1,2,87212,In > Out
Sept 2021,197,140,2,177481,1347926,1525407,2,2,2,1170445,In > Out
Sept 2021,197,143,3,4187899889,4373286738,8561186627,2,1,1,185386849,In > Out
Sept 2021,197,146,2,311429,9124356,9435785,2,2,2,8812927,In > Out
Sept 2021,197,15,3,382601953,390420127,773022080,3,3,2,7818174,In > Out
Sept 2021,197,152,2,193800,144576,338376,2,1,1,49224,Out > In
Sept 2021,197,153,3,10497749,133376209,143873958,3,3,3,122878460,In > Out
Sept 2021,197,158,3,1217441,22524867,23742308,2,2,3,21307426,In > Out
Sept 2021,197,16,1,1785650,2688728,4474378,1,1,1,903078,In > Out
Sept 2021,197,160,1,71304,106704,178008,1,1,1,35400,In > Out
Sept 2021,197,161,1,321028,321324,642352,1,1,1,296,In > Out
Sept 2021,197,163,6,80341,1429922,1510263,3,2,6,1349581,In > Out
Sept 2021,197,165,2,406815495,966918609,1373734104,2,2,2,560103114,In > Out
Sept 2021,197,166,1,682586315,698010080,1380596395,1,1,1,15423765,In > Out
Sept 2021,197,170,5,1718582,13426872,15145454,2,2,4,11708290,In > Out
Sept 2021,197,174,2,15417686,7564540,22982226,2,2,2,7853146,Out > In
Sept 2021,197,181,2,828710089,701236241,1529946330,2,2,1,127473848,Out > In
Sept 2021,197,183,1,66856,50306,117162,1,1,1,16550,Out > In
Sept 2021,197,187,4,8368391,6530622,14899013,2,4,4,1837769,Out > In
Sept 2021,197,188,1,15428122,17030218,32458340,1,1,1,1602096,In > Out
Sept 2021,197,191,1,155616304,191661881,347278185,1,1,1,36045577,In > Out
Sept 2021,197,194,4,292526,3572285,3864811,2,2,4,3279759,In > Out
Sept 2021,197,198,11,2533122,3655866,6188988,2,2,11,1122744,In > Out
Sept 2021,197,199,1,19214,182753,201967,1,1,1,163539,In > Out
Sept 2021,197,201,2,402179154,536296816,938475970,2,2,2,134117662,In > Out
Sept 2021,197,204,1,211182,239727,450909,1,1,1,28545,In > Out
Sept 2021,197,205,6,26055190,31596909,57652099,5,6,6,5541719,In > Out
Sept 2021,197,212,2,179637,1196035,1375672,2,2,2,1016398,In > Out
Sept 2021,197,219,4,962656,7713856,8676512,1,1,1,6751200,In > Out
Sept 2021,197,221,3,5083704,4492390,9576094,2,3,2,591314,Out > In
Sept 2021,197,223,2,2575441,425549910,428125351,2,2,2,422974469,In > Out
Sept 2021,197,25,1,3269113,148064017,151333130,1,1,1,144794904,In > Out
Sept 2021,197,26,2,75288003,1334696199,1409984202,2,2,2,1259408196,In > Out
Sept 2021,197,30,1,12924,143379,156303,1,1,1,130455,In > Out
Sept 2021,197,31,1,7505848,5247431,12753279,1,1,1,2258417,Out > In
Sept 2021,197,4,5,88061924,169277215,257339139,4,4,5,81215291,In > Out
Sept 2021,197,42,2,1488765833,1311934520,2800700353,2,2,2,176831313,Out > In
Sept 2021,197,44,1,522736,9948,532684,1,1,1,512788,Out > In
Sept 2021,197,49,1,345628,350900,696528,1,1,1,5272,In > Out
Sept 2021,197,54,1,880310265,2675592709,3555902974,1,1,1,1795282444,In > Out
Sept 2021,197,55,3,82745750,284865260,367611010,3,3,3,202119510,In > Out
Sept 2021,197,58,1,341509260,3658779412,4000288672,1,1,1,3317270152,In > Out
Sept 2021,197,77,1,1540,1151396,1152936,1,1,1,1149856,In > Out
Sept 2021,197,78,5,131060734,116998370,248059104,1,5,1,14062364,Out > In
Sept 2021,197,80,1,1302275,791717,2093992,1,1,1,510558,Out > In
Sept 2021,197,81,2,1029503805,1148024446,2177528251,2,2,2,118520641,In > Out
Sept 2021,197,85,2,271500,153618589,153890089,2,2,2,153347089,In > Out
Sept 2021,197,86,6,139419549,140881614,280301163,6,3,3,1462065,In > Out
Sept 2021,197,87,2,136160,134720,270880,1,2,1,1440,Out > In
Sept 2021,197,9,3,1372804,55674019,57046823,1,1,3,54301215,In > Out
Sept 2021,197,90,7,1799557,3224561,5024118,2,2,2,1425004,In > Out
Sept 2021,197,94,1,50481328,66177526,116658854,1,1,1,15696198,In > Out
Sept 2021,197,98,2,482782027,1075371047,1558153074,2,2,2,592589020,In > Out
Sept 2021,198,22,26,799024792,1000067523,1799092315,19,10,26,201042731,In > Out
Sept 2021,199,77,3,3523161,47271,3570432,1,3,1,3475890,Out > In
Sept 2021,199,85,1,2157170,33957,2191127,1,1,1,2123213,Out > In
Sept 2021,2,1,62,4984840,4653252,9638092,10,13,1,331588,Out > In
Sept 2021,2,100,5,7273718,3131715,10405433,2,5,1,4142003,Out > In
Sept 2021,2,12,8043,1048490101,1820087667,2868577768,77,7505,2,771597566,In > Out
Sept 2021,2,14,3,573192592,477163,573669755,3,3,1,572715429,Out > In
Sept 2021,2,15,32,6915150,10715995,17631145,3,32,32,3800845,In > Out
Sept 2021,2,16,1,81656,81715,163371,1,1,1,59,In > Out
Sept 2021,2,17,21133,29656296848,990532084,30646828932,5219,15356,2,28665764764,Out > In
Sept 2021,2,19,17296,57226819943,605094296,57831914239,2977,14110,2,56621725647,Out > In
Sept 2021,2,21,44762,64644801710,1098981584,65743783294,6227,27733,7,63545820126,Out > In
Sept 2021,2,22,3,355507,22759,378266,3,3,2,332748,Out > In
Sept 2021,2,23,6,1606034,248959,1854993,4,6,2,1357075,Out > In
Sept 2021,2,24,10,2228173,76051,2304224,6,10,3,2152122,Out > In
Sept 2021,2,244,812,202509305,343042995,545552300,9,806,1,140533690,In > Out
Sept 2021,2,25,8,1112015,51503,1163518,5,8,3,1060512,Out > In
Sept 2021,2,26,6,793350,33864,827214,5,6,2,759486,Out > In
Sept 2021,2,27,6,740466,33366,773832,5,6,3,707100,Out > In
Sept 2021,2,29,14,2090263,114093,2204356,7,14,2,1976170,Out > In
Sept 2021,2,30,5787,13550407873,198921182,13749329055,1465,5399,4,13351486691,Out > In
Sept 2021,2,31,9,1550455,75738,1626193,6,9,3,1474717,Out > In
Sept 2021,2,32,8,946147,160206,1106353,5,8,2,785941,Out > In
Sept 2021,2,33,31,24478359,551716,25030075,23,31,3,23926643,Out > In
Sept 2021,2,35,11,1475558,203352,1678910,7,11,3,1272206,Out > In
Sept 2021,2,36,9,1268296,280662,1548958,5,9,4,987634,Out > In
Sept 2021,2,37,11,1676005,79864,1755869,5,11,3,1596141,Out > In
Sept 2021,2,38,81,151678822,1967092,153645914,51,81,4,149711730,Out > In
Sept 2021,2,39,8,1044260,49426,1093686,4,8,2,994834,Out > In
Sept 2021,2,4,8,825892,779152,1605044,5,3,1,46740,Out > In
Sept 2021,2,85,9,2525920,99144,2625064,7,9,1,2426776,Out > In
Sept 2021,2,91,30188,149923098709,166258535217,316181633926,588,14988,26,16335436508,In > Out
Sept 2021,200,206,3,511372,23964,535336,3,3,1,487408,Out > In
Sept 2021,200,211,53,105757000,719025,106476025,17,53,1,105037975,Out > In
Sept 2021,200,34,315,768534208,11488000,780022208,55,198,1,757046208,Out > In
Sept 2021,200,65,891,160810499,18418722,179229221,33,251,2,142391777,Out > In
Sept 2021,200,68,1062,3090174580,45435501,3135610081,486,1007,2,3044739079,Out > In
Sept 2021,202,76,1,65598,47896,113494,1,1,1,17702,Out > In
Sept 2021,202,82,13,24600510,1242805,25843315,3,13,1,23357705,Out > In
Sept 2021,203,160,1,3370,110267,113637,1,1,1,106897,In > Out
Sept 2021,204,192,44,418405570,1452795007,1871200577,25,22,42,1034389437,In > Out
Sept 2021,206,147,1,8950516,189936610,198887126,1,1,1,180986094,In > Out
Sept 2021,206,148,1,110580,165581,276161,1,1,1,55001,In > Out
Sept 2021,206,155,1,69785627,228056842,297842469,1,1,1,158271215,In > Out
Sept 2021,206,200,1,227012,547403,774415,1,1,1,320391,In > Out
Sept 2021,207,127,802,2635167065,610507033,3245674098,452,314,2,2024660032,Out > In
Sept 2021,208,113,102872,62533395184,1034379149,63567774333,14044,39256,2,61499016035,Out > In
Sept 2021,208,114,616,263135927,3786619,266922546,197,609,1,259349308,Out > In
Sept 2021,208,115,6575,2509445384,142223160,2651668544,274,5654,1,2367222224,Out > In
Sept 2021,208,119,11,3038835,670992,3709827,1,11,1,2367843,Out > In
Sept 2021,208,125,173542,337872627635,6029931183,343902558818,42830,52025,2,331842696452,Out > In
Sept 2021,208,126,201,59558602,1532341,61090943,82,196,1,58026261,Out > In
Sept 2021,208,127,326,171914448,4517519,176431967,94,320,1,167396929,Out > In
Sept 2021,208,128,72015,27707999561,497777492,28205777053,9306,30604,2,27210222069,Out > In
Sept 2021,208,195,2320,557426636,18853808,576280444,167,2224,1,538572828,Out > In
Sept 2021,208,32,6,3397289,281356,3678645,5,6,2,3115933,Out > In
Sept 2021,208,39,1974,265711841,10991878,276703719,610,1923,2,254719963,Out > In
Sept 2021,208,40,1,262419,8038,270457,1,1,1,254381,Out > In
Sept 2021,208,41,1,124034,223473,347507,1,1,1,99439,In > Out
Sept 2021,208,44,19621,244147140680,1836818040,245983958720,889,12454,2,242310322640,Out > In
Sept 2021,208,45,77461,60639294149,754359885,61393654034,2627,22070,2,59884934264,Out > In
Sept 2021,208,47,32,3746300,1146702,4893002,19,32,1,2599598,Out > In
Sept 2021,208,49,39,9228275,668284,9896559,30,39,1,8559991,Out > In
Sept 2021,208,50,35436,15008024963,2015596719,17023621682,5149,18222,1,12992428244,Out > In
Sept 2021,208,52,2563,814907381,21007510,835914891,362,2464,3,793899871,Out > In
Sept 2021,208,53,374,106307033,2002398,108309431,90,373,2,104304635,Out > In
Sept 2021,208,58,122,172874137,2230393,175104530,85,121,1,170643744,Out > In
Sept 2021,208,59,974,445764734,52974919,498739653,104,969,1,392789815,Out > In
Sept 2021,208,71,70,28360773,14352669,42713442,4,68,1,14008104,Out > In
Sept 2021,208,81,12,1544497,80365,1624862,1,12,1,1464132,Out > In
Sept 2021,208,85,1,458126768,21390564,479517332,1,1,1,436736204,Out > In
Sept 2021,208,87,2392,470684255,17499716,488183971,1015,2312,2,453184539,Out > In
Sept 2021,208,88,125,23963716,712951,24676667,44,125,1,23250765,Out > In
Sept 2021,208,89,6,3791279,85184,3876463,1,6,1,3706095,Out > In
Sept 2021,208,91,1,131421,9129,140550,1,1,1,122292,Out > In
Sept 2021,208,92,101,53269255,2362143,55631398,20,100,2,50907112,Out > In
Sept 2021,208,93,1,868597,22769,891366,1,1,1,845828,Out > In
Sept 2021,208,96,23742,32692716520,627711126,33320427646,10331,16395,2,32065005394,Out > In
Sept 2021,209,100,7,166801396,5094940,171896336,3,7,1,161706456,Out > In
Sept 2021,209,204,2,1181768,94128,1275896,2,2,2,1087640,Out > In
Sept 2021,210,36,1609,591928080610,177441732030,769369812640,574,1533,1,414486348580,Out > In
Sept 2021,210,44,4570,1828011852132,690532937687,2518544789819,1782,4045,1,1137478914445,Out > In
Sept 2021,212,26,4262,18808516822,167348012,18975864834,1519,3986,1,18641168810,Out > In
Sept 2021,213,1,472,26264814337,39324159806,65588974143,286,232,409,13059345469,In > Out
Sept 2021,213,10,317,24607247671,26053601319,50660848990,201,111,264,1446353648,In > Out
Sept 2021,213,100,566,44218366217,59216254772,103434620989,267,144,474,14997888555,In > Out
Sept 2021,213,101,1153,16060022263,23993675649,40053697912,907,921,293,7933653386,In > Out
Sept 2021,213,102,658,24388975600,29931338607,54320314207,519,393,368,5542363007,In > Out
Sept 2021,213,103,237,20700531276,19649934479,40350465755,179,87,206,1050596797,Out > In
Sept 2021,213,104,505,21055539536,22967702475,44023242011,415,333,444,1912162939,In > Out
Sept 2021,213,105,668,28788890136,32873811372,61662701508,282,302,544,4084921236,In > Out
Sept 2021,213,106,273,16995262030,23810179805,40805441835,175,83,228,6814917775,In > Out
Sept 2021,213,107,259,14250236244,17982918915,32233155159,175,117,234,3732682671,In > Out
Sept 2021,213,108,419,10949371300,19197699740,30147071040,300,268,385,8248328440,In > Out
Sept 2021,213,109,358,15709680809,26134365530,41844046339,202,106,321,10424684721,In > Out
Sept 2021,213,11,371,14017996882,19671282267,33689279149,252,112,308,5653285385,In > Out
Sept 2021,213,110,262,11701648068,20631466848,32333114916,170,117,199,8929818780,In > Out
Sept 2021,213,111,366,16931402383,24693439717,41624842100,207,103,314,7762037334,In > Out
Sept 2021,213,112,377,11206234027,17425986120,28632220147,252,170,339,6219752093,In > Out
Sept 2021,213,113,297,21401091929,26862009399,48263101328,178,102,261,5460917470,In > Out
Sept 2021,213,114,294,17228179971,19888656070,37116836041,195,116,249,2660476099,In > Out
Sept 2021,213,115,255,12680270075,21077704949,33757975024,151,84,210,8397434874,In > Out
Sept 2021,213,116,414,8698751726,17944753455,26643505181,238,149,386,9246001729,In > Out
Sept 2021,213,117,568,15974843255,21502767092,37477610347,423,226,332,5527923837,In > Out
Sept 2021,213,118,607,24626713094,37710947019,62337660113,272,337,508,13084233925,In > Out
Sept 2021,213,119,398,8948522605,21041441531,29989964136,203,140,364,12092918926,In > Out
Sept 2021,213,12,215,13400936170,17852731659,31253667829,157,73,187,4451795489,In > Out
Sept 2021,213,120,436,15480848529,20581881591,36062730120,344,268,243,5101033062,In > Out
Sept 2021,213,121,362,18779188891,28117315967,46896504858,219,119,321,9338127076,In > Out
Sept 2021,213,122,443,10505837238,12245182606,22751019844,293,136,197,1739345368,In > Out
Sept 2021,213,123,374,17852260778,22318082589,40170343367,201,135,302,4465821811,In > Out
Sept 2021,213,124,333,19010233524,26483563855,45493797379,203,83,296,7473330331,In > Out
Sept 2021,213,125,270,8625280746,18687032967,27312313713,171,112,220,10061752221,In > Out
Sept 2021,213,126,2018,18069441416,26168970233,44238411649,1660,1736,316,8099528817,In > Out
Sept 2021,213,127,512,13729435905,20479841976,34209277881,393,356,437,6750406071,In > Out
Sept 2021,213,128,503,20178703815,31141259172,51319962987,270,184,431,10962555357,In > Out
Sept 2021,213,129,412,28850534176,39224888344,68075422520,229,145,339,10374354168,In > Out
Sept 2021,213,13,594,19586184395,29889638702,49475823097,365,373,557,10303454307,In > Out
Sept 2021,213,130,862,9343470559,23348421073,32691891632,549,475,731,14004950514,In > Out
Sept 2021,213,131,324,7111150993,19166847776,26277998769,140,147,300,12055696783,In > Out
Sept 2021,213,132,363,20585823197,30651283121,51237106318,222,117,321,10065459924,In > Out
Sept 2021,213,133,326,16824129414,27660160838,44484290252,176,96,290,10836031424,In > Out
Sept 2021,213,134,282,10686123187,21074727539,31760850726,189,104,247,10388604352,In > Out
Sept 2021,213,135,566,11871501717,27154385266,39025886983,372,259,442,15282883549,In > Out
Sept 2021,213,136,663,23343558150,35047203079,58390761229,343,262,346,11703644929,In > Out
Sept 2021,213,137,766,21530388775,23732292929,45262681704,528,228,284,2201904154,In > Out
Sept 2021,213,138,460,14838286972,22173685004,37011971976,326,269,415,7335398032,In > Out
Sept 2021,213,139,247,13450901791,21742914409,35193816200,139,64,228,8292012618,In > Out
Sept 2021,213,14,277,11412567307,17986676899,29399244206,197,106,246,6574109592,In > Out
Sept 2021,213,140,423,28325642578,39181449379,67507091957,261,124,348,10855806801,In > Out
Sept 2021,213,141,406,13746981593,22021579263,35768560856,278,171,345,8274597670,In > Out
Sept 2021,213,142,289,17032149974,22823363310,39855513284,179,94,252,5791213336,In > Out
Sept 2021,213,143,463,18276819487,29188010958,47464830445,258,142,418,10911191471,In > Out
Sept 2021,213,144,1546,8340497734,19527998255,27868495989,1157,1176,442,11187500521,In > Out
Sept 2021,213,145,504,12039578000,21770605957,33810183957,346,323,436,9731027957,In > Out
Sept 2021,213,146,470,34593685456,40703423149,75297108605,264,148,412,6109737693,In > Out
Sept 2021,213,147,362,18235117186,25191653043,43426770229,208,117,305,6956535857,In > Out
Sept 2021,213,148,424,19930839135,30661501660,50592340795,310,235,368,10730662525,In > Out
Sept 2021,213,149,430,23115425543,34895251776,58010677319,285,198,376,11779826233,In > Out
Sept 2021,213,15,320,19353450484,42981216246,62334666730,204,98,276,23627765762,In > Out
Sept 2021,213,150,249,8644946585,18131393208,26776339793,159,72,229,9486446623,In > Out
Sept 2021,213,151,242,21623616545,35137140348,56760756893,149,72,210,13513523803,In > Out
Sept 2021,213,152,418,7735859002,13617430711,21353289713,174,91,390,5881571709,In > Out
Sept 2021,213,153,401,21728019546,28789402470,50517422016,252,122,332,7061382924,In > Out
Sept 2021,213,154,668,33611601106,36094686488,69706287594,550,470,619,2483085382,In > Out
Sept 2021,213,155,446,21333133838,29536598947,50869732785,244,293,397,8203465109,In > Out
Sept 2021,213,156,712,17448897390,28186115657,45635013047,437,430,645,10737218267,In > Out
Sept 2021,213,157,342,23409456402,27982115412,51391571814,217,178,288,4572659010,In > Out
Sept 2021,213,158,468,12190082469,23752307126,35942389595,342,273,406,11562224657,In > Out
Sept 2021,213,159,356,13215765568,22809915496,36025681064,214,104,291,9594149928,In > Out
Sept 2021,213,16,299,11056494680,19702388719,30758883399,221,119,246,8645894039,In > Out
Sept 2021,213,160,432,16356720273,33572632941,49929353214,210,124,385,17215912668,In > Out
Sept 2021,213,161,283,21354584396,31360264804,52714849200,192,89,241,10005680408,In > Out
Sept 2021,213,162,335,12138087307,15368021253,27506108560,270,185,194,3229933946,In > Out
Sept 2021,213,163,855,11645838108,15045798888,26691636996,429,460,783,3399960780,In > Out
Sept 2021,213,164,375,21031661351,110799439462,131831100813,222,94,302,89767778111,In > Out
Sept 2021,213,165,492,10487540476,20744269971,31231810447,367,273,272,10256729495,In > Out
Sept 2021,213,166,381,19798093675,23856402340,43654496015,218,187,343,4058308665,In > Out
Sept 2021,213,167,302,25453599500,64314602341,89768201841,209,125,265,38861002841,In > Out
Sept 2021,213,168,371,11045610319,19178357283,30223967602,251,106,263,8132746964,In > Out
Sept 2021,213,169,552,11762060858,26185380601,37947441459,237,115,503,14423319743,In > Out
Sept 2021,213,17,1722,12856549214,26354329223,39210878437,1537,1480,375,13497780009,In > Out
Sept 2021,213,170,351,13814329345,19086189336,32900518681,220,125,262,5271859991,In > Out
Sept 2021,213,171,988,23413356466,38082866263,61496222729,819,764,457,14669509797,In > Out
Sept 2021,213,172,1202,44384244114,37454228146,81838472260,596,374,858,6930015968,Out > In
Sept 2021,213,173,377,9908129188,20215847231,30123976419,196,96,344,10307718043,In > Out
Sept 2021,213,174,1348,15158017467,24530222937,39688240404,1188,1105,329,9372205470,In > Out
Sept 2021,213,175,557,12277175962,16606690899,28883866861,321,263,525,4329514937,In > Out
Sept 2021,213,176,318,14488720764,26393453582,40882174346,169,98,254,11904732818,In > Out
Sept 2021,213,177,280,12843815733,20746291658,33590107391,185,105,233,7902475925,In > Out
Sept 2021,213,178,294,11747382531,19310802014,31058184545,200,83,247,7563419483,In > Out
Sept 2021,213,179,326,14401403965,22727258159,37128662124,189,101,276,8325854194,In > Out
Sept 2021,213,18,286,12197369341,19139640323,31337009664,182,111,245,6942270982,In > Out
Sept 2021,213,180,362,25916818297,40937329711,66854148008,241,123,323,15020511414,In > Out
Sept 2021,213,181,426,16934066246,22812675871,39746742117,203,152,373,5878609625,In > Out
Sept 2021,213,182,356,22425539501,29445537066,51871076567,231,120,321,7019997565,In > Out
Sept 2021,213,183,908,28914709422,46819696506,75734405928,693,644,821,17904987084,In > Out
Sept 2021,213,184,470,28867442862,39986726160,68854169022,268,211,424,11119283298,In > Out
Sept 2021,213,185,341,24131429463,31661586245,55793015708,213,118,299,7530156782,In > Out
Sept 2021,213,186,564,25935757440,34441073507,60376830947,286,134,459,8505316067,In > Out
Sept 2021,213,187,391,12172856169,24354229608,36527085777,212,99,357,12181373439,In > Out
Sept 2021,213,188,359,9906932998,12093141697,22000074695,218,122,330,2186208699,In > Out
Sept 2021,213,189,748,21477974609,43923626009,65401600618,598,458,293,22445651400,In > Out
Sept 2021,213,19,429,16972091594,61186134568,78158226162,291,207,390,44214042974,In > Out
Sept 2021,213,190,292,39698065532,49165396587,88863462119,182,96,219,9467331055,In > Out
Sept 2021,213,191,805,11562810501,22618006172,34180816673,617,523,453,11055195671,In > Out
Sept 2021,213,192,398,32128305511,40699593130,72827898641,289,179,331,8571287619,In > Out
Sept 2021,213,193,386,18886753251,25543885729,44430638980,229,121,344,6657132478,In > Out
Sept 2021,213,194,301,16473045142,29614368717,46087413859,218,124,259,13141323575,In > Out
Sept 2021,213,195,420,13239464796,39543785557,52783250353,208,109,373,26304320761,In > Out
Sept 2021,213,196,427,12217920342,18545323667,30763244009,240,129,381,6327403325,In > Out
Sept 2021,213,197,399,7274548684,14295547327,21570096011,221,178,356,7020998643,In > Out
Sept 2021,213,198,1239,23391700819,33499771755,56891472574,996,941,363,10108070936,In > Out
Sept 2021,213,199,286,18383015664,22677620549,41060636213,166,90,238,4294604885,In > Out
Sept 2021,213,2,299,40757629317,42059714611,82817343928,194,109,252,1302085294,In > Out
Sept 2021,213,20,338,35189094940,44621787469,79810882409,227,113,269,9432692529,In > Out
Sept 2021,213,200,436,11464007115,21752068297,33216075412,339,241,392,10288061182,In > Out
Sept 2021,213,201,467,22596612049,27776488218,50373100267,369,305,428,5179876169,In > Out
Sept 2021,213,202,344,30067407394,46281880745,76349288139,200,114,281,16214473351,In > Out
Sept 2021,213,203,297,17390607580,24824344512,42214952092,178,101,263,7433736932,In > Out
Sept 2021,213,204,429,34652398343,43220981443,77873379786,312,228,364,8568583100,In > Out
Sept 2021,213,205,397,11128576887,17833836304,28962413191,217,119,359,6705259417,In > Out
Sept 2021,213,206,541,17886426475,28349350144,46235776619,329,234,499,10462923669,In > Out
Sept 2021,213,207,272,15085382766,19851665130,34937047896,193,120,208,4766282364,In > Out
Sept 2021,213,208,437,28344943915,39188602454,67533546369,230,89,371,10843658539,In > Out
Sept 2021,213,209,501,32973931479,41956768117,74930699596,293,180,448,8982836638,In > Out
Sept 2021,213,21,493,18098852592,31331014300,49429866892,300,124,356,13232161708,In > Out
Sept 2021,213,210,328,14063572283,23530686964,37594259247,218,150,293,9467114681,In > Out
Sept 2021,213,211,376,18275396693,22104217984,40379614677,252,161,338,3828821291,In > Out
Sept 2021,213,212,704,20517189797,27598438719,48115628516,344,469,617,7081248922,In > Out
Sept 2021,213,213,466,23886420126,40744542228,64630962354,321,219,405,16858122102,In > Out
Sept 2021,213,214,338,11437999780,18182356195,29620355975,233,111,260,6744356415,In > Out
Sept 2021,213,215,326,17275875169,24952634289,42228509458,214,99,279,7676759120,In > Out
Sept 2021,213,216,570,15360100588,22087564747,37447665335,288,305,500,6727464159,In > Out
Sept 2021,213,217,444,18215387485,29048379060,47263766545,279,210,395,10832991575,In > Out
Sept 2021,213,218,330,30592756677,38789456906,69382213583,192,89,259,8196700229,In > Out
Sept 2021,213,219,388,17944990755,29033173015,46978163770,231,112,342,11088182260,In > Out
Sept 2021,213,22,391,8266189520,19163703937,27429893457,207,86,321,10897514417,In > Out
Sept 2021,213,220,907,28084425997,49065826408,77150252405,685,683,344,20981400411,In > Out
Sept 2021,213,221,416,13361206469,19071616585,32432823054,307,159,334,5710410116,In > Out
Sept 2021,213,222,381,30374616020,32713390372,63088006392,269,155,337,2338774352,In > Out
Sept 2021,213,223,1265,28842204872,36563817835,65406022707,835,362,448,7721612963,In > Out
Sept 2021,213,224,464,19064626062,37671709270,56736335332,360,256,380,18607083208,In > Out
Sept 2021,213,225,725,13597463338,22863321886,36460785224,600,490,485,9265858548,In > Out
Sept 2021,213,226,747,34660347608,44465304287,79125651895,464,165,357,9804956679,In > Out
Sept 2021,213,227,1117,21599711845,33090534849,54690246694,725,555,572,11490823004,In > Out
Sept 2021,213,228,335,11018544816,15137484525,26156029341,196,117,295,4118939709,In > Out
Sept 2021,213,229,498,10254420276,24521742846,34776163122,396,296,455,14267322570,In > Out
Sept 2021,213,23,473,17849251143,30289519303,48138770446,308,158,338,12440268160,In > Out
Sept 2021,213,230,282,7919363635,19053842934,26973206569,186,86,245,11134479299,In > Out
Sept 2021,213,231,381,7805656488,13393516047,21199172535,261,142,302,5587859559,In > Out
Sept 2021,213,232,343,35220216710,40730058639,75950275349,217,133,286,5509841929,In > Out
Sept 2021,213,233,450,18359645027,26874408433,45234053460,319,184,335,8514763406,In > Out
Sept 2021,213,234,275,5717804934,10494578717,16212383651,180,82,249,4776773783,In > Out
Sept 2021,213,235,362,23406929298,35190450676,58597379974,210,109,321,11783521378,In > Out
Sept 2021,213,236,532,26895260103,39291384351,66186644454,381,299,428,12396124248,In > Out
Sept 2021,213,237,601,19239701331,32487491165,51727192496,420,319,507,13247789834,In > Out
Sept 2021,213,238,691,33790144028,71055011048,104845155076,315,189,623,37264867020,In > Out
Sept 2021,213,239,363,31273448647,30434007140,61707455787,219,153,317,839441507,Out > In
Sept 2021,213,24,1382,34431335196,49681388500,84112723696,491,325,1058,15250053304,In > Out
Sept 2021,213,240,346,24522985649,26536139866,51059125515,243,178,317,2013154217,In > Out
Sept 2021,213,241,503,19204256828,26956158454,46160415282,265,123,407,7751901626,In > Out
Sept 2021,213,242,352,11609699298,18844224771,30453924069,198,129,309,7234525473,In > Out
Sept 2021,213,243,350,12505939421,19474407684,31980347105,209,115,284,6968468263,In > Out
Sept 2021,213,244,400,17640747706,25440918629,43081666335,258,160,329,7800170923,In > Out
Sept 2021,213,245,516,22828189713,33165342703,55993532416,380,291,410,10337152990,In > Out
Sept 2021,213,246,378,26329378910,37914989011,64244367921,245,141,328,11585610101,In > Out
Sept 2021,213,247,519,20134276887,26906007460,47040284347,377,320,338,6771730573,In > Out
Sept 2021,213,248,350,7844531195,16492843115,24337374310,206,132,299,8648311920,In > Out
Sept 2021,213,249,514,15000435756,66664169455,81664605211,220,92,449,51663733699,In > Out
Sept 2021,213,25,240,9831385305,20209162440,30040547745,182,106,211,10377777135,In > Out
Sept 2021,213,250,440,37586830335,49339055782,86925886117,320,231,379,11752225447,In > Out
Sept 2021,213,251,413,28671935166,45150399026,73822334192,309,227,340,16478463860,In > Out
Sept 2021,213,252,3558,38694854983,23047241685,61742096668,2296,3144,3155,15647613298,Out > In
Sept 2021,213,253,346,21929438696,28529361806,50458800502,199,83,316,6599923110,In > Out
Sept 2021,213,26,596,18976558215,29846548735,48823106950,392,172,372,10869990520,In > Out
Sept 2021,213,27,439,15331385570,29542637556,44874023126,319,235,399,14211251986,In > Out
Sept 2021,213,28,410,13389971787,25028991741,38418963528,239,170,297,11639019954,In > Out
Sept 2021,213,29,335,25398087784,40338668701,65736756485,195,83,272,14940580917,In > Out
Sept 2021,213,3,201,13761997612,20323745307,34085742919,142,81,171,6561747695,In > Out
Sept 2021,213,30,354,15835395027,23422719565,39258114592,206,104,308,7587324538,In > Out
Sept 2021,213,31,2556,17550862411,34352634746,51903497157,2029,2223,550,16801772335,In > Out
Sept 2021,213,32,443,14848926042,17787794151,32636720193,281,205,407,2938868109,In > Out
Sept 2021,213,33,421,18766569745,24813576319,43580146064,336,229,392,6047006574,In > Out
Sept 2021,213,34,396,4965644321,13002210391,17967854712,284,182,369,8036566070,In > Out
Sept 2021,213,35,348,19704345012,31161657489,50866002501,204,117,292,11457312477,In > Out
Sept 2021,213,36,283,15957899266,23492086466,39449985732,183,83,214,7534187200,In > Out
Sept 2021,213,37,274,9079387824,16965201004,26044588828,180,67,238,7885813180,In > Out
Sept 2021,213,38,480,15831831348,21566606046,37398437394,212,123,432,5734774698,In > Out
Sept 2021,213,39,329,15145222546,23407985465,38553208011,231,149,279,8262762919,In > Out
Sept 2021,213,4,457,38314569634,36419902730,74734472364,356,255,405,1894666904,Out > In
Sept 2021,213,40,345,15653968379,26777151381,42431119760,233,132,305,11123183002,In > Out
Sept 2021,213,41,378,31008887342,40656208970,71665096312,260,167,344,9647321628,In > Out
Sept 2021,213,42,599,34995427285,55654531660,90649958945,446,357,525,20659104375,In > Out
Sept 2021,213,43,444,14521386291,22319535492,36840921783,226,142,406,7798149201,In > Out
Sept 2021,213,44,389,18567036028,29851654501,48418690529,225,126,333,11284618473,In > Out
Sept 2021,213,45,339,27176353805,30096271247,57272625052,241,150,270,2919917442,In > Out
Sept 2021,213,46,356,11447510789,16551864385,27999375174,249,154,291,5104353596,In > Out
Sept 2021,213,47,610,12832292899,15334645862,28166938761,352,347,577,2502352963,In > Out
Sept 2021,213,48,348,27418941795,33612768501,61031710296,243,135,282,6193826706,In > Out
Sept 2021,213,49,357,24131565353,32682411314,56813976667,230,156,302,8550845961,In > Out
Sept 2021,213,5,459,28739270738,29809861385,58549132123,290,186,413,1070590647,In > Out
Sept 2021,213,50,387,18344433653,23739898958,42084332611,267,168,326,5395465305,In > Out
Sept 2021,213,51,253,17157690134,26404789273,43562479407,193,115,214,9247099139,In > Out
Sept 2021,213,52,476,6663677964,14005130694,20668808658,213,104,438,7341452730,In > Out
Sept 2021,213,53,409,9947257831,25273487543,35220745374,212,215,372,15326229712,In > Out
Sept 2021,213,54,520,18714860096,24999399248,43714259344,270,195,422,6284539152,In > Out
Sept 2021,213,55,274,7161812882,13301294610,20463107492,189,104,220,6139481728,In > Out
Sept 2021,213,56,474,9315955262,17451713029,26767668291,303,271,457,8135757767,In > Out
Sept 2021,213,57,311,29510873792,40237532006,69748405798,212,111,243,10726658214,In > Out
Sept 2021,213,58,257,18696425403,29078776610,47775202013,172,100,223,10382351207,In > Out
Sept 2021,213,59,408,11237703471,17619051064,28856754535,302,197,316,6381347593,In > Out
Sept 2021,213,6,239,10035167532,25809016269,35844183801,166,70,197,15773848737,In > Out
Sept 2021,213,60,464,18077090477,27946304926,46023395403,254,168,427,9869214449,In > Out
Sept 2021,213,61,332,10650145378,23706536090,34356681468,229,141,259,13056390712,In > Out
Sept 2021,213,62,328,16206751218,24613469376,40820220594,252,158,258,8406718158,In > Out
Sept 2021,213,63,600,14214897408,24060979465,38275876873,436,328,529,9846082057,In > Out
Sept 2021,213,64,361,13745443505,18539954985,32285398490,202,120,314,4794511480,In > Out
Sept 2021,213,65,403,19856739477,28543415693,48400155170,279,173,362,8686676216,In > Out
Sept 2021,213,66,248,13841934752,20034932922,33876867674,163,80,224,6192998170,In > Out
Sept 2021,213,67,285,18924213715,23850479133,42774692848,168,123,230,4926265418,In > Out
Sept 2021,213,68,481,10254278927,16736360957,26990639884,186,145,408,6482082030,In > Out
Sept 2021,213,69,318,17366895041,21391527086,38758422127,215,144,262,4024632045,In > Out
Sept 2021,213,7,373,19183783305,33136112016,52319895321,283,191,241,13952328711,In > Out
Sept 2021,213,70,295,11867040669,19818053025,31685093694,190,134,252,7951012356,In > Out
Sept 2021,213,71,359,11840248934,17885867429,29726116363,263,217,308,6045618495,In > Out
Sept 2021,213,72,336,8561557094,13527872599,22089429693,258,173,287,4966315505,In > Out
Sept 2021,213,73,323,13376372349,20724359197,34100731546,219,131,284,7347986848,In > Out
Sept 2021,213,74,262,13986956264,23677360531,37664316795,152,124,224,9690404267,In > Out
Sept 2021,213,75,303,13102846579,17063701966,30166548545,219,120,270,3960855387,In > Out
Sept 2021,213,76,242,10699790475,19654515993,30354306468,157,58,204,8954725518,In > Out
Sept 2021,213,77,246,8368887740,19189285513,27558173253,152,59,210,10820397773,In > Out
Sept 2021,213,78,387,12586933795,20418271517,33005205312,262,215,356,7831337722,In > Out
Sept 2021,213,79,444,30877866654,40217366495,71095233149,295,192,391,9339499841,In > Out
Sept 2021,213,8,771,26760963743,34915117686,61676081429,464,366,526,8154153943,In > Out
Sept 2021,213,80,418,15711533738,16606619571,32318153309,298,201,261,895085833,In > Out
Sept 2021,213,81,326,20420126145,24699866061,45119992206,223,113,276,4279739916,In > Out
Sept 2021,213,82,514,28879884646,34985978338,63865862984,410,327,374,6106093692,In > Out
Sept 2021,213,83,619,25047530522,29245020758,54292551280,438,424,583,4197490236,In > Out
Sept 2021,213,84,303,11668194548,26953974692,38622169240,200,95,259,15285780144,In > Out
Sept 2021,213,85,402,6986611354,13590684632,20577295986,282,225,370,6604073278,In > Out
Sept 2021,213,86,560,15541754448,32756845217,48298599665,426,310,514,17215090769,In > Out
Sept 2021,213,87,311,17193138010,24488716786,41681854796,189,93,273,7295578776,In > Out
Sept 2021,213,88,341,50234710639,55738621876,105973332515,238,169,298,5503911237,In > Out
Sept 2021,213,89,338,18459185153,26362976438,44822161591,211,141,302,7903791285,In > Out
Sept 2021,213,9,783,12362938001,21207818170,33570756171,251,120,730,8844880169,In > Out
Sept 2021,213,90,653,9833513127,16566710300,26400223427,440,209,285,6733197173,In > Out
Sept 2021,213,91,379,10929963708,17769214066,28699177774,257,145,275,6839250358,In > Out
Sept 2021,213,92,221,21295656701,26000948085,47296604786,148,65,187,4705291384,In > Out
Sept 2021,213,93,280,30775624321,34330264965,65105889286,188,85,236,3554640644,In > Out
Sept 2021,213,94,347,14898865491,27083144912,41982010403,183,108,303,12184279421,In > Out
Sept 2021,213,95,258,23707954739,36629484326,60337439065,177,89,233,12921529587,In > Out
Sept 2021,213,96,285,9507003438,24826833159,34333836597,164,74,266,15319829721,In > Out
Sept 2021,213,97,276,21724545373,32697919892,54422465265,184,92,234,10973374519,In > Out
Sept 2021,213,98,282,20826097665,36183722196,57009819861,177,80,245,15357624531,In > Out
Sept 2021,213,99,443,17316154816,26012595667,43328750483,247,154,332,8696440851,In > Out
Sept 2021,215,113,3995,76049410122,6219343291,82268753413,1752,2203,1,69830066831,Out > In
Sept 2021,215,154,1,375707,644646,1020353,1,1,1,268939,In > Out
Sept 2021,215,51,10,10526707,404021647,414548354,6,3,10,393494940,In > Out
Sept 2021,215,55,20,19229091,778937,20008028,1,20,1,18450154,Out > In
Sept 2021,220,32,170,230947667,4980711,235928378,23,170,1,225966956,Out > In
Sept 2021,221,16,1034,6015783160,4713254142,10729037302,260,791,4,1302529018,Out > In
Sept 2021,221,168,14,90337382,668241389,758578771,11,2,14,577904007,In > Out
Sept 2021,221,185,1,231090981,136099660,367190641,1,1,1,94991321,Out > In
Sept 2021,221,212,2,232928711,1704701471,1937630182,2,2,2,1471772760,In > Out
Sept 2021,221,22,21,22774891,2039145,24814036,1,21,1,20735746,Out > In
Sept 2021,221,36,2,217914774,369554397,587469171,2,1,2,151639623,In > Out
Sept 2021,221,42,14,7469289,194184,7663473,12,10,1,7275105,Out > In
Sept 2021,221,46,559,5630577722,769794877,6400372599,207,311,1,4860782845,Out > In
Sept 2021,221,62,149,72514078,19455119,91969197,76,135,2,53058959,Out > In
Sept 2021,221,80,1,257418,842400,1099818,1,1,1,584982,In > Out
Sept 2021,222,230,1,26689,388130,414819,1,1,1,361441,In > Out
Sept 2021,224,179,1,2596034,13764879,16360913,1,1,1,11168845,In > Out
Sept 2021,225,136,2,793914,23392313,24186227,1,1,2,22598399,In > Out
Sept 2021,225,149,3,570234216,1727021664,2297255880,2,2,3,1156787448,In > Out
Sept 2021,225,202,13,2345070,680870,3025940,11,9,1,1664200,Out > In
Sept 2021,225,218,106,105076549,3068069,108144618,75,105,1,102008480,Out > In
Sept 2021,225,8,26,324924238,1396235898,1721160136,5,25,6,1071311660,In > Out
Sept 2021,228,104,2,761736759,1148699399,1910436158,2,1,1,386962640,In > Out
Sept 2021,228,105,5,648616389,377358627,1025975016,5,5,2,271257762,Out > In
Sept 2021,228,107,1,10818,123822,134640,1,1,1,113004,In > Out
Sept 2021,228,11,1,1720666,1675754,3396420,1,1,1,44912,Out > In
Sept 2021,228,110,7,13002455,642827747,655830202,3,3,7,629825292,In > Out
Sept 2021,228,113,2,16185172,22078131,38263303,2,2,2,5892959,In > Out
Sept 2021,228,114,4,75719210,86716250,162435460,3,4,1,10997040,In > Out
Sept 2021,228,116,3,585519,1975773,2561292,3,3,1,1390254,In > Out
Sept 2021,228,119,3,2794140,24089085,26883225,2,2,3,21294945,In > Out
Sept 2021,228,12,11,52094311,72004795,124099106,6,7,6,19910484,In > Out
Sept 2021,228,123,2,1755823,1490000,3245823,2,2,2,265823,Out > In
Sept 2021,228,131,1,48696,1195415,1244111,1,1,1,1146719,In > Out
Sept 2021,228,132,10,23142461,34664180,57806641,5,9,6,11521719,In > Out
Sept 2021,228,134,8,1619904,16645922,18265826,3,3,8,15026018,In > Out
Sept 2021,228,138,1,28801,313549,342350,1,1,1,284748,In > Out
Sept 2021,228,14,5,1426919387,2777236533,4204155920,5,4,3,1350317146,In > Out
Sept 2021,228,142,44,9298095,304578348,313876443,6,7,44,295280253,In > Out
Sept 2021,228,145,1,27086111,1015144,28101255,1,1,1,26070967,Out > In
Sept 2021,228,15,8,744884342,1392302081,2137186423,6,3,8,647417739,In > Out
Sept 2021,228,151,3,3735819,19301373,23037192,2,1,3,15565554,In > Out
Sept 2021,228,152,3,3998293,7889577,11887870,3,3,3,3891284,In > Out
Sept 2021,228,16,4,9803392,6780182,16583574,3,4,4,3023210,Out > In
Sept 2021,228,165,2,2158723,132838349,134997072,1,1,2,130679626,In > Out
Sept 2021,228,168,2,649796844,843712086,1493508930,2,2,2,193915242,In > Out
Sept 2021,228,171,2,373609,305208,678817,2,2,2,68401,Out > In
Sept 2021,228,180,6,1975230607,2788117060,4763347667,3,4,4,812886453,In > Out
Sept 2021,228,183,1,624173181,625218160,1249391341,1,1,1,1044979,In > Out
Sept 2021,228,184,3,260527064,262913240,523440304,2,1,1,2386176,In > Out
Sept 2021,228,187,4,2299160,1295942,3595102,1,1,4,1003218,Out > In
Sept 2021,228,191,4,6353976,28167777,34521753,3,3,4,21813801,In > Out
Sept 2021,228,193,2,48923015,41613934,90536949,2,2,2,7309081,Out > In
Sept 2021,228,195,6,2911112,8889024,11800136,3,2,6,5977912,In > Out
Sept 2021,228,199,4,28955410,1893559,30848969,3,4,4,27061851,Out > In
Sept 2021,228,200,3,3175118053,2987635572,6162753625,3,3,3,187482481,Out > In
Sept 2021,228,201,13,12398782813,12333693195,24732476008,7,11,7,65089618,Out > In
Sept 2021,228,206,1,1684779,21735353,23420132,1,1,1,20050574,In > Out
Sept 2021,228,208,1,733568,249592,983160,1,1,1,483976,Out > In
Sept 2021,228,209,6,1688908793,810114816,2499023609,2,6,4,878793977,Out > In
Sept 2021,228,21,1,12406804,125227068,137633872,1,1,1,112820264,In > Out
Sept 2021,228,214,8,1013503053,997020779,2010523832,6,5,5,16482274,Out > In
Sept 2021,228,215,1,2090947,76438817,78529764,1,1,1,74347870,In > Out
Sept 2021,228,216,5,1018400,2790285,3808685,5,5,5,1771885,In > Out
Sept 2021,228,23,33,4890264948,4987406308,9877671256,27,29,7,97141360,In > Out
Sept 2021,228,30,5,71905323,51192235,123097558,3,5,3,20713088,Out > In
Sept 2021,228,32,2,106982532,213032964,320015496,2,2,2,106050432,In > Out
Sept 2021,228,35,2,6882805827,6331090671,13213896498,1,1,1,551715156,Out > In
Sept 2021,228,36,1,32225083,31471252,63696335,1,1,1,753831,Out > In
Sept 2021,228,39,3,733052449,1692761161,2425813610,3,3,2,959708712,In > Out
Sept 2021,228,4,21,2220488,41259058,43479546,2,2,21,39038570,In > Out
Sept 2021,228,41,7,345226685,391661579,736888264,5,4,7,46434894,In > Out
Sept 2021,228,42,4,75434394,126394655,201829049,2,4,3,50960261,In > Out
Sept 2021,228,44,1,27177909,46045170,73223079,1,1,1,18867261,In > Out
Sept 2021,228,45,2,4061280,489301155,493362435,2,1,2,485239875,In > Out
Sept 2021,228,51,7,812540069,657117335,1469657404,6,7,6,155422734,Out > In
Sept 2021,228,57,4,193503964,240850739,434354703,3,3,3,47346775,In > Out
Sept 2021,228,62,1,21330699,16688504,38019203,1,1,1,4642195,Out > In
Sept 2021,228,63,2,140364696,163299355,303664051,2,2,2,22934659,In > Out
Sept 2021,228,65,6,365442752,480993125,846435877,4,4,5,115550373,In > Out
Sept 2021,228,70,1,229920,70799373,71029293,1,1,1,70569453,In > Out
Sept 2021,228,71,14,187508811,596304595,783813406,7,3,14,408795784,In > Out
Sept 2021,228,74,1,6828661,16892011,23720672,1,1,1,10063350,In > Out
Sept 2021,228,79,6,227999816,199115711,427115527,6,2,6,28884105,Out > In
Sept 2021,228,8,2,413526560,2489290211,2902816771,1,1,1,2075763651,In > Out
Sept 2021,228,85,2,2549371,38072323,40621694,2,1,2,35522952,In > Out
Sept 2021,228,92,1,736193244,546900333,1283093577,1,1,1,189292911,Out > In
Sept 2021,228,95,1,139589020,157101684,296690704,1,1,1,17512664,In > Out
Sept 2021,228,98,1,1198368,258160,1456528,1,1,1,940208,Out > In
Sept 2021,229,104,4,606794775,561159453,1167954228,2,4,4,45635322,Out > In
Sept 2021,229,107,4,1596461,5945162,7541623,1,1,4,4348701,In > Out
Sept 2021,229,108,5,20155866,112381574,132537440,4,2,5,92225708,In > Out
Sept 2021,229,11,7,4829854,4091157,8921011,3,3,7,738697,Out > In
Sept 2021,229,111,2,342077101,308038483,650115584,2,2,1,34038618,Out > In
Sept 2021,229,115,1,123708,1655698,1779406,1,1,1,1531990,In > Out
Sept 2021,229,118,2,953640,1347149,2300789,2,2,2,393509,In > Out
Sept 2021,229,119,1,1062300,16444,1078744,1,1,1,1045856,Out > In
Sept 2021,229,122,1,436929,325622,762551,1,1,1,111307,Out > In
Sept 2021,229,123,3,3531490,39742233,43273723,3,3,3,36210743,In > Out
Sept 2021,229,126,5,2596194,19962647,22558841,3,2,5,17366453,In > Out
Sept 2021,229,127,2,19281468,14438597,33720065,2,1,2,4842871,Out > In
Sept 2021,229,129,5,1070706049,1064083525,2134789574,5,5,2,6622524,Out > In
Sept 2021,229,130,1,4877709,79020531,83898240,1,1,1,74142822,In > Out
Sept 2021,229,132,5,16051511,15169044,31220555,4,5,4,882467,Out > In
Sept 2021,229,134,5,14010629,49584363,63594992,4,4,5,35573734,In > Out
Sept 2021,229,137,2,233241,288682,521923,1,2,2,55441,In > Out
Sept 2021,229,142,8,232080866,335990721,568071587,5,4,7,103909855,In > Out
Sept 2021,229,143,5,1242371,25891919,27134290,1,1,5,24649548,In > Out
Sept 2021,229,144,1,9448363,2468860,11917223,1,1,1,6979503,Out > In
Sept 2021,229,145,6,13723297,47054848,60778145,4,4,6,33331551,In > Out
Sept 2021,229,146,2,494854266,515186794,1010041060,2,2,1,20332528,In > Out
Sept 2021,229,149,1,23180166,23251641,46431807,1,1,1,71475,In > Out
Sept 2021,229,15,8,665308399,882816609,1548125008,8,5,8,217508210,In > Out
Sept 2021,229,154,4,508823455,457553634,966377089,2,4,3,51269821,Out > In
Sept 2021,229,155,2,57382877,59147190,116530067,2,2,2,1764313,In > Out
Sept 2021,229,156,1,55770724,147302023,203072747,1,1,1,91531299,In > Out
Sept 2021,229,159,1,2054041,1802228,3856269,1,1,1,251813,Out > In
Sept 2021,229,168,4,742172455,1133346847,1875519302,3,3,1,391174392,In > Out
Sept 2021,229,171,2,152734592,101565160,254299752,1,2,1,51169432,Out > In
Sept 2021,229,175,4,2836802,12488145,15324947,4,3,4,9651343,In > Out
Sept 2021,229,177,1,7140658,7086439,14227097,1,1,1,54219,Out > In
Sept 2021,229,178,1,175259692,180447604,355707296,1,1,1,5187912,In > Out
Sept 2021,229,18,4,435486,2233442,2668928,2,2,4,1797956,In > Out
Sept 2021,229,181,4,7269285,232386361,239655646,3,1,4,225117076,In > Out
Sept 2021,229,182,13,6862992929,6042602425,12905595354,9,6,12,820390504,Out > In
Sept 2021,229,186,1,204600542,235617924,440218466,1,1,1,31017382,In > Out
Sept 2021,229,190,5,2939102,6780372,9719474,3,3,5,3841270,In > Out
Sept 2021,229,191,7,5098272,33585957,38684229,5,6,7,28487685,In > Out
Sept 2021,229,193,1,1133425,463101,1596526,1,1,1,670324,Out > In
Sept 2021,229,195,2,3314674,85195332,88510006,1,1,2,81880658,In > Out
Sept 2021,229,20,3,16291014,18786505,35077519,3,3,3,2495491,In > Out
Sept 2021,229,200,1,1198616,3544550,4743166,1,1,1,2345934,In > Out
Sept 2021,229,208,4,39650952,105032234,144683186,4,3,4,65381282,In > Out
Sept 2021,229,210,3,3411699132,3500052301,6911751433,1,3,3,88353169,In > Out
Sept 2021,229,212,2,169753090,316172970,485926060,2,2,1,146419880,In > Out
Sept 2021,229,213,2,418100,861528,1279628,2,2,2,443428,In > Out
Sept 2021,229,214,4,620845164,361262807,982107971,4,3,4,259582357,Out > In
Sept 2021,229,216,2,7656520,5027651,12684171,2,2,2,2628869,Out > In
Sept 2021,229,217,16,419005988,313275239,732281227,13,4,14,105730749,Out > In
Sept 2021,229,27,1,77527264,12766129,90293393,1,1,1,64761135,Out > In
Sept 2021,229,30,4,733776783,1516824009,2250600792,4,4,2,783047226,In > Out
Sept 2021,229,32,5,14190978,26243837,40434815,5,5,5,12052859,In > Out
Sept 2021,229,38,1,2969428,262147370,265116798,1,1,1,259177942,In > Out
Sept 2021,229,44,3,20304907,16119829,36424736,3,3,3,4185078,Out > In
Sept 2021,229,45,5,11767029,294398095,306165124,4,2,5,282631066,In > Out
Sept 2021,229,5,1,81076,106868,187944,1,1,1,25792,In > Out
Sept 2021,229,55,8,141395768,162090613,303486381,5,5,8,20694845,In > Out
Sept 2021,229,58,3,3367477,151483384,154850861,1,1,3,148115907,In > Out
Sept 2021,229,6,6,224271871,84680981,308952852,5,5,5,139590890,Out > In
Sept 2021,229,63,2,2939177,4726519,7665696,2,2,2,1787342,In > Out
Sept 2021,229,64,6,3627817226,3530207790,7158025016,5,6,5,97609436,Out > In
Sept 2021,229,66,2,99509411,82574312,182083723,1,2,2,16935099,Out > In
Sept 2021,229,67,16,74457681,117033633,191491314,3,11,14,42575952,In > Out
Sept 2021,229,70,22,33522060,1208890000,1242412060,5,4,7,1175367940,In > Out
Sept 2021,229,71,2,1533913609,1542690258,3076603867,2,2,1,8776649,In > Out
Sept 2021,229,72,3,1037700,102329412,103367112,1,1,3,101291712,In > Out
Sept 2021,229,77,2,323354,132759,456113,2,1,2,190595,Out > In
Sept 2021,229,79,9,189447343,411286521,600733864,5,3,9,221839178,In > Out
Sept 2021,229,80,3,4306683849,5112138724,9418822573,1,2,1,805454875,In > Out
Sept 2021,229,81,11,74070608,7915058,81985666,3,4,11,66155550,Out > In
Sept 2021,229,89,4,97149626,243056179,340205805,4,4,4,145906553,In > Out
Sept 2021,229,92,10,42656652,34096325,76752977,3,4,10,8560327,Out > In
Sept 2021,230,171,4,861421,21900,883321,2,4,1,839521,Out > In
Sept 2021,232,239,11,2978216,59187249,62165465,3,4,8,56209033,In > Out
Sept 2021,234,126,1,651396,154443,805839,1,1,1,496953,Out > In
Sept 2021,234,129,23,1078832535,2153832108,3232664643,20,4,23,1074999573,In > Out
Sept 2021,234,130,2,2169358,37861491,40030849,2,2,2,35692133,In > Out
Sept 2021,234,151,2,533073920,245526514,778600434,1,2,1,287547406,Out > In
Sept 2021,234,233,4,445132,55915777,56360909,2,1,4,55470645,In > Out
Sept 2021,234,29,4,54485902,14340305,68826207,1,4,2,40145597,Out > In
Sept 2021,234,65,3,3507943,99732774,103240717,3,2,3,96224831,In > Out
Sept 2021,234,66,7,25285640,520020,25805660,5,7,1,24765620,Out > In
Sept 2021,234,89,3,23871235,117021514,140892749,2,1,3,93150279,In > Out
Sept 2021,235,212,314,170169472,5051114,175220586,5,313,1,165118358,Out > In
Sept 2021,235,223,514463,245280711746,7373757440,252654469186,13508,43622,2,237906954306,Out > In
Sept 2021,236,253,25,1611336748,2068000993,3679337741,18,18,25,456664245,In > Out
Sept 2021,239,207,2,1305517,39653,1345170,2,2,1,1265864,Out > In
Sept 2021,239,63,3,381429,24988,406417,3,3,1,356441,Out > In
Sept 2021,242,104,2,23274810,4108422,27383232,2,2,2,19166388,Out > In
Sept 2021,242,110,8,7490146,229332,7719478,2,8,1,7260814,Out > In
Sept 2021,242,122,6,9570942,194427,9765369,2,6,1,9376515,Out > In
Sept 2021,242,174,21,7972268,353215,8325483,7,21,1,7619053,Out > In
Sept 2021,242,41,10,1204111954,775139177,1979251131,5,10,10,428972777,Out > In
Sept 2021,242,44,151,882624168,48236523,930860691,8,150,1,834387645,Out > In
Sept 2021,242,45,12,9782879932,2033284060,11816163992,4,12,12,7749595872,Out > In
Sept 2021,246,193,3,5075975,305031691,310107666,1,1,3,299955716,In > Out
Sept 2021,246,220,1,1065100,1760792,2825892,1,1,1,695692,In > Out
Sept 2021,248,192,1,48274,62975,111249,1,1,1,14701,In > Out
Sept 2021,250,204,6,9698378,5921650,15620028,2,2,2,3776728,Out > In
Sept 2021,250,3,4,8635542,10610712,19246254,2,2,2,1975170,In > Out
Sept 2021,250,51,1,7022889,10499136,17522025,1,1,1,3476247,In > Out
Sept 2021,250,62,1,174611,48203,222814,1,1,1,126408,Out > In
Sept 2021,250,67,4,1058923,35106,1094029,3,4,1,1023817,Out > In
Sept 2021,256,1,2,205561,10875,216436,1,2,1,194686,Out > In
Sept 2021,256,104,192,409228037,5891893,415119930,95,191,1,403336144,Out > In
Sept 2021,256,11,362,234561474,39006988,273568462,38,353,6,195554486,Out > In
Sept 2021,256,12,90,19584188,1145351,20729539,33,90,3,18438837,Out > In
Sept 2021,256,15,383,7563522,196696825,204260347,275,380,2,189133303,In > Out
Sept 2021,256,248,940,11747874619,44354025470,56101900089,544,281,793,32606150851,In > Out
Sept 2021,256,249,954,10815020620,38704296546,49519317166,559,338,872,27889275926,In > Out
Sept 2021,256,250,1159,21329791681,49512108552,70841900233,661,439,969,28182316871,In > Out
Sept 2021,256,251,1505,10985081235,37324597580,48309678815,1020,729,841,26339516345,In > Out
Sept 2021,256,252,843,7140305736,40258002594,47398308330,478,214,697,33117696858,In > Out
Sept 2021,256,253,876,14106727206,41479614509,55586341715,471,187,790,27372887303,In > Out
Sept 2021,256,254,1107,10913545157,35041981168,45955526325,601,359,959,24128436011,In > Out
Sept 2021,26,2,5,391303,375995,767298,1,5,1,15308,Out > In
Sept 2021,28,129,1,1770,268745,270515,1,1,1,266975,In > Out
Sept 2021,28,130,2,55559,316315,371874,2,2,1,260756,In > Out
Sept 2021,28,131,69926,292570262718,7327670533,299897933251,2252,30613,3,285242592185,Out > In
Sept 2021,28,133,1,175864,272800,448664,1,1,1,96936,In > Out
Sept 2021,28,135,2237,733557112,26326287,759883399,16,2178,1,707230825,Out > In
Sept 2021,28,137,40245,164130753021,1524091114,165654844135,286,16138,3,162606661907,Out > In
Sept 2021,28,138,51211,128055921847,1423445178,129479367025,265,15603,13569,126632476669,Out > In
Sept 2021,28,139,26899,100930902066,999316102,101930218168,289,14679,2,99931585964,Out > In
Sept 2021,28,143,572,2188216,59898905,62087121,2,535,1,57710689,In > Out
Sept 2021,28,146,17,10438373,609879,11048252,4,17,1,9828494,Out > In
Sept 2021,28,147,77,417768530,89606329,507374859,12,77,2,328162201,Out > In
Sept 2021,28,148,19,15193549,336469,15530018,15,19,1,14857080,Out > In
Sept 2021,28,149,160,73773721,1649746,75423467,136,158,1,72123975,Out > In
Sept 2021,28,151,593,297933298,7113421,305046719,85,586,1,290819877,Out > In
Sept 2021,28,152,39,43513041,1617933,45130974,15,39,2,41895108,Out > In
Sept 2021,28,154,8,7355787,13076920,20432707,2,8,1,5721133,In > Out
Sept 2021,28,157,63,103174916,2450363,105625279,41,63,1,100724553,Out > In
Sept 2021,28,159,268,351680131,6081761,357761892,126,260,1,345598370,Out > In
Sept 2021,28,160,2,421737,232799,654536,2,2,2,188938,Out > In
Sept 2021,28,163,11,3430485,361399,3791884,2,11,1,3069086,Out > In
Sept 2021,28,164,15,14108801,226108,14334909,2,15,1,13882693,Out > In
Sept 2021,28,165,6,1321172,70400,1391572,2,6,1,1250772,Out > In
Sept 2021,28,167,4220,916813653,381846351,1298660004,49,4026,2,534967302,Out > In
Sept 2021,28,171,42,8975812,410052,9385864,9,42,1,8565760,Out > In
Sept 2021,28,172,41,82654341,1035165,83689506,18,41,1,81619176,Out > In
Sept 2021,28,173,149,36242631,1570700,37813331,60,149,2,34671931,Out > In
Sept 2021,28,174,1,240309,5430,245739,1,1,1,234879,Out > In
Sept 2021,28,175,2,2779361,52008,2831369,1,2,1,2727353,Out > In
Sept 2021,28,179,105,1330980,40003866,41334846,13,3,105,38672886,In > Out
Sept 2021,28,181,859,9775658,284691374,294467032,8,9,840,274915716,In > Out
Sept 2021,28,182,55,197555015,3878215,201433230,35,55,1,193676800,Out > In
Sept 2021,28,183,160,70978407,1459629,72438036,133,160,1,69518778,Out > In
Sept 2021,28,188,29,35327496,998000,36325496,12,29,2,34329496,Out > In
Sept 2021,28,191,64,31538263,760006,32298269,24,64,1,30778257,Out > In
Sept 2021,28,193,14,10921948,116580,11038528,1,14,1,10805368,Out > In
Sept 2021,28,194,5,307140789,40222972167,40530112956,2,5,2,39915831378,In > Out
Sept 2021,28,195,3543,543022716,23540486,566563202,281,3337,1,519482230,Out > In
Sept 2021,28,196,1,334074,9846,343920,1,1,1,324228,Out > In
Sept 2021,28,197,1,112703,3637,116340,1,1,1,109066,Out > In
Sept 2021,28,198,246,106143588,2518881,108662469,169,244,2,103624707,Out > In
Sept 2021,28,199,462,122616146,3989598,126605744,185,455,2,118626548,Out > In
Sept 2021,28,202,185,75799072,1551162,77350234,128,183,2,74247910,Out > In
Sept 2021,28,203,622,940206782,16472448,956679230,246,571,2,923734334,Out > In
Sept 2021,28,205,1,757990,50206,808196,1,1,1,707784,Out > In
Sept 2021,28,206,24,29124938,445785,29570723,2,24,1,28679153,Out > In
Sept 2021,29,54,1,24459164,10633236,35092400,1,1,1,13825928,Out > In
Sept 2021,33,159,1,88,167724,167812,1,1,1,167636,In > Out
Sept 2021,34,201,4,326452,391468,717920,3,4,1,65016,In > Out
Sept 2021,35,118,841,282302392,68031125,350333517,126,825,1,214271267,Out > In
Sept 2021,35,16,9,1281555,320905,1602460,1,7,1,960650,Out > In
Sept 2021,35,192,18,12016121,333132,12349253,11,18,1,11682989,Out > In
Sept 2021,35,195,149,404021030,6740832,410761862,95,149,2,397280198,Out > In
Sept 2021,35,202,53,8594796,265877,8860673,3,53,1,8328919,Out > In
Sept 2021,35,212,1047,3459592108,3855318424,7314910532,300,1011,2,395726316,In > Out
Sept 2021,35,35,47,889222136,46229366963,47118589099,13,47,1,45340144827,In > Out
Sept 2021,35,38,51,7107875,300418,7408293,26,51,1,6807457,Out > In
Sept 2021,35,44,3,601807,10625,612432,2,3,1,591182,Out > In
Sept 2021,35,58,65,17760673,620727,18381400,27,61,1,17139946,Out > In
Sept 2021,35,60,2940,15904877497,1998373048,17903250545,189,2719,1,13906504449,Out > In
Sept 2021,35,61,11,1635182,235404,1870586,8,11,1,1399778,Out > In
Sept 2021,37,71,15,11200458,691159,11891617,1,15,1,10509299,Out > In
Sept 2021,37,76,21620,93411396267,2022556832,95433953099,5230,15576,1,91388839435,Out > In
Sept 2021,38,17,1,120277,10225,130502,1,1,1,110052,Out > In
Sept 2021,38,19,3,859778,17571,877349,3,3,1,842207,Out > In
Sept 2021,38,20,1,101964,4673,106637,1,1,1,97291,Out > In
Sept 2021,38,21,3,685759,18059,703818,2,3,1,667700,Out > In
Sept 2021,38,40,5,162205,602894,765099,5,5,1,440689,In > Out
Sept 2021,38,41,390320,144842876555,54256066020,199098942575,40980,49904,1,90586810535,Out > In
Sept 2021,38,42,7625,3050242866,1723648296,4773891162,1324,6363,1,1326594570,Out > In
Sept 2021,38,43,34386,13023899733,4668956876,17692856609,5196,17474,1,8354942857,Out > In
Sept 2021,38,44,87972,28779720872,6532391066,35312111938,17979,27424,1,22247329806,Out > In
Sept 2021,38,45,15276,37345285395,2801253008,40146538403,1534,11003,1,34544032387,Out > In
Sept 2021,38,47,5,266962,1921123,2188085,1,5,1,1654161,In > Out
Sept 2021,38,48,1,151422,238323,389745,1,1,1,86901,In > Out
Sept 2021,38,49,6467,1211708902,98862344,1310571246,1,5373,1,1112846558,Out > In
Sept 2021,38,55,3,298595,54387,352982,2,3,1,244208,Out > In
Sept 2021,38,56,1,112252,8314,120566,1,1,1,103938,Out > In
Sept 2021,4,104,95,4825384811,77631096,4903015907,21,93,15,4747753715,Out > In
Sept 2021,4,106,16,272328897,4278131,276607028,3,16,2,268050766,Out > In
Sept 2021,4,11,1,197230,213951,411181,1,1,1,16721,In > Out
Sept 2021,4,15,20,2415821761,49037871,2464859632,4,20,5,2366783890,Out > In
Sept 2021,43,4,8,10098616,9138159,19236775,6,8,2,960457,Out > In
Sept 2021,44,128,42,59660986,165875256,225536242,23,21,38,106214270,In > Out
Sept 2021,46,113,1,121000,81104,202104,1,1,1,39896,Out > In
Sept 2021,46,122,9,295270119,7129736282,7425006401,4,2,4,6834466163,In > Out
Sept 2021,46,14,5,6875942,174511023,181386965,3,1,5,167635081,In > Out
Sept 2021,46,146,28,300058606,2195280636,2495339242,14,10,25,1895222030,In > Out
Sept 2021,46,149,1,54682,12924127,12978809,1,1,1,12869445,In > Out
Sept 2021,46,150,1,1558006,37701223,39259229,1,1,1,36143217,In > Out
Sept 2021,46,159,1,4900,165011,169911,1,1,1,160111,In > Out
Sept 2021,46,162,2,1223138,4728551,5951689,1,1,2,3505413,In > Out
Sept 2021,46,170,3,4627028,161010404,165637432,2,1,3,156383376,In > Out
Sept 2021,46,175,12,17817075,35935173,53752248,8,7,9,18118098,In > Out
Sept 2021,46,178,11,44566338,226090995,270657333,6,4,11,181524657,In > Out
Sept 2021,46,195,1,2486,843988,846474,1,1,1,841502,In > Out
Sept 2021,46,196,4,851309007,1009226251,1860535258,3,2,4,157917244,In > Out
Sept 2021,46,200,6,1861590688,1832104004,3693694692,6,5,6,29486684,Out > In
Sept 2021,46,205,2,3983205,26553558,30536763,2,2,2,22570353,In > Out
Sept 2021,46,220,10,2359342206,3104097494,5463439700,8,4,10,744755288,In > Out
Sept 2021,46,45,8,21320956,237563425,258884381,6,4,7,216242469,In > Out
Sept 2021,46,6,1,11861149,15776015,27637164,1,1,1,3914866,In > Out
Sept 2021,46,62,32,423439281,395854028,819293309,9,12,31,27585253,Out > In
Sept 2021,46,75,18,38943234,131831654,170774888,17,9,4,92888420,In > Out
Sept 2021,46,8,6,620160,27766100,28386260,3,3,6,27145940,In > Out
Sept 2021,46,80,5,67328578,511617550,578946128,5,4,5,444288972,In > Out
Sept 2021,46,81,2,1098794,23546020,24644814,2,1,2,22447226,In > Out
Sept 2021,46,86,3,5482445,44724065,50206510,3,2,3,39241620,In > Out
Sept 2021,46,94,8,2496471,3895426,6391897,6,6,7,1398955,In > Out
Sept 2021,46,99,15,151546153,236352151,387898304,7,6,15,84805998,In > Out
Sept 2021,47,53,267,2443190525,554216130,2997406655,181,184,85,1888974395,Out > In
Sept 2021,48,159,66,69530462,599469750,669000212,20,12,66,529939288,In > Out
Sept 2021,48,36,23,370042011,223743132,593785143,6,5,23,146298879,Out > In
Sept 2021,48,39,200,2881215971,2606898019,5488113990,26,12,180,274317952,Out > In
Sept 2021,48,41,4,2980814,255865813,258846627,2,2,4,252884999,In > Out
Sept 2021,48,59,17,148027048,19226030,167253078,7,6,17,128801018,Out > In
Sept 2021,49,113,49,4870140085,198403086622,203273226707,27,16,49,193532946537,In > Out
Sept 2021,49,114,67,1764389088,1871160755,3635549843,25,39,67,106771667,In > Out
Sept 2021,49,115,15,790330608,1359526024,2149856632,9,5,14,569195416,In > Out
Sept 2021,49,116,33,2129775209,1532605110,3662380319,17,10,30,597170099,Out > In
Sept 2021,49,117,23,159620814,998686377,1158307191,14,6,23,839065563,In > Out
Sept 2021,49,118,101,3415152508,4131180388,7546332896,45,51,98,716027880,In > Out
Sept 2021,49,119,45,869066580,2233607388,3102673968,20,9,43,1364540808,In > Out
Sept 2021,49,120,268,5185710280,10584027874,15769738154,55,18,262,5398317594,In > Out
Sept 2021,49,121,30,941857268,1895943693,2837800961,13,7,28,954086425,In > Out
Sept 2021,49,122,107,1802054077,3643561372,5445615449,30,59,101,1841507295,In > Out
Sept 2021,49,123,60,5048481736,5652430517,10700912253,37,16,55,603948781,In > Out
Sept 2021,49,124,86,4211876559,6697221682,10909098241,31,36,83,2485345123,In > Out
Sept 2021,49,125,19,371037726,824297342,1195335068,12,2,19,453259616,In > Out
Sept 2021,49,126,19,33638842,756219103,789857945,12,1,19,722580261,In > Out
Sept 2021,49,180,4,7254284,1023196,8277480,2,2,2,6231088,Out > In
Sept 2021,5,103,31,20883146,9977920,30861066,3,31,1,10905226,Out > In
Sept 2021,5,19,94,367072041,87417938,454489979,35,94,1,279654103,Out > In
Sept 2021,5,22,90,412236722,97758643,509995365,8,90,6,314478079,Out > In
Sept 2021,5,23,27,22531981210,355773335,22887754545,3,27,1,22176207875,Out > In
Sept 2021,5,25,60,191848460,41383799,233232259,17,60,5,150464661,Out > In
Sept 2021,5,27,32,67469271,11115061,78584332,4,32,3,56354210,Out > In
Sept 2021,5,42,287,4633958013,792357314,5426315327,92,286,1,3841600699,Out > In
Sept 2021,5,46,301,15422877783,340100079,15762977862,112,298,1,15082777704,Out > In
Sept 2021,5,47,150,635261048,124499963,759761011,64,149,1,510761085,Out > In
Sept 2021,50,52,35,390958036,181317051,572275087,8,34,1,209640985,Out > In
Sept 2021,51,151,10,3982375247,49313399,4031688646,1,10,10,3933061848,Out > In
Sept 2021,51,154,12,10445816,932318044,942763860,1,12,12,921872228,In > Out
Sept 2021,51,173,6,417298537,569964169,987262706,4,3,6,152665632,In > Out
Sept 2021,51,182,983,3770848532,115347679,3886196211,82,959,24,3655500853,Out > In
Sept 2021,51,207,2,410443731,235298668,645742399,1,1,2,175145063,Out > In
Sept 2021,51,209,8,3893150208,109704631,4002854839,1,8,8,3783445577,Out > In
Sept 2021,51,226,2,116958,185953,302911,2,2,2,68995,In > Out
Sept 2021,51,230,2,150604613,34531107,185135720,1,1,2,116073506,Out > In
Sept 2021,51,239,2,116231514,4778352,121009866,1,2,2,111453162,Out > In
Sept 2021,51,254,4,83623,799857,883480,4,4,1,716234,In > Out
Sept 2021,51,4,3,144137,446866,591003,3,3,1,302729,In > Out
Sept 2021,51,5,1,1740,322770,324510,1,1,1,321030,In > Out
Sept 2021,51,50,8,3022553483,43172339,3065725822,6,4,8,2979381144,Out > In
Sept 2021,51,54,14,1144802339,14304589,1159106928,8,5,13,1130497750,Out > In
Sept 2021,51,62,1,210141563,14735584,224877147,1,1,1,195405979,Out > In
Sept 2021,52,10,652,515488023,162844363,678332386,144,636,7,352643660,Out > In
Sept 2021,52,113,13,2223668,154234,2377902,12,13,3,2069434,Out > In
Sept 2021,52,118,2,2099494,317378,2416872,1,2,1,1782116,Out > In
Sept 2021,52,12,594,481924436,305300699,787225135,99,522,10,176623737,Out > In
Sept 2021,52,137,10,2086289,965522,3051811,2,10,1,1120767,Out > In
Sept 2021,52,164,1,258066,266031,524097,1,1,1,7965,In > Out
Sept 2021,52,199,7182,57388770497,753790829,58142561326,472,6369,1061,56634979668,Out > In
Sept 2021,52,24,9,1864488,57901,1922389,5,9,2,1806587,Out > In
Sept 2021,52,29,17608,304522076035,4423432847,308945508882,350,11635,2,300098643188,Out > In
Sept 2021,52,35,6,3538984,447779648,451318632,1,6,6,444240664,In > Out
Sept 2021,52,92,1,56560,67888,124448,1,1,1,11328,In > Out
Sept 2021,52,97,630,1071492696,88615080,1160107776,173,630,2,982877616,Out > In
Sept 2021,53,169,1,80392,178160,258552,1,1,1,97768,In > Out
Sept 2021,53,171,292,176336536,19702734,196039270,1,272,1,156633802,Out > In
Sept 2021,53,28,4,3887763,88629,3976392,3,4,1,3799134,Out > In
Sept 2021,54,144,1,76345116,9981011,86326127,1,1,1,66364105,Out > In
Sept 2021,54,145,1,926963,75784544,76711507,1,1,1,74857581,In > Out
Sept 2021,55,130,1747,46279366603,362308761,46641675364,538,1700,2,45917057842,Out > In
Sept 2021,55,9,6,110752323,6090139,116842462,3,6,1,104662184,Out > In
Sept 2021,55,96,4,668191575,30767975,698959550,2,4,1,637423600,Out > In
Sept 2021,56,134,3,7469506,11076974,18546480,1,2,3,3607468,In > Out
Sept 2021,56,147,7,485956217,1430911687,1916867904,5,5,7,944955470,In > Out
Sept 2021,56,181,3,116388491,1293740934,1410129425,3,1,3,1177352443,In > Out
Sept 2021,57,129,89,112867794,16572472,129440266,66,33,1,96295322,Out > In
Sept 2021,57,131,1556,1155861823,27993097,1183854920,86,1478,1,1127868726,Out > In
Sept 2021,57,152,10,1050467,32387,1082854,5,10,1,1018080,Out > In
Sept 2021,57,153,1,996,204374,205370,1,1,1,203378,In > Out
Sept 2021,57,166,145,83030169,3906869,86937038,1,145,1,79123300,Out > In
Sept 2021,57,180,3,58115006,2635768,60750774,1,2,3,55479238,Out > In
Sept 2021,57,2,1,175978,13452,189430,1,1,1,162526,Out > In
Sept 2021,57,207,4,719238,725449,1444687,1,1,3,6211,In > Out
Sept 2021,58,218,4,9885410,27387890,37273300,4,2,4,17502480,In > Out
Sept 2021,58,234,11,593525756,901682725,1495208481,11,5,11,308156969,In > Out
Sept 2021,6,231,3,2612415,23867307,26479722,1,2,3,21254892,In > Out
Sept 2021,6,232,4,5391404,208251349,213642753,2,3,4,202859945,In > Out
Sept 2021,6,45,3,140901358,205221771,346123129,3,3,3,64320413,In > Out
Sept 2021,6,57,99,249565146,76047259,325612405,67,44,2,173517887,Out > In
Sept 2021,6,7,340,690113754,324732686,1014846440,236,118,1,365381068,Out > In
Sept 2021,60,103,22,2217992,4752669,6970661,2,22,1,2534677,In > Out
Sept 2021,60,105,22042,37233523260,919962763,38153486023,1866,14631,1,36313560497,Out > In
Sept 2021,60,107,6661,16680537879,212032855,16892570734,223,5925,1,16468505024,Out > In
Sept 2021,60,110,6,1358830,44802,1403632,4,6,1,1314028,Out > In
Sept 2021,60,112,12,2642371,251006,2893377,10,11,1,2391365,Out > In
Sept 2021,60,114,445,210097821,12610385,222708206,150,439,1,197487436,Out > In
Sept 2021,60,115,188,52473635,1392642,53866277,86,181,1,51080993,Out > In
Sept 2021,60,116,231,162452208,4727522,167179730,30,229,1,157724686,Out > In
Sept 2021,60,117,148,13015464923,5635688851,18651153774,56,148,1,7379776072,Out > In
Sept 2021,60,118,269,117636825,2626707,120263532,1,268,1,115010118,Out > In
Sept 2021,60,119,34718,24126499565,4223426872,28349926437,3252,22359,1,19903072693,Out > In
Sept 2021,60,121,11332,53659826868,633755321,54293582189,2417,9810,2,53026071547,Out > In
Sept 2021,60,132,3,359136,19767,378903,3,3,1,339369,Out > In
Sept 2021,60,133,1143,828383533,70441004,898824537,55,673,1,757942529,Out > In
Sept 2021,60,16,11,784511,944801,1729312,1,11,1,160290,In > Out
Sept 2021,60,17,1,114238,111946,226184,1,1,1,2292,Out > In
Sept 2021,60,18,2,158119,111386,269505,1,2,1,46733,Out > In
Sept 2021,60,19,1,452679,8365,461044,1,1,1,444314,Out > In
Sept 2021,60,24,63,15083166,1990326,17073492,27,63,1,13092840,Out > In
Sept 2021,60,27,2127,680867066,168598658,849465724,446,2017,1,512268408,Out > In
Sept 2021,60,31,2980,729904905,63468681,793373586,1396,2801,1,666436224,Out > In
Sept 2021,60,34,95532,146128542958,3115535834,149244078792,19533,39133,2,143013007124,Out > In
Sept 2021,60,35,6544,1932418102,1122019776,3054437878,1092,5680,1,810398326,Out > In
Sept 2021,60,38,1,157150,254397,411547,1,1,1,97247,In > Out
Sept 2021,60,44,9199,5427031594,334981220,5762012814,1440,7565,1,5092050374,Out > In
Sept 2021,60,46,9,6705004,100526,6805530,8,9,1,6604478,Out > In
Sept 2021,60,47,1,160221,256974,417195,1,1,1,96753,In > Out
Sept 2021,60,52,83,15322269,7255232,22577501,6,83,1,8067037,Out > In
Sept 2021,60,54,113,22884617,23167014,46051631,43,113,1,282397,In > Out
Sept 2021,60,56,50,26188202,2378865,28567067,11,50,1,23809337,Out > In
Sept 2021,60,66,4052,1135247809,1426474219,2561722028,945,3749,2,291226410,In > Out
Sept 2021,60,68,2,202384,59043,261427,2,2,1,143341,Out > In
Sept 2021,60,69,48,44016020,801332,44817352,11,48,1,43214688,Out > In
Sept 2021,60,70,3273,5545071243,85509938,5630581181,629,3011,1,5459561305,Out > In
Sept 2021,60,73,1,97569,5157,102726,1,1,1,92412,Out > In
Sept 2021,60,74,4,448443,24107,472550,4,4,1,424336,Out > In
Sept 2021,60,76,1875,2514523932,347491533,2862015465,360,1813,1,2167032399,Out > In
Sept 2021,60,77,980,1328709504,58142300,1386851804,48,953,1,1270567204,Out > In
Sept 2021,60,79,2,216563,46149,262712,1,2,1,170414,Out > In
Sept 2021,60,83,60,57797286,4512202,62309488,25,60,1,53285084,Out > In
Sept 2021,60,85,146,48883262,1610290,50493552,67,144,1,47272972,Out > In
Sept 2021,60,87,54738,24419036944,706167477,25125204421,9315,22032,1,23712869467,Out > In
Sept 2021,60,88,5,722562,398559,1121121,4,5,1,324003,Out > In
Sept 2021,60,89,486,99275077,4269574,103544651,371,480,1,95005503,Out > In
Sept 2021,60,91,5,1081447,21130,1102577,5,5,1,1060317,Out > In
Sept 2021,60,93,90,2058479,42966856,45025335,8,89,1,40908377,In > Out
Sept 2021,60,94,3685,24918937,1738836317,1763755254,23,3553,1,1713917380,In > Out
Sept 2021,60,95,3,449075,25347,474422,1,3,1,423728,Out > In
Sept 2021,60,96,13,1944806,109019,2053825,1,13,1,1835787,Out > In
Sept 2021,60,98,127,34302069,3573369,37875438,47,127,1,30728700,Out > In
Sept 2021,60,99,114,83550012,2340164,85890176,56,114,1,81209848,Out > In
Sept 2021,65,114,813,3929805948,937560003,4867365951,473,354,2,2992245945,Out > In
Sept 2021,65,181,2,11568571,311859324,323427895,1,1,2,300290753,In > Out
Sept 2021,65,226,2,93100,118030,211130,2,1,2,24930,In > Out
Sept 2021,65,236,1,2641974,16801,2658775,1,1,1,2625173,Out > In
Sept 2021,65,70,3,191943712,998927931,1190871643,1,1,3,806984219,In > Out
Sept 2021,7,119,27,2218889702,2220255318,4439145020,18,9,27,1365616,In > Out
Sept 2021,7,129,4267,2978633994,157410012,3136044006,279,3824,3,2821223982,Out > In
Sept 2021,7,49,5,475318,5190808,5666126,1,5,1,4715490,In > Out
Sept 2021,7,56,2,13452084,3619332,17071416,1,2,1,9832752,Out > In
Sept 2021,7,94,7,40337556,82534534,122872090,6,2,7,42196978,In > Out
Sept 2021,7,97,113,707687101,59255059,766942160,3,110,1,648432042,Out > In
Sept 2021,70,10,7,2809348,3061200,5870548,2,2,7,251852,In > Out
Sept 2021,70,100,1,863753,61941773,62805526,1,1,1,61078020,In > Out
Sept 2021,70,101,4,628289092,231063881,859352973,3,2,1,397225211,Out > In
Sept 2021,70,104,4,490595848,749847291,1240443139,4,4,3,259251443,In > Out
Sept 2021,70,106,2,104906981,105215740,210122721,2,2,2,308759,In > Out
Sept 2021,70,108,10,2863586406,1773236843,4636823249,7,5,6,1090349563,Out > In
Sept 2021,70,121,2,298550683,304479550,603030233,2,2,2,5928867,In > Out
Sept 2021,70,124,15,1267183042,1034909793,2302092835,7,15,3,232273249,Out > In
Sept 2021,70,13,2,276319,546405,822724,2,2,2,270086,In > Out
Sept 2021,70,134,1,50463,372015,422478,1,1,1,321552,In > Out
Sept 2021,70,135,1,130825,3084609,3215434,1,1,1,2953784,In > Out
Sept 2021,70,138,1,10047,176625,186672,1,1,1,166578,In > Out
Sept 2021,70,139,1,14569,146884,161453,1,1,1,132315,In > Out
Sept 2021,70,140,2,542892,7064432,7607324,1,1,2,6521540,In > Out
Sept 2021,70,141,3,1748003,34822671,36570674,2,1,3,33074668,In > Out
Sept 2021,70,148,9,1987321,209498071,211485392,4,4,9,207510750,In > Out
Sept 2021,70,151,2,6011177,2619732,8630909,2,2,2,3391445,Out > In
Sept 2021,70,158,1,3181387,20584370,23765757,1,1,1,17402983,In > Out
Sept 2021,70,165,9,10067947,9754023,19821970,5,7,6,313924,Out > In
Sept 2021,70,166,5,7529887,30906083,38435970,3,2,5,23376196,In > Out
Sept 2021,70,168,1,49488380,51398145,100886525,1,1,1,1909765,In > Out
Sept 2021,70,177,18,10222200,17330461,27552661,3,3,18,7108261,In > Out
Sept 2021,70,181,1,256943681,259288191,516231872,1,1,1,2344510,In > Out
Sept 2021,70,189,13,5526513,63941372,69467885,13,13,13,58414859,In > Out
Sept 2021,70,192,1,7731683,470040,8201723,1,1,1,7261643,Out > In
Sept 2021,70,193,3,228840,26328074,26556914,2,2,3,26099234,In > Out
Sept 2021,70,197,9,14685982412,12185193481,26871175893,5,9,5,2500788931,Out > In
Sept 2021,70,199,1,261168,81856,343024,1,1,1,179312,Out > In
Sept 2021,70,200,2,161830508,282769029,444599537,2,2,2,120938521,In > Out
Sept 2021,70,201,3,97882190,71263322,169145512,2,3,2,26618868,Out > In
Sept 2021,70,204,2,1486165991,1663023207,3149189198,2,2,1,176857216,In > Out
Sept 2021,70,207,1,3193,1926125,1929318,1,1,1,1922932,In > Out
Sept 2021,70,21,1,4414947,4553540,8968487,1,1,1,138593,In > Out
Sept 2021,70,210,4,3734062,58215900,61949962,2,3,4,54481838,In > Out
Sept 2021,70,218,6,112655320,4774205,117429525,2,2,6,107881115,Out > In
Sept 2021,70,223,2,266928,217375,484303,1,2,2,49553,Out > In
Sept 2021,70,23,2,3072755182,2364933264,5437688446,1,2,1,707821918,Out > In
Sept 2021,70,27,3,2748435908,1808303127,4556739035,3,3,3,940132781,Out > In
Sept 2021,70,28,1,57664,303359,361023,1,1,1,245695,In > Out
Sept 2021,70,30,2,40651252,35089168,75740420,2,2,1,5562084,Out > In
Sept 2021,70,35,1,178862937,208534202,387397139,1,1,1,29671265,In > Out
Sept 2021,70,37,3,100020666,246293190,346313856,3,2,3,146272524,In > Out
Sept 2021,70,4,3,124659027,52478488,177137515,2,3,2,72180539,Out > In
Sept 2021,70,43,2,762793526,921858126,1684651652,2,2,1,159064600,In > Out
Sept 2021,70,44,9,426484516,243016176,669500692,7,9,7,183468340,Out > In
Sept 2021,70,47,6,58742051,178957772,237699823,5,2,6,120215721,In > Out
Sept 2021,70,54,4,11930970,10686702,22617672,2,4,4,1244268,Out > In
Sept 2021,70,58,1,217751861,271729146,489481007,1,1,1,53977285,In > Out
Sept 2021,70,59,5,55421309,14747384,70168693,2,2,5,40673925,Out > In
Sept 2021,70,6,1,20632312,28482638,49114950,1,1,1,7850326,In > Out
Sept 2021,70,61,7,133128114,122047512,255175626,6,7,5,11080602,Out > In
Sept 2021,70,62,1,4886583,6222881,11109464,1,1,1,1336298,In > Out
Sept 2021,70,66,9,65133337,212099333,277232670,5,5,9,146965996,In > Out
Sept 2021,70,67,1,9881,139113,148994,1,1,1,129232,In > Out
Sept 2021,70,68,2,1163914,11781968,12945882,2,2,2,10618054,In > Out
Sept 2021,70,7,3,169530265,172048077,341578342,3,3,3,2517812,In > Out
Sept 2021,70,70,1,1482274,3604583,5086857,1,1,1,2122309,In > Out
Sept 2021,70,72,1,134171,170667,304838,1,1,1,36496,In > Out
Sept 2021,70,74,1,1188454,2013070,3201524,1,1,1,824616,In > Out
Sept 2021,70,76,7,3899969546,3151772783,7051742329,2,7,6,748196763,Out > In
Sept 2021,70,83,2,4824102,4253137,9077239,1,2,2,570965,Out > In
Sept 2021,70,85,4,2819499,183180050,185999549,3,2,4,180360551,In > Out
Sept 2021,70,89,79,232704463,840950191,1073654654,4,4,79,608245728,In > Out
Sept 2021,70,91,4,258313384,334375761,592689145,4,4,3,76062377,In > Out
Sept 2021,70,95,1,4205275,87811564,92016839,1,1,1,83606289,In > Out
Sept 2021,70,96,4,29933388,223507816,253441204,3,1,4,193574428,In > Out
Sept 2021,72,101,12,2935668,81549,3017217,3,12,1,2854119,Out > In
Sept 2021,72,124,4,413961,24187,438148,2,4,1,389774,Out > In
Sept 2021,72,125,7,858074,37836,895910,3,7,1,820238,Out > In
Sept 2021,72,129,143,30701826,1137094,31838920,45,143,1,29564732,Out > In
Sept 2021,72,138,14,4147761,151988,4299749,4,14,1,3995773,Out > In
Sept 2021,72,146,1,158095,259637,417732,1,1,1,101542,In > Out
Sept 2021,72,149,7304,17391446636,303725478,17695172114,2237,6355,1,17087721158,Out > In
Sept 2021,72,184,1,95193,16982,112175,1,1,1,78211,Out > In
Sept 2021,72,185,1,82713,20145,102858,1,1,1,62568,Out > In
Sept 2021,72,19,216,45889102,1462296,47351398,59,216,1,44426806,Out > In
Sept 2021,72,191,28,12057696,338226,12395922,14,28,1,11719470,Out > In
Sept 2021,72,20,2,240207,10306,250513,2,2,1,229901,Out > In
Sept 2021,72,22,3,352134,18855,370989,1,3,1,333279,Out > In
Sept 2021,72,24,13,1636841,133073,1769914,12,13,1,1503768,Out > In
Sept 2021,72,248,29156,10390649010,366343759,10756992769,10605,18515,2,10024305251,Out > In
Sept 2021,72,249,3,520915,80095,601010,3,3,2,440820,Out > In
Sept 2021,72,56,14,1513168,71972,1585140,8,14,1,1441196,Out > In
Sept 2021,72,59,1,132462,6053,138515,1,1,1,126409,Out > In
Sept 2021,72,70,2,218503,14593,233096,2,2,1,203910,Out > In
Sept 2021,72,97,12,1298257,57109,1355366,5,12,1,1241148,Out > In
Sept 2021,73,105,5,321469849,1084058256,1405528105,3,2,5,762588407,In > Out
Sept 2021,73,108,1,1087369,97977401,99064770,1,1,1,96890032,In > Out
Sept 2021,73,11,78,59515266,1419020,60934286,1,78,2,58096246,Out > In
Sept 2021,73,117,2,553659,307465,861124,2,2,2,246194,Out > In
Sept 2021,73,120,1,51862296,5164650,57026946,1,1,1,46697646,Out > In
Sept 2021,73,121,3,3012395,8290105,11302500,3,1,3,5277710,In > Out
Sept 2021,73,130,4,847167,44221,891388,1,1,4,802946,Out > In
Sept 2021,73,14,19,2372631,159380,2532011,6,19,1,2213251,Out > In
Sept 2021,73,148,353,1083536710,401763755,1485300465,235,118,2,681772955,Out > In
Sept 2021,73,149,31,23635480,754725,24390205,27,31,2,22880755,Out > In
Sept 2021,73,157,2149,6401595988,2105263625,8506859613,270,1880,2,4296332363,Out > In
Sept 2021,73,166,240,463452121,9603567,473055688,168,240,2,453848554,Out > In
Sept 2021,73,167,8,1388763,557625,1946388,2,8,1,831138,Out > In
Sept 2021,73,169,4,72125554,228023248,300148802,4,1,4,155897694,In > Out
Sept 2021,73,172,3,101810,1684639,1786449,2,1,3,1582829,In > Out
Sept 2021,73,181,15,797334916,94392098,891727014,15,10,15,702942818,Out > In
Sept 2021,73,187,5,605273,24824,630097,5,5,1,580449,Out > In
Sept 2021,73,200,1,140833,5190,146023,1,1,1,135643,Out > In
Sept 2021,73,201,5,595706,24570,620276,5,5,1,571136,Out > In
Sept 2021,73,208,126,314393681,677348892,991742573,61,108,2,362955211,In > Out
Sept 2021,73,215,4,1776764,1661926,3438690,3,1,4,114838,Out > In
Sept 2021,73,22,1,588,529446,530034,1,1,1,528858,In > Out
Sept 2021,73,24,59,19131572,2749832,21881404,23,59,2,16381740,Out > In
Sept 2021,73,3,32,12346024,1397533,13743557,19,8,1,10948491,Out > In
Sept 2021,73,4,1,222496,4522,227018,1,1,1,217974,Out > In
Sept 2021,73,42,5,125389790,471431740,596821530,2,1,5,346041950,In > Out
Sept 2021,73,47,1,103625914,40883358,144509272,1,1,1,62742556,Out > In
Sept 2021,73,56,4,173067211,146261410,319328621,4,3,4,26805801,Out > In
Sept 2021,73,58,3,470595363,317548259,788143622,3,2,3,153047104,Out > In
Sept 2021,73,70,2,71614888,80301310,151916198,2,1,2,8686422,In > Out
Sept 2021,73,71,2,605106,660596,1265702,1,2,1,55490,In > Out
Sept 2021,73,72,2,114512980,75876544,190389524,1,2,2,38636436,Out > In
Sept 2021,73,78,2,258688,18626,277314,1,1,2,240062,Out > In
Sept 2021,73,79,7,223791162,494896232,718687394,7,4,7,271105070,In > Out
Sept 2021,73,8,44,33382135,456706,33838841,26,44,1,32925429,Out > In
Sept 2021,73,80,5,206941041,333136073,540077114,3,2,5,126195032,In > Out
Sept 2021,73,9,35,12948771,1450438,14399209,21,7,2,11498333,Out > In
Sept 2021,73,90,1,439408,41524,480932,1,1,1,397884,Out > In
Sept 2021,73,91,1,2469493,84756208,87225701,1,1,1,82286715,In > Out
Sept 2021,73,99,1,2451005,123793,2574798,1,1,1,2327212,Out > In
Sept 2021,74,10,3,12811620,276507663,289319283,2,1,3,263696043,In > Out
Sept 2021,74,115,2,3313310,7025257,10338567,2,2,2,3711947,In > Out
Sept 2021,74,116,1,55160,60755,115915,1,1,1,5595,In > Out
Sept 2021,74,12,1,3182,156241,159423,1,1,1,153059,In > Out
Sept 2021,74,154,339,917615906,372041519,1289657425,232,114,1,545574387,Out > In
Sept 2021,74,178,137,140440592,44017242,184457834,79,102,1,96423350,Out > In
Sept 2021,74,185,3,592727,16004,608731,1,3,1,576723,Out > In
Sept 2021,74,202,2,289544294,481117244,770661538,2,2,2,191572950,In > Out
Sept 2021,74,204,1,71947,235330,307277,1,1,1,163383,In > Out
Sept 2021,74,21,3,13747510,33882170,47629680,3,1,3,20134660,In > Out
Sept 2021,74,225,1,1351665,2290253,3641918,1,1,1,938588,In > Out
Sept 2021,74,229,33,59185997,913619719,972805716,30,29,33,854433722,In > Out
Sept 2021,74,234,73,12945660,5738838,18684498,41,62,1,7206822,Out > In
Sept 2021,74,250,8,37835442,348079689,385915131,5,3,8,310244247,In > Out
Sept 2021,74,4,4,13202673,339076157,352278830,4,1,4,325873484,In > Out
Sept 2021,74,45,905,2291974312,682156295,2974130607,355,661,2,1609818017,Out > In
Sept 2021,74,58,1,1262388,101453817,102716205,1,1,1,100191429,In > Out
Sept 2021,74,65,3,711982612,638712826,1350695438,3,3,3,73269786,Out > In
Sept 2021,74,91,2,3252916,160031977,163284893,1,1,2,156779061,In > Out
Sept 2021,75,37,3,333096,25477,358573,3,3,1,307619,Out > In
Sept 2021,77,120,27,65647501,2094261,67741762,14,19,2,63553240,Out > In
Sept 2021,77,122,2467,361500232,311286626,672786858,4,23,1,50213606,Out > In
Sept 2021,77,231,6,50132444,60748630,110881074,6,6,6,10616186,In > Out
Sept 2021,79,10,5,5232250,668147,5900397,1,5,1,4564103,Out > In
Sept 2021,79,11,2,59647904,16660744498,16720392402,2,2,2,16601096594,In > Out
Sept 2021,79,12,40,30992354913,2945202354,33937557267,7,40,1,28047152559,Out > In
Sept 2021,79,13,4,2571802,117890,2689692,1,4,1,2453912,Out > In
Sept 2021,79,16,32,1471876,23439510,24911386,9,31,32,21967634,In > Out
Sept 2021,79,22,1,216401,134125,350526,1,1,1,82276,Out > In
Sept 2021,79,30,40,21079185024,837308672,21916493696,7,40,1,20241876352,Out > In
Sept 2021,79,8,15,16141040,1414228,17555268,6,14,2,14726812,Out > In
Sept 2021,79,9,182,62979258175,898940191,63878198366,113,178,2,62080317984,Out > In
Sept 2021,80,108,1,1077361,1262960,2340321,1,1,1,185599,In > Out
Sept 2021,80,9,24,2409931305,77579916,2487511221,1,24,24,2332351389,Out > In
Sept 2021,81,140,80167,76159601360,13756592730,89916194090,2834,18834,1,62403008630,Out > In
Sept 2021,81,143,201,7792510511,14199041817,21991552328,79,51,121,6406531306,In > Out
Sept 2021,81,47,2,984980,503784,1488764,1,2,1,481196,Out > In
Sept 2021,82,10,5,2335791,352984709,355320500,4,3,5,350648918,In > Out
Sept 2021,82,142,2,1047397,11103885,12151282,1,1,2,10056488,In > Out
Sept 2021,82,146,13,45918364,8817402,54735766,5,13,13,37100962,Out > In
Sept 2021,82,150,7,26537935,172340643,198878578,5,5,7,145802708,In > Out
Sept 2021,82,239,337,859026402,367546184,1226572586,229,113,1,491480218,Out > In
Sept 2021,82,44,1,175716,166220,341936,1,1,1,9496,Out > In
Sept 2021,82,81,1,1145602,1183072,2328674,1,1,1,37470,In > Out
Sept 2021,82,92,1,3518344,272751003,276269347,1,1,1,269232659,In > Out
Sept 2021,83,158,1,40180,73515,113695,1,1,1,33335,In > Out
Sept 2021,83,167,2,1774311,1616577,3390888,2,2,2,157734,Out > In
Sept 2021,83,226,2,263857421,176298134,440155555,1,1,2,87559287,Out > In
Sept 2021,83,35,2,3925301,6468084,10393385,2,2,2,2542783,In > Out
Sept 2021,83,39,68,291439383,535582602,827021985,5,24,64,244143219,In > Out
Sept 2021,84,36,43,15194105,678927,15873032,30,43,2,14515178,Out > In
Sept 2021,84,38,1,6807735,39447782,46255517,1,1,1,32640047,In > Out
Sept 2021,85,101,3,142498060,412293877,554791937,2,1,3,269795817,In > Out
Sept 2021,85,103,1,48104128,271431634,319535762,1,1,1,223327506,In > Out
Sept 2021,85,107,2,14343306,38702721,53046027,1,1,2,24359415,In > Out
Sept 2021,85,112,1,1039337,24069,1063406,1,1,1,1015268,Out > In
Sept 2021,85,114,1,121936,5507,127443,1,1,1,116429,Out > In
Sept 2021,85,115,3,289403480,294635933,584039413,3,2,3,5232453,In > Out
Sept 2021,85,120,2,12725620,10785901,23511521,2,2,2,1939719,Out > In
Sept 2021,85,121,3,81394492,141179335,222573827,3,3,3,59784843,In > Out
Sept 2021,85,122,1,74338,70946,145284,1,1,1,3392,Out > In
Sept 2021,85,126,30,1125347587,1794585371,2919932958,22,3,30,669237784,In > Out
Sept 2021,85,129,2,172926946,873982603,1046909549,2,2,2,701055657,In > Out
Sept 2021,85,132,5,193392037,398752743,592144780,3,3,5,205360706,In > Out
Sept 2021,85,134,1,2775294,2309423,5084717,1,1,1,465871,Out > In
Sept 2021,85,138,4,1160950123,1098200559,2259150682,2,3,4,62749564,Out > In
Sept 2021,85,141,1,156,214226,214382,1,1,1,214070,In > Out
Sept 2021,85,142,1,101596530,31626047,133222577,1,1,1,69970483,Out > In
Sept 2021,85,143,6,267289106,878960844,1146249950,3,5,6,611671738,In > Out
Sept 2021,85,144,5,252429780,185126915,437556695,4,3,4,67302865,Out > In
Sept 2021,85,149,2,350675536,108988184,459663720,2,2,2,241687352,Out > In
Sept 2021,85,150,1,140290557,310899684,451190241,1,1,1,170609127,In > Out
Sept 2021,85,16,134,12430003296,6311375351,18741378647,42,11,1,6118627945,Out > In
Sept 2021,85,55,1,9176604,640431,9817035,1,1,1,8536173,Out > In
Sept 2021,86,175,65,38493023,694744,39187767,45,65,1,37798279,Out > In
Sept 2021,86,66,13,3992936,63640,4056576,7,13,1,3929296,Out > In
Sept 2021,89,141,1,195424801,891914643,1087339444,1,1,1,696489842,In > Out
Sept 2021,89,51,2,262552,139617542,139880094,1,1,2,139354990,In > Out
Sept 2021,89,64,2,3829318,63571378,67400696,2,2,2,59742060,In > Out
Sept 2021,89,66,2,228281374,1688120445,1916401819,2,2,2,1459839071,In > Out
Sept 2021,89,73,1,13307876,328991,13636867,1,1,1,12978885,Out > In
Sept 2021,89,80,4,74981410,134021522,209002932,3,1,4,59040112,In > Out
Sept 2021,89,82,1,567285,4840720,5408005,1,1,1,4273435,In > Out
Sept 2021,9,2,2,256027,435818,691845,2,2,1,179791,In > Out
Sept 2021,90,149,1,57171599,226406404,283578003,1,1,1,169234805,In > Out
Sept 2021,90,158,3,373395,265650,639045,2,2,3,107745,Out > In
Sept 2021,90,159,2,6346574,27479374,33825948,2,1,2,21132800,In > Out
Sept 2021,90,165,6,171912933,620363684,792276617,4,4,6,448450751,In > Out
Sept 2021,90,167,1,715613,781363,1496976,1,1,1,65750,In > Out
Sept 2021,90,220,7,1141611,26506,1168117,6,7,1,1115105,Out > In
Sept 2021,90,253,3,157186,186121,343307,3,1,3,28935,In > Out
Sept 2021,90,27,4,6588924,1298459030,1305047954,3,1,4,1291870106,In > Out
Sept 2021,90,39,2,831099,51329715,52160814,1,1,2,50498616,In > Out
Sept 2021,90,52,1,8428041,49248542,57676583,1,1,1,40820501,In > Out
Sept 2021,90,54,1,58502102,1141516,59643618,1,1,1,57360586,Out > In
Sept 2021,90,72,2,515180316,1620472288,2135652604,2,1,2,1105291972,In > Out
Sept 2021,90,87,4,2589723,100864896,103454619,2,1,4,98275173,In > Out
Sept 2021,91,117,12,4261951,20505782,24767733,1,1,12,16243831,In > Out
Sept 2021,91,139,1,38924941,107730108,146655049,1,1,1,68805167,In > Out
Sept 2021,91,148,1,3647465,50413412,54060877,1,1,1,46765947,In > Out
Sept 2021,91,151,29,4408949831,276967962,4685917793,3,27,28,4131981869,Out > In
Sept 2021,91,156,17,9216843,205059560,214276403,17,17,2,195842717,In > Out
Sept 2021,91,184,11,145021789,208523953,353545742,6,8,9,63502164,In > Out
Sept 2021,92,228,7,885236,922347,1807583,6,4,1,37111,In > Out
Sept 2021,94,22,762,3016860973,649058076,3665919049,419,291,46,2367802897,Out > In
Sept 2021,94,51,45,35789628,951080,36740708,1,45,45,34838548,Out > In
Sept 2021,96,1,694,547372805,15852851,563225656,302,683,2,531519954,Out > In
Sept 2021,96,10,133,93063184,8364105,101427289,18,133,1,84699079,Out > In
Sept 2021,96,100,784,4648704797,64356208,4713061005,3,784,1,4584348589,Out > In
Sept 2021,96,119,5,1255003,50606,1305609,3,5,1,1204397,Out > In
Sept 2021,96,125,2425971,1740344619327,106662985801,1847007605128,250093,64691,2,1633681633526,Out > In
Sept 2021,96,142,1,126592,6620,133212,1,1,1,119972,Out > In
Sept 2021,96,148,25,7711863,363798,8075661,8,24,1,7348065,Out > In
Sept 2021,96,149,535,209733764,40618391,250352155,326,529,1,169115373,Out > In
Sept 2021,96,152,68,10636040,636570,11272610,38,68,1,9999470,Out > In
Sept 2021,96,156,3,254421,65030,319451,1,3,1,189391,Out > In
Sept 2021,96,163,1,139776,5172,144948,1,1,1,134604,Out > In
Sept 2021,96,17,3,258534,65563,324097,1,3,1,192971,Out > In
Sept 2021,96,179,17213,40022833902,740293025,40763126927,5926,13204,1,39282540877,Out > In
Sept 2021,96,180,6,639322,27743,667065,2,6,1,611579,Out > In
Sept 2021,96,182,1199,400769330,258682464,659451794,160,1167,1,142086866,Out > In
Sept 2021,96,183,569590,221719980984,10450640032,232170621016,84360,59734,2,211269340952,Out > In
Sept 2021,96,190,878,12932089882,1604340156,14536430038,120,853,1,11327749726,Out > In
Sept 2021,96,192,27336,10102497673,7730964856,17833462529,114,15428,1,2371532817,Out > In
Sept 2021,96,193,2336,95310639885,12077951221,107388591106,382,2201,2,83232688664,Out > In
Sept 2021,96,195,32,111852025,10250059,122102084,9,32,1,101601966,Out > In
Sept 2021,96,204,1265,252489692,20314730,272804422,769,1241,1,232174962,Out > In
Sept 2021,96,23,20,8668094,2507436,11175530,2,20,1,6160658,Out > In
Sept 2021,96,24,18,17235478,229666,17465144,8,18,2,17005812,Out > In
Sept 2021,96,25,15695,2764413889,110716658,2875130547,5581,13210,2,2653697231,Out > In
Sept 2021,96,26,2053,1650225551,27792608,1678018159,541,1998,2,1622432943,Out > In
Sept 2021,96,29,6,7101138,119825,7220963,3,6,1,6981313,Out > In
Sept 2021,96,30,550,270272070,54344341,324616411,58,540,1,215927729,Out > In
Sept 2021,96,31,1575,158636976,127010540,285647516,1024,1521,1,31626436,Out > In
Sept 2021,96,33,160,32480707,5944181,38424888,12,160,1,26536526,Out > In
Sept 2021,96,34,4,430352,75708,506060,2,4,1,354644,Out > In
Sept 2021,96,39,1779,591643138,91722860,683365998,414,1698,1,499920278,Out > In
Sept 2021,96,41,1111,437277004,9781606,447058610,314,1088,1,427495398,Out > In
Sept 2021,96,46,70,40189807,2512863,42702670,21,70,1,37676944,Out > In
Sept 2021,96,51,123998,24002664598,2346887322,26349551920,31903,33453,2,21655777276,Out > In
Sept 2021,96,58,63,25690872,7273330,32964202,8,63,1,18417542,Out > In
Sept 2021,96,60,61,584745125,150763145,735508270,19,61,2,433981980,Out > In
Sept 2021,96,62,234,69163739,5266456,74430195,72,231,1,63897283,Out > In
Sept 2021,96,78,408,1227522696,32315149,1259837845,41,405,2,1195207547,Out > In
Sept 2021,96,81,8316,3899399779,1233487880,5132887659,1150,6393,1,2665911899,Out > In
Sept 2021,96,82,3,263147,66435,329582,1,3,1,196712,Out > In
Sept 2021,96,85,1865,473200115,323785440,796985555,151,1745,2,149414675,Out > In
Sept 2021,96,86,87,20660226,3171473,23831699,24,87,2,17488753,Out > In
Sept 2021,96,88,815,606031465,16253517,622284982,288,802,2,589777948,Out > In
Sept 2021,96,90,3,763819,12780,776599,3,3,1,751039,Out > In
Sept 2021,96,93,23,4400137,645517,5045654,19,23,1,3754620,Out > In
Sept 2021,96,94,43,43065974,29160765,72226739,6,43,1,13905209,Out > In
Sept 2021,96,95,27712,8084072683,774210833,8858283516,770,14152,1,7309861850,Out > In
Sept 2021,96,96,40246,16749397341,729100612,17478497953,3754,17929,1,16020296729,Out > In
Sept 2021,98,10,1,551136,1868276,2419412,1,1,1,1317140,In > Out
Sept 2021,98,108,1,32481541,40649563,73131104,1,1,1,8168022,In > Out
Sept 2021,98,11,10,6850493,38209896,45060389,4,3,10,31359403,In > Out
Sept 2021,98,111,3,483589061,497890732,981479793,3,3,2,14301671,In > Out
Sept 2021,98,113,1,38219761,35417597,73637358,1,1,1,2802164,Out > In
Sept 2021,98,12,3,903221,85378328,86281549,2,3,3,84475107,In > Out
Sept 2021,98,120,12,282950102,126341220,409291322,3,10,6,156608882,Out > In
Sept 2021,98,122,2,4492478,4853074,9345552,2,2,2,360596,In > Out
Sept 2021,98,125,1,28936305,27305170,56241475,1,1,1,1631135,Out > In
Sept 2021,98,126,6,1847934298,1340777290,3188711588,4,2,1,507157008,Out > In
Sept 2021,98,133,9,57410827,274020526,331431353,5,5,9,216609699,In > Out
Sept 2021,98,134,21,66164145,210427674,276591819,8,10,19,144263529,In > Out
Sept 2021,98,135,1,1190016,685043,1875059,1,1,1,504973,Out > In
Sept 2021,98,138,1,9057929,10815598,19873527,1,1,1,1757669,In > Out
Sept 2021,98,139,3,11085364,34396400,45481764,3,3,2,23311036,In > Out
Sept 2021,98,14,4,96632595,424809089,521441684,3,1,4,328176494,In > Out
Sept 2021,98,140,2,130920,424958,555878,2,2,2,294038,In > Out
Sept 2021,98,142,3,480363696,634032663,1114396359,3,3,3,153668967,In > Out
Sept 2021,98,145,8,51196,21922651,21973847,1,1,8,21871455,In > Out
Sept 2021,98,146,17,871011379,2275175240,3146186619,2,4,4,1404163861,In > Out
Sept 2021,98,148,1,48543955,55905292,104449247,1,1,1,7361337,In > Out
Sept 2021,98,149,4,3890235067,4288703477,8178938544,2,4,3,398468410,In > Out
Sept 2021,98,15,4,51614816,132940342,184555158,4,4,3,81325526,In > Out
Sept 2021,98,150,1,1167739127,1611331894,2779071021,1,1,1,443592767,In > Out
Sept 2021,98,152,2,468650883,435647513,904298396,1,2,2,33003370,Out > In
Sept 2021,98,153,2,515268,3297050,3812318,1,1,2,2781782,In > Out
Sept 2021,98,154,1,2195152,2534800,4729952,1,1,1,339648,In > Out
Sept 2021,98,156,2,174430,247352,421782,2,2,1,72922,In > Out
Sept 2021,98,157,4,106791698,52021534,158813232,3,4,4,54770164,Out > In
Sept 2021,98,164,1,146467130,128221336,274688466,1,1,1,18245794,Out > In
Sept 2021,98,168,2,12669152,198017135,210686287,2,1,2,185347983,In > Out
Sept 2021,98,17,3,2815840,7901944,10717784,2,3,2,5086104,In > Out
Sept 2021,98,170,1,3167369,8206993,11374362,1,1,1,5039624,In > Out
Sept 2021,98,171,5,2484721,6208320,8693041,2,2,5,3723599,In > Out
Sept 2021,98,172,1,25869,324938,350807,1,1,1,299069,In > Out
Sept 2021,98,173,1,2503424,29120786,31624210,1,1,1,26617362,In > Out
Sept 2021,98,18,2,30081856,28276761,58358617,2,2,2,1805095,Out > In
Sept 2021,98,181,1,8839,630880,639719,1,1,1,622041,In > Out
Sept 2021,98,182,3,58870984,86946870,145817854,3,3,3,28075886,In > Out
Sept 2021,98,184,1,1479553,3649967,5129520,1,1,1,2170414,In > Out
Sept 2021,98,185,3,112442611,66046795,178489406,2,2,3,46395816,Out > In
Sept 2021,98,186,1,359950323,347801798,707752121,1,1,1,12148525,Out > In
Sept 2021,98,199,4,126204135,150274479,276478614,4,3,3,24070344,In > Out
Sept 2021,98,20,1,13275504,5065548,18341052,1,1,1,8209956,Out > In
Sept 2021,98,200,1,339941,160222,500163,1,1,1,179719,Out > In
Sept 2021,98,203,2,1311906,1805102,3117008,1,2,1,493196,In > Out
Sept 2021,98,204,1,3446824,132191444,135638268,1,1,1,128744620,In > Out
Sept 2021,98,206,6,239693363,206374042,446067405,3,6,3,33319321,Out > In
Sept 2021,98,210,11,175843983,156169221,332013204,4,11,3,19674762,Out > In
Sept 2021,98,211,2,300793,678728,979521,1,2,2,377935,In > Out
Sept 2021,98,216,1,2099620,1912637,4012257,1,1,1,186983,Out > In
Sept 2021,98,219,1,11182178,13660059,24842237,1,1,1,2477881,In > Out
Sept 2021,98,22,2,1074558758,1149453605,2224012363,2,2,1,74894847,In > Out
Sept 2021,98,222,1,100584711,176210538,276795249,1,1,1,75625827,In > Out
Sept 2021,98,223,1,701177,679456,1380633,1,1,1,21721,Out > In
Sept 2021,98,23,3,790983924,84586753,875570677,3,3,3,706397171,Out > In
Sept 2021,98,27,3,506976072,445019596,951995668,3,3,1,61956476,Out > In
Sept 2021,98,28,7,73464612,957532029,1030996641,5,3,7,884067417,In > Out
Sept 2021,98,29,12,3619725625,1987589849,5607315474,11,9,12,1632135776,Out > In
Sept 2021,98,34,1,87061754,147726592,234788346,1,1,1,60664838,In > Out
Sept 2021,98,37,1,67706,62964,130670,1,1,1,4742,Out > In
Sept 2021,98,4,2,200672423,495423407,696095830,1,1,2,294750984,In > Out
Sept 2021,98,40,8,85515763,137770286,223286049,3,8,8,52254523,In > Out
Sept 2021,98,44,2,2909830510,3687705326,6597535836,2,2,1,777874816,In > Out
Sept 2021,98,49,3,295105803,293388729,588494532,1,3,3,1717074,Out > In
Sept 2021,98,54,1,398548,1375454,1774002,1,1,1,976906,In > Out
Sept 2021,98,56,4,322674198,331769344,654443542,4,3,3,9095146,In > Out
Sept 2021,98,59,1,327597,1132191,1459788,1,1,1,804594,In > Out
Sept 2021,98,61,20,200658554,511218830,711877384,5,3,18,310560276,In > Out
Sept 2021,98,62,28,2602802749,3806573869,6409376618,9,7,28,1203771120,In > Out
Sept 2021,98,65,5,4438533,45053431,49491964,2,1,5,40614898,In > Out
Sept 2021,98,66,1,1216572,1343935,2560507,1,1,1,127363,In > Out
Sept 2021,98,70,1,29230308,48210885,77441193,1,1,1,18980577,In > Out
Sept 2021,98,72,8,298865900,303486295,602352195,3,3,8,4620395,In > Out
Sept 2021,98,73,1,14155,1511029,1525184,1,1,1,1496874,In > Out
Sept 2021,98,79,11,66655216,90405575,157060791,6,8,11,23750359,In > Out
Sept 2021,98,80,2,35194868,39662018,74856886,2,2,2,4467150,In > Out
Sept 2021,98,81,4,2022355,476497354,478519709,2,2,4,474474999,In > Out
Sept 2021,98,82,9,334646577,435803852,770450429,3,7,7,101157275,In > Out
Sept 2021,98,83,2,490746,396779,887525,2,1,2,93967,Out > In
Sept 2021,98,86,2,82068523,85570466,167638989,2,2,2,3501943,In > Out
Sept 2021,98,87,3,523566671,1202944934,1726511605,2,3,1,679378263,In > Out
Sept 2021,98,93,1,1728235,2596348,4324583,1,1,1,868113,In > Out
Sept 2021,98,94,2,455745864,931274533,1387020397,2,2,1,475528669,In > Out
Sept 2021,98,96,4,1123469,33048519,34171988,3,3,3,31925050,In > Out
Sept 2021,98,97,4,11699027,94552653,106251680,2,1,4,82853626,In > Out
Sept 2021,98,98,1,11960,651145,663105,1,1,1,639185,In > Out
Sept 2021,99,136,3,7056589,735240608,742297197,3,1,3,728184019,In > Out
Sept 2021,99,180,3,753684877,723859182,1477544059,2,3,3,29825695,Out > In
Sept 2021,99,183,3,67977148,2577639,70554787,2,3,2,65399509,Out > In
