Week,SourceSubnet,SourceIP,Connections,Outbound,Inbound,TotalBytes,TargetIPs,SourcePorts,TargetPorts,Difference,Color
Feb 2020,0,40,1161,79167194,1685577311,1764744505,262,1140,3,1606410117,In > Out
Feb 2020,10,200,4,267026,57285612,57552638,1,4,1,57018586,In > Out
Feb 2020,10,4,7,79105,3793183,3872288,3,7,2,3714078,In > Out
Feb 2020,100,109,1245,208954185,423009622,631963807,158,1204,2,214055437,In > Out
Feb 2020,100,114,379,91812973,371546159,463359132,122,375,2,279733186,In > Out
Feb 2020,100,132,5914,776157202,1030367780,1806524982,209,4937,53,254210578,In > Out
Feb 2020,100,139,160,7889884,188246508,196136392,84,159,2,180356624,In > Out
Feb 2020,100,142,30,748886,13855152,14604038,11,30,2,13106266,In > Out
Feb 2020,100,148,365,293817598,287637411,581455009,125,363,4,6180187,Out > In
Feb 2020,100,151,9,637788,36590393,37228181,2,9,1,35952605,In > Out
Feb 2020,100,180,4,15642,732194,747836,1,4,1,716552,In > Out
Feb 2020,100,181,642,120513255,743518731,864031986,182,632,3,623005476,In > Out
Feb 2020,100,192,645,152906820,1474150321,1627057141,240,639,4,1321243501,In > Out
Feb 2020,100,200,384,19504293,956253613,975757906,177,379,2,936749320,In > Out
Feb 2020,100,228,6,23722,935682,959404,1,6,1,911960,In > Out
Feb 2020,100,229,11,355657,10080518,10436175,5,11,2,9724861,In > Out
Feb 2020,100,239,756,77787154,250288568,328075722,147,741,3,172501414,In > Out
Feb 2020,100,32,14,378343,3629145,4007488,8,14,2,3250802,In > Out
Feb 2020,100,33,134,7874959,108974733,116849692,68,134,2,101099774,In > Out
Feb 2020,100,37,158,9301688,93491677,102793365,30,158,3,84189989,In > Out
Feb 2020,100,43,24,672195,21708886,22381081,11,24,2,21036691,In > Out
Feb 2020,100,5,190,5617016,327466044,333083060,56,189,2,321849028,In > Out
Feb 2020,101,104,1684,318762056,1602097306,1920859362,417,1589,5,1283335250,In > Out
Feb 2020,101,105,190,11515605,402452239,413967844,44,190,3,390936634,In > Out
Feb 2020,101,106,347,53339981,120075881,173415862,43,342,2,66735900,In > Out
Feb 2020,101,108,2324,46429554789,1304429196,47733983985,138,2189,2,45125125593,Out > In
Feb 2020,101,109,115,3336242,120262274,123598516,54,115,2,116926032,In > Out
Feb 2020,101,111,400,20396408,809340057,829736465,31,400,2,788943649,In > Out
Feb 2020,101,112,657,110183372,267656132,377839504,147,644,2,157472760,In > Out
Feb 2020,101,123,102,7705910,47991443,55697353,47,101,2,40285533,In > Out
Feb 2020,101,126,626,101575834,707032772,808608606,139,619,2,605456938,In > Out
Feb 2020,101,129,2,29925,594884,624809,2,2,1,564959,In > Out
Feb 2020,101,135,433,25345014,857222155,882567169,138,427,2,831877141,In > Out
Feb 2020,101,139,2,238995,40758218,40997213,2,2,2,40519223,In > Out
Feb 2020,101,156,154,1913623,57509889,59423512,60,153,3,55596266,In > Out
Feb 2020,101,158,22,364815,82469745,82834560,10,22,2,82104930,In > Out
Feb 2020,101,160,2364,552480151,2799260171,3351740322,373,2106,79,2246780020,In > Out
Feb 2020,101,163,402,35273143,232550842,267823985,84,400,2,197277699,In > Out
Feb 2020,101,171,514,52317366,522643704,574961070,138,510,2,470326338,In > Out
Feb 2020,101,175,8,1710228,72306774,74017002,3,8,2,70596546,In > Out
Feb 2020,101,176,281,334169377,386426605,720595982,139,276,6,52257228,In > Out
Feb 2020,101,180,590,170622310,9468214112,9638836422,225,580,2,9297591802,In > Out
Feb 2020,101,181,37,18988574,1357177,20345751,24,37,2,17631397,Out > In
Feb 2020,101,183,270,13521373,1803420101,1816941474,72,267,2,1789898728,In > Out
Feb 2020,101,184,63,1564152,21595231,23159383,36,63,2,20031079,In > Out
Feb 2020,101,186,1174,146831356,2164648770,2311480126,244,1143,3,2017817414,In > Out
Feb 2020,101,195,3,42783,775650,818433,2,3,1,732867,In > Out
Feb 2020,101,199,74,3457371,299193458,302650829,14,73,2,295736087,In > Out
Feb 2020,101,200,180,3592866,73371289,76964155,50,180,4,69778423,In > Out
Feb 2020,101,201,673,100059106,239857021,339916127,108,662,3,139797915,In > Out
Feb 2020,101,203,381,4421320,106090259,110511579,93,381,2,101668939,In > Out
Feb 2020,101,204,2387,312315797,4039170708,4351486505,639,2218,5,3726854911,In > Out
Feb 2020,101,207,745,104685586,514891496,619577082,170,737,4,410205910,In > Out
Feb 2020,101,209,202,14865646,273802289,288667935,33,201,1,258936643,In > Out
Feb 2020,101,211,570,76259916,2984977256,3061237172,117,569,2,2908717340,In > Out
Feb 2020,101,215,5,504800,403008,907808,1,1,1,101792,Out > In
Feb 2020,101,217,68,11599539,245833121,257432660,28,68,4,234233582,In > Out
Feb 2020,101,218,544,240205853,547641964,787847817,160,544,5,307436111,In > Out
Feb 2020,101,224,490,33960362,443432641,477393003,138,485,2,409472279,In > Out
Feb 2020,101,225,27,4204335,30811313,35015648,18,27,1,26606978,In > Out
Feb 2020,101,231,144,13283897,33258322,46542219,34,144,3,19974425,In > Out
Feb 2020,101,34,20,449689,26299815,26749504,10,20,2,25850126,In > Out
Feb 2020,101,36,470,31051801,2498512171,2529563972,133,458,2,2467460370,In > Out
Feb 2020,101,40,109,4492773,327409481,331902254,42,109,2,322916708,In > Out
Feb 2020,101,41,31,1034278,8039908,9074186,11,31,2,7005630,In > Out
Feb 2020,101,43,532,739091311,330828784,1069920095,125,525,2,408262527,Out > In
Feb 2020,101,44,1030,116997818,4100438769,4217436587,260,999,2,3983440951,In > Out
Feb 2020,101,49,7,471422,71539281,72010703,5,7,2,71067859,In > Out
Feb 2020,101,69,3,17279,4479916,4497195,1,3,1,4462637,In > Out
Feb 2020,101,89,626,42894887,3402668403,3445563290,168,617,2,3359773516,In > Out
Feb 2020,101,91,902,43035922,1414430326,1457466248,251,878,6,1371394404,In > Out
Feb 2020,101,93,19,2051346,44726798,46778144,11,19,2,42675452,In > Out
Feb 2020,101,94,938,117348951,2789097828,2906446779,292,913,3,2671748877,In > Out
Feb 2020,101,98,657,62695904,143694318,206390222,39,657,2,80998414,In > Out
Feb 2020,102,102,76,72815335,37386798,110202133,12,66,12,35428537,Out > In
Feb 2020,102,58,2,13566,789392,802958,2,2,1,775826,In > Out
Feb 2020,102,84,3,127452,240164,367616,3,3,2,112712,In > Out
Feb 2020,103,223,841,197268815,798294441,995563256,236,834,2,601025626,In > Out
Feb 2020,103,226,1161,81607417,1774693414,1856300831,317,1139,3,1693085997,In > Out
Feb 2020,103,230,38,1531385,59439773,60971158,11,38,2,57908388,In > Out
Feb 2020,103,231,22,8537490,3063027,11600517,18,1,19,5474463,Out > In
Feb 2020,103,234,94,4629153,161719397,166348550,18,94,2,157090244,In > Out
Feb 2020,103,235,242,13052719,337280581,350333300,104,240,3,324227862,In > Out
Feb 2020,103,237,821,24317041704,6690210303,31007252007,261,804,12,17626831401,Out > In
Feb 2020,103,239,68,12104678,784208432,796313110,25,68,2,772103754,In > Out
Feb 2020,103,240,1279,175719575,1896147805,2071867380,91,1256,3,1720428230,In > Out
Feb 2020,103,246,661,87670466,8804651537,8892322003,184,657,2,8716981071,In > Out
Feb 2020,104,103,773,167899943,382241648,550141591,157,754,2,214341705,In > Out
Feb 2020,104,105,17,108042523,1086663058,1194705581,13,17,1,978620535,In > Out
Feb 2020,104,108,1942,411710749,5958283458,6369994207,373,1870,4,5546572709,In > Out
Feb 2020,104,110,1,94584,14080,108664,1,1,1,80504,Out > In
Feb 2020,104,111,1148,2353531017,2063298538,4416829555,332,1121,4,290232479,Out > In
Feb 2020,104,122,505,136595977,458730999,595326976,172,496,2,322135022,In > Out
Feb 2020,104,124,353,1200911139,589383911,1790295050,151,353,2,611527228,Out > In
Feb 2020,104,127,500,338242798,254125493,592368291,90,484,5,84117305,Out > In
Feb 2020,104,136,142,5388818,181302047,186690865,61,141,2,175913229,In > Out
Feb 2020,104,139,2,131400,105536,236936,1,1,1,25864,Out > In
Feb 2020,104,145,10,320405,8963349,9283754,9,10,2,8642944,In > Out
Feb 2020,104,150,1049,100362877,2130337252,2230700129,331,1031,5,2029974375,In > Out
Feb 2020,104,152,109,19968437,98530334,118498771,40,109,4,78561897,In > Out
Feb 2020,104,159,451,18973687,948529305,967502992,156,439,2,929555618,In > Out
Feb 2020,104,161,1686,285380344,15791019929,16076400273,363,1635,3,15505639585,In > Out
Feb 2020,104,163,431,65136743,850102993,915239736,134,426,2,784966250,In > Out
Feb 2020,104,164,219,17735396,146033127,163768523,89,219,2,128297731,In > Out
Feb 2020,104,167,2091,76202581887,1701234010,77903815897,328,1973,2,74501347877,Out > In
Feb 2020,104,170,18,202999,7648679,7851678,5,18,1,7445680,In > Out
Feb 2020,104,171,406,36191719,1112146122,1148337841,90,404,3,1075954403,In > Out
Feb 2020,104,188,210,18141012,199549549,217690561,68,210,2,181408537,In > Out
Feb 2020,104,189,368,28358847,526293215,554652062,162,362,2,497934368,In > Out
Feb 2020,104,193,22,695289,32068396,32763685,10,22,2,31373107,In > Out
Feb 2020,104,204,8,168651,2111902,2280553,4,8,2,1943251,In > Out
Feb 2020,104,210,371,26007098,942971126,968978224,117,370,3,916964028,In > Out
Feb 2020,104,211,812,66428573,408809140,475237713,189,797,4,342380567,In > Out
Feb 2020,104,224,929,21223128,697585250,718808378,123,913,3,676362122,In > Out
Feb 2020,104,227,388,27283408,169915956,197199364,99,383,2,142632548,In > Out
Feb 2020,104,231,162,3229139,252347837,255576976,26,162,2,249118698,In > Out
Feb 2020,104,232,246,5119486,173985700,179105186,78,244,2,168866214,In > Out
Feb 2020,104,233,253,11515639,168447310,179962949,70,248,2,156931671,In > Out
Feb 2020,104,238,1167,184234571,2994558149,3178792720,303,1019,2,2810323578,In > Out
Feb 2020,104,246,136,6076974,75771040,81848014,64,136,2,69694066,In > Out
Feb 2020,104,49,675,53683505,1332175885,1385859390,209,662,2,1278492380,In > Out
Feb 2020,104,55,1,99487,14464,113951,1,1,1,85023,Out > In
Feb 2020,104,59,1385,201537106,896445385,1097982491,210,1331,3,694908279,In > Out
Feb 2020,104,61,187,58434103,143900726,202334829,55,186,2,85466623,In > Out
Feb 2020,104,69,296,17043857,138448139,155491996,79,294,2,121404282,In > Out
Feb 2020,104,71,3,303530,4288560,4592090,3,3,2,3985030,In > Out
Feb 2020,104,81,164,10776715,25020090,35796805,60,164,3,14243375,In > Out
Feb 2020,104,85,134,22430272,112821420,135251692,63,133,4,90391148,In > Out
Feb 2020,104,96,112,37373419,77055155,114428574,50,112,2,39681736,In > Out
Feb 2020,106,64,1023,210098516,8036419832,8246518348,219,999,2,7826321316,In > Out
Feb 2020,109,110,5,6190,13005190,13011380,1,1,1,12999000,In > Out
Feb 2020,109,188,3,868212,1339464,2207676,1,3,3,471252,In > Out
Feb 2020,11,65,3,253292,6758443,7011735,3,3,1,6505151,In > Out
Feb 2020,11,68,13,232374,10905085,11137459,13,13,1,10672711,In > Out
Feb 2020,11,70,5,347059,1638183,1985242,5,5,2,1291124,In > Out
Feb 2020,11,71,56,2783987,45057460,47841447,34,56,1,42273473,In > Out
Feb 2020,11,72,5,44637,1193778,1238415,4,5,1,1149141,In > Out
Feb 2020,11,80,22,716471,28738098,29454569,7,22,2,28021627,In > Out
Feb 2020,11,88,1064,86851036,712156356,799007392,279,1061,2,625305320,In > Out
Feb 2020,11,92,2,244570,194992,439562,2,2,2,49578,Out > In
Feb 2020,110,133,220,13116109,595983145,609099254,38,202,2,582867036,In > Out
Feb 2020,110,161,1083,185002391,25249202242,25434204633,299,1039,3,25064199851,In > Out
Feb 2020,110,212,278,13880261,636892145,650772406,43,274,2,623011884,In > Out
Feb 2020,110,75,402,10866877,158765913,169632790,112,400,2,147899036,In > Out
Feb 2020,111,5,1,444400,394400,838800,1,1,1,50000,Out > In
Feb 2020,112,10,1739,509970905,17632757856,18142728761,172,1733,5,17122786951,In > Out
Feb 2020,112,100,206,268512844,1184050139,1452562983,93,206,5,915537295,In > Out
Feb 2020,112,102,521,47315328,924266064,971581392,115,515,5,876950736,In > Out
Feb 2020,112,104,501,681995118,773341773,1455336891,230,474,31,91346655,In > Out
Feb 2020,112,105,676,255076923,7138767773,7393844696,252,669,3,6883690850,In > Out
Feb 2020,112,107,712,79225823,1367592292,1446818115,297,702,10,1288366469,In > Out
Feb 2020,112,108,1035,138177761,1528887019,1667064780,324,1024,4,1390709258,In > Out
Feb 2020,112,109,484,343862173,2064634175,2408496348,171,479,4,1720772002,In > Out
Feb 2020,112,111,736,628454609,3133353651,3761808260,205,718,9,2504899042,In > Out
Feb 2020,112,112,455,204488384,2929234921,3133723305,158,450,6,2724746537,In > Out
Feb 2020,112,114,870,139987857,3876438802,4016426659,237,862,3,3736450945,In > Out
Feb 2020,112,115,1429,266889766,8165368757,8432258523,446,1223,72,7898478991,In > Out
Feb 2020,112,117,659,110027752,4581672422,4691700174,168,647,6,4471644670,In > Out
Feb 2020,112,118,300,516553026,2682430414,3198983440,103,298,6,2165877388,In > Out
Feb 2020,112,119,703,424492269,3951134306,4375626575,208,700,7,3526642037,In > Out
Feb 2020,112,123,818,200815388,2528344891,2729160279,239,800,6,2327529503,In > Out
Feb 2020,112,126,638,79570073,2507558545,2587128618,211,636,3,2427988472,In > Out
Feb 2020,112,127,1234,832626766,7689042919,8521669685,386,1214,3,6856416153,In > Out
Feb 2020,112,128,395,196561535,9680934452,9877495987,136,388,5,9484372917,In > Out
Feb 2020,112,129,380,57661255,1178705949,1236367204,162,376,4,1121044694,In > Out
Feb 2020,112,130,740,473349751,4116181927,4589531678,179,719,4,3642832176,In > Out
Feb 2020,112,131,1212,238476657,10453366472,10691843129,226,1166,8,10214889815,In > Out
Feb 2020,112,132,751,130799220,4601063975,4731863195,227,739,4,4470264755,In > Out
Feb 2020,112,133,327,76272643,788827983,865100626,173,319,7,712555340,In > Out
Feb 2020,112,134,683,873493329,7236209414,8109702743,233,669,7,6362716085,In > Out
Feb 2020,112,135,105,133472663,272459809,405932472,36,105,6,138987146,In > Out
Feb 2020,112,136,289,35900784,746533204,782433988,150,287,5,710632420,In > Out
Feb 2020,112,137,288,21630270,415833161,437463431,130,283,3,394202891,In > Out
Feb 2020,112,138,688,356187650,3157322702,3513510352,213,672,9,2801135052,In > Out
Feb 2020,112,139,885,1058095531,6234802842,7292898373,277,866,7,5176707311,In > Out
Feb 2020,112,14,766,136958924,5095708664,5232667588,269,757,10,4958749740,In > Out
Feb 2020,112,140,596,63990996,1184302126,1248293122,173,590,5,1120311130,In > Out
Feb 2020,112,141,782,164385177,3480053494,3644438671,217,766,13,3315668317,In > Out
Feb 2020,112,142,715,142182239,1877507630,2019689869,182,709,4,1735325391,In > Out
Feb 2020,112,143,1255,441690674,15141379840,15583070514,454,1228,3,14699689166,In > Out
Feb 2020,112,144,371,109484020,5667885238,5777369258,188,371,3,5558401218,In > Out
Feb 2020,112,145,1431,1399979577,4749837212,6149816789,280,1391,24,3349857635,In > Out
Feb 2020,112,146,545,369189314,2418267906,2787457220,115,534,5,2049078592,In > Out
Feb 2020,112,147,407,81884836,615059868,696944704,142,398,11,533175032,In > Out
Feb 2020,112,148,1033,195692243,4526317756,4722009999,145,1010,6,4330625513,In > Out
Feb 2020,112,149,311,176881954,650110951,826992905,141,306,5,473228997,In > Out
Feb 2020,112,15,1189,289038488,12797952290,13086990778,280,1172,9,12508913802,In > Out
Feb 2020,112,150,485,446551461,2044584861,2491136322,200,473,7,1598033400,In > Out
Feb 2020,112,151,274,95320107,1860769937,1956090044,118,270,5,1765449830,In > Out
Feb 2020,112,152,790,197595479,5126016121,5323611600,197,762,6,4928420642,In > Out
Feb 2020,112,153,468,136301817,1083828130,1220129947,103,467,7,947526313,In > Out
Feb 2020,112,154,2034,251711720,12687649916,12939361636,351,1934,6,12435938196,In > Out
Feb 2020,112,155,2023,195733072,8983520105,9179253177,318,1871,4,8787787033,In > Out
Feb 2020,112,156,1196,512782321,18225072909,18737855230,327,1163,7,17712290588,In > Out
Feb 2020,112,157,619,327472841,3402739950,3730212791,171,599,7,3075267109,In > Out
Feb 2020,112,158,851,324924747,2545313464,2870238211,187,832,4,2220388717,In > Out
Feb 2020,112,159,560,56785106,1258526035,1315311141,177,553,4,1201740929,In > Out
Feb 2020,112,160,854,75465415,3297514467,3372979882,122,844,6,3222049052,In > Out
Feb 2020,112,161,207,25688754,880804416,906493170,81,204,4,855115662,In > Out
Feb 2020,112,162,536,49438232,1305667345,1355105577,212,527,3,1256229113,In > Out
Feb 2020,112,163,480,52402262,1624487169,1676889431,130,471,6,1572084907,In > Out
Feb 2020,112,164,234,128578124,583488003,712066127,123,232,8,454909879,In > Out
Feb 2020,112,165,2323,159794988,5668441363,5828236351,219,2227,4,5508646375,In > Out
Feb 2020,112,166,595,453530527,4475119677,4928650204,253,579,19,4021589150,In > Out
Feb 2020,112,167,4969,384589572,10125441689,10510031261,221,4861,4,9740852117,In > Out
Feb 2020,112,168,225,26895261,654354398,681249659,89,225,3,627459137,In > Out
Feb 2020,112,169,822,783554701,18440056604,19223611305,275,795,5,17656501903,In > Out
Feb 2020,112,170,829,1563839350,4029710649,5593549999,234,818,6,2465871299,In > Out
Feb 2020,112,171,553,929585295,2619571320,3549156615,167,549,15,1689986025,In > Out
Feb 2020,112,173,1051,134588318,1902111549,2036699867,220,1033,5,1767523231,In > Out
Feb 2020,112,174,652,60147776,2415984571,2476132347,212,649,3,2355836795,In > Out
Feb 2020,112,175,805,219712611,8182538279,8402250890,201,793,6,7962825668,In > Out
Feb 2020,112,176,6107,3311172404,312141047663,315452220067,350,5732,17,308829875259,In > Out
Feb 2020,112,177,345,68560733,800367742,868928475,75,341,11,731807009,In > Out
Feb 2020,112,178,710,132836919,1800852431,1933689350,209,695,6,1668015512,In > Out
Feb 2020,112,179,1187,142538070,5138510466,5281048536,277,1169,5,4995972396,In > Out
Feb 2020,112,180,655,140572139,1333913737,1474485876,151,649,4,1193341598,In > Out
Feb 2020,112,181,468,556795493,1245038797,1801834290,120,468,8,688243304,In > Out
Feb 2020,112,182,1411,2065369111,11629654527,13695023638,326,1348,9,9564285416,In > Out
Feb 2020,112,183,386,111965483,3816921199,3928886682,163,382,5,3704955716,In > Out
Feb 2020,112,184,828,967181896,7404831465,8372013361,299,802,12,6437649569,In > Out
Feb 2020,112,185,589,434475147,2407914374,2842389521,133,584,6,1973439227,In > Out
Feb 2020,112,186,236,17925793,477586603,495512396,90,233,6,459660810,In > Out
Feb 2020,112,187,396,41224806,1283855392,1325080198,136,395,3,1242630586,In > Out
Feb 2020,112,188,738,160321548,2153979488,2314301036,214,726,7,1993657940,In > Out
Feb 2020,112,189,34040,1289282902,74876342182,76165625084,212,15608,35,73587059280,In > Out
Feb 2020,112,190,531,389685690,1796986889,2186672579,147,527,5,1407301199,In > Out
Feb 2020,112,191,783,259987969,2429984551,2689972520,222,776,6,2169996582,In > Out
Feb 2020,112,192,341,91905600,1103089582,1194995182,112,335,5,1011183982,In > Out
Feb 2020,112,193,1024,437294288,12143905566,12581199854,249,1007,9,11706611278,In > Out
Feb 2020,112,199,810,763522245,2212848556,2976370801,260,794,6,1449326311,In > Out
Feb 2020,112,200,240,55564542,297635257,353199799,142,238,4,242070715,In > Out
Feb 2020,112,201,323,23319981,526685404,550005385,139,318,7,503365423,In > Out
Feb 2020,112,202,750,1018406453,2611884215,3630290668,256,730,10,1593477762,In > Out
Feb 2020,112,203,993,778382983,2924630155,3703013138,218,979,5,2146247172,In > Out
Feb 2020,112,204,972,1898025765,5385736619,7283762384,232,959,10,3487710854,In > Out
Feb 2020,112,205,769,344508379,2171326610,2515834989,185,761,5,1826818231,In > Out
Feb 2020,112,206,1169,328178557,6686385680,7014564237,244,1142,6,6358207123,In > Out
Feb 2020,112,207,391,247913781,961293213,1209206994,163,387,7,713379432,In > Out
Feb 2020,112,208,765,416113808,4068692140,4484805948,233,749,19,3652578332,In > Out
Feb 2020,112,209,393,49242412,2197323146,2246565558,163,391,4,2148080734,In > Out
Feb 2020,112,211,861,117536609,4252753195,4370289804,204,835,13,4135216586,In > Out
Feb 2020,112,212,406,26086345,774798689,800885034,139,405,5,748712344,In > Out
Feb 2020,112,213,605,197949413,2252329020,2450278433,180,598,7,2054379607,In > Out
Feb 2020,112,216,681,107459738,2907908985,3015368723,179,664,5,2800449247,In > Out
Feb 2020,112,217,250,76122626,2588618590,2664741216,85,249,6,2512495964,In > Out
Feb 2020,112,219,1853,451804964,13572238886,14024043850,485,1736,56,13120433922,In > Out
Feb 2020,112,22,885,290019188,4327292555,4617311743,212,858,7,4037273367,In > Out
Feb 2020,112,220,1061,265244664,2850238626,3115483290,239,1047,7,2584993962,In > Out
Feb 2020,112,223,256,55019331,650959722,705979053,85,256,5,595940391,In > Out
Feb 2020,112,25,1224,513832419,4657989256,5171821675,257,1200,7,4144156837,In > Out
Feb 2020,112,28,785,454385222,7363260092,7817645314,242,768,2,6908874870,In > Out
Feb 2020,112,30,499,83640703,1812069158,1895709861,162,493,8,1728428455,In > Out
Feb 2020,112,31,645,65611539,962424570,1028036109,181,635,6,896813031,In > Out
Feb 2020,112,32,713,156189662,1624001495,1780191157,260,695,12,1467811833,In > Out
Feb 2020,112,33,209,139199062,556681469,695880531,102,209,4,417482407,In > Out
Feb 2020,112,36,1936,252287583,7897642481,8149930064,370,1863,8,7645354898,In > Out
Feb 2020,112,38,701,65188520,1122993677,1188182197,254,697,5,1057805157,In > Out
Feb 2020,112,39,366,64996801,3783383724,3848380525,92,360,3,3718386923,In > Out
Feb 2020,112,40,794,117942265,7124852346,7242794611,228,761,5,7006910081,In > Out
Feb 2020,112,41,83,7731940,125975688,133707628,55,83,2,118243748,In > Out
Feb 2020,112,42,825,63251657,2534930943,2598182600,134,810,3,2471679286,In > Out
Feb 2020,112,45,307,150524278,6384231442,6534755720,100,297,3,6233707164,In > Out
Feb 2020,112,49,599,82692240,1083099647,1165791887,214,581,8,1000407407,In > Out
Feb 2020,112,50,966,422629582,7933168328,8355797910,348,938,6,7510538746,In > Out
Feb 2020,112,53,472,59278396,1954302722,2013581118,146,469,5,1895024326,In > Out
Feb 2020,112,54,437,735415060,1187036121,1922451181,193,437,4,451621061,In > Out
Feb 2020,112,59,295,43805598,708528624,752334222,159,295,5,664723026,In > Out
Feb 2020,112,6,726,413691959,4710598014,5124289973,224,714,3,4296906055,In > Out
Feb 2020,112,63,993,127435466,1797083655,1924519121,255,968,5,1669648189,In > Out
Feb 2020,112,64,557,54993409,1294672979,1349666388,221,534,5,1239679570,In > Out
Feb 2020,112,67,326,75739978,649403009,725142987,92,325,4,573663031,In > Out
Feb 2020,112,68,547,228604243,7452332907,7680937150,158,538,6,7223728664,In > Out
Feb 2020,112,71,1661,136937945,4548102220,4685040165,369,1574,7,4411164275,In > Out
Feb 2020,112,72,495,268383251,13379412715,13647795966,232,487,3,13111029464,In > Out
Feb 2020,112,73,872,128692402,4766687064,4895379466,217,821,5,4637994662,In > Out
Feb 2020,112,74,335,54109756,1392822705,1446932461,141,333,6,1338712949,In > Out
Feb 2020,112,76,1317,300138100,15821298210,16121436310,403,1266,9,15521160110,In > Out
Feb 2020,112,78,591,82216652,5050554660,5132771312,121,585,4,4968338008,In > Out
Feb 2020,112,84,715,862086007,13693617019,14555703026,246,704,5,12831531012,In > Out
Feb 2020,112,86,557,99878761,3120003664,3219882425,176,555,6,3020124903,In > Out
Feb 2020,112,88,1259,369571549,5656906362,6026477911,311,1216,8,5287334813,In > Out
Feb 2020,112,90,619,232520582,1382405251,1614925833,196,616,4,1149884669,In > Out
Feb 2020,112,91,497,117559320,7202874217,7320433537,217,492,4,7085314897,In > Out
Feb 2020,112,93,372,34368480,799616902,833985382,147,369,10,765248422,In > Out
Feb 2020,112,94,591,72239221,2442537096,2514776317,133,585,3,2370297875,In > Out
Feb 2020,112,96,452,83433746,2976039855,3059473601,218,450,3,2892606109,In > Out
Feb 2020,112,97,613,80407369,3767486100,3847893469,189,608,5,3687078731,In > Out
Feb 2020,112,99,1296,360764962,21621023464,21981788426,285,1240,26,21260258502,In > Out
Feb 2020,114,110,11,1164176,14754552,15918728,6,11,3,13590376,In > Out
Feb 2020,115,155,59,2737886,57928357,60666243,30,59,2,55190471,In > Out
Feb 2020,115,159,165,59468501,213763800,273232301,61,165,2,154295299,In > Out
Feb 2020,115,161,354,130512802,230306758,360819560,37,348,2,99793956,In > Out
Feb 2020,115,162,56,7610327,46476844,54087171,30,56,2,38866517,In > Out
Feb 2020,115,164,190,26871673,95408009,122279682,69,186,2,68536336,In > Out
Feb 2020,115,165,210,24540953,159804020,184344973,92,210,2,135263067,In > Out
Feb 2020,115,169,65,13471688,149882111,163353799,39,65,2,136410423,In > Out
Feb 2020,115,181,1,3045,184008,187053,1,1,1,180963,In > Out
Feb 2020,115,184,27,1361634,30449111,31810745,14,27,2,29087477,In > Out
Feb 2020,115,185,140,416733085,254645210,671378295,63,138,8,162087875,Out > In
Feb 2020,115,189,403,22376946,395453807,417830753,120,399,2,373076861,In > Out
Feb 2020,115,193,221,7252831,301171901,308424732,36,221,2,293919070,In > Out
Feb 2020,115,194,217,9005094,241481607,250486701,68,216,2,232476513,In > Out
Feb 2020,115,195,497,50582860,204095663,254678523,29,494,2,153512803,In > Out
Feb 2020,115,201,665,125119836,130578502,255698338,137,655,2,5458666,In > Out
Feb 2020,115,211,413,33574615,426142997,459717612,123,408,2,392568382,In > Out
Feb 2020,115,26,248,9707185,191217684,200924869,104,246,2,181510499,In > Out
Feb 2020,115,27,326,27220692,780612490,807833182,95,323,2,753391798,In > Out
Feb 2020,115,29,129,5767555,158551088,164318643,44,129,2,152783533,In > Out
Feb 2020,115,31,131,3851912,63564370,67416282,63,128,2,59712458,In > Out
Feb 2020,115,32,56,1521624,116260920,117782544,14,56,2,114739296,In > Out
Feb 2020,115,35,29,562192,24128161,24690353,11,29,2,23565969,In > Out
Feb 2020,115,71,19,481758,32961001,33442759,13,19,2,32479243,In > Out
Feb 2020,115,73,197,11893857,169954791,181848648,60,194,2,158060934,In > Out
Feb 2020,115,76,30,866515,22025505,22892020,15,30,2,21158990,In > Out
Feb 2020,115,81,219,9155736,229365717,238521453,86,218,2,220209981,In > Out
Feb 2020,115,89,197,4828718,220582101,225410819,77,196,2,215753383,In > Out
Feb 2020,117,147,275,7569480,539400573,546970053,6,275,2,531831093,In > Out
Feb 2020,117,148,551,6639479,1066878347,1073517826,4,551,2,1060238868,In > Out
Feb 2020,117,149,142,51924883591,589848051,52514731642,31,62,3,51335035540,Out > In
Feb 2020,117,153,73,5574557,470680206,476254763,26,69,2,465105649,In > Out
Feb 2020,117,154,1,23314,933578,956892,1,1,1,910264,In > Out
Feb 2020,117,158,3,275241,94470,369711,2,3,1,180771,Out > In
Feb 2020,117,16,245,31067580,1150344976,1181412556,79,245,3,1119277396,In > Out
Feb 2020,117,177,884,60109645,907795639,967905284,220,840,3,847685994,In > Out
Feb 2020,117,183,7,763346,254797,1018143,2,7,1,508549,Out > In
Feb 2020,117,185,4,417412,130774,548186,1,4,1,286638,Out > In
Feb 2020,117,208,103,182475971,22080078,204556049,2,103,3,160395893,Out > In
Feb 2020,117,209,7167,35670966194,11785414875,47456381069,1370,6779,20,23885551319,Out > In
Feb 2020,117,236,9,7317958,41221704,48539662,3,9,2,33903746,In > Out
Feb 2020,117,238,2218,667630730,20096733665,20764364395,527,2094,3,19429102935,In > Out
Feb 2020,117,254,303,230526221265,8516638554,239042859819,59,1,8,222009582711,Out > In
Feb 2020,117,50,177,66916011,23059366,89975377,3,172,15,43856645,Out > In
Feb 2020,117,61,1548,253357197,5095826906,5349184103,140,1506,6,4842469709,In > Out
Feb 2020,117,76,60,26822484,15922612,42745096,1,1,1,10899872,Out > In
Feb 2020,117,81,1,108278,31712,139990,1,1,1,76566,Out > In
Feb 2020,118,100,22,309975,5978700,6288675,10,22,2,5668725,In > Out
Feb 2020,118,106,480,18841581,307387145,326228726,174,475,2,288545564,In > Out
Feb 2020,118,108,624,24145455,460519585,484665040,250,616,3,436374130,In > Out
Feb 2020,118,114,97,7073386,117079145,124152531,53,97,2,110005759,In > Out
Feb 2020,118,116,733,164997359,1085945517,1250942876,288,723,4,920948158,In > Out
Feb 2020,118,119,97,5174044,57128495,62302539,42,97,2,51954451,In > Out
Feb 2020,118,12,92,14700911,251492753,266193664,53,92,2,236791842,In > Out
Feb 2020,118,120,25,976250,3235341,4211591,11,25,2,2259091,In > Out
Feb 2020,118,124,411,42898401,50177097,93075498,24,411,2,7278696,In > Out
Feb 2020,118,128,730,21333251,2655372486,2676705737,100,716,5,2634039235,In > Out
Feb 2020,118,130,1225,71434867,1428062116,1499496983,292,1180,2,1356627249,In > Out
Feb 2020,118,132,316,20532243,354138129,374670372,161,311,2,333605886,In > Out
Feb 2020,118,133,1,4068,179400,183468,1,1,1,175332,In > Out
Feb 2020,118,134,53,1913345,83425147,85338492,15,53,2,81511802,In > Out
Feb 2020,118,136,598,375400887,359852176,735253063,155,591,2,15548711,Out > In
Feb 2020,118,137,1,20403,755971,776374,1,1,1,735568,In > Out
Feb 2020,118,138,11,275135,11132028,11407163,10,11,2,10856893,In > Out
Feb 2020,118,140,47,4768347,37388492,42156839,26,47,1,32620145,In > Out
Feb 2020,118,141,1,6270,1234136,1240406,1,1,1,1227866,In > Out
Feb 2020,118,143,33,23189210,120031634,143220844,14,32,5,96842424,In > Out
Feb 2020,118,144,123,24248304,276701302,300949606,50,122,2,252452998,In > Out
Feb 2020,118,154,70,5562341,135002668,140565009,38,70,2,129440327,In > Out
Feb 2020,118,158,212,2773407,458199654,460973061,31,212,2,455426247,In > Out
Feb 2020,118,160,582,33876415,909981255,943857670,25,572,2,876104840,In > Out
Feb 2020,118,163,113,11885332,122208797,134094129,48,111,2,110323465,In > Out
Feb 2020,118,165,191,20177872,261366747,281544619,73,191,2,241188875,In > Out
Feb 2020,118,168,991,67861347,4261701704,4329563051,188,967,8,4193840357,In > Out
Feb 2020,118,171,6,41973,2080181,2122154,4,6,2,2038208,In > Out
Feb 2020,118,173,56,3548644,492351116,495899760,34,56,2,488802472,In > Out
Feb 2020,118,176,44,3011486,87141474,90152960,26,44,2,84129988,In > Out
Feb 2020,118,177,176,60984803,65016133,126000936,61,174,2,4031330,In > Out
Feb 2020,118,178,24,1013821,23029639,24043460,13,24,2,22015818,In > Out
Feb 2020,118,179,1123,155898078,1907013948,2062912026,305,1095,2,1751115870,In > Out
Feb 2020,118,18,1355,493895925,544087408,1037983333,223,1290,2,50191483,In > Out
Feb 2020,118,181,273,6593158,108351801,114944959,67,272,2,101758643,In > Out
Feb 2020,118,184,27,885080,3241036,4126116,8,27,2,2355956,In > Out
Feb 2020,118,187,1159,68308031,487844675,556152706,270,1140,3,419536644,In > Out
Feb 2020,118,188,51,2146682,118354366,120501048,20,51,2,116207684,In > Out
Feb 2020,118,19,22,334574,27662321,27996895,11,22,1,27327747,In > Out
Feb 2020,118,190,244,12137213,262515691,274652904,104,242,2,250378478,In > Out
Feb 2020,118,191,288,21224561,203610706,224835267,140,279,2,182386145,In > Out
Feb 2020,118,193,448,90267217,217392307,307659524,87,443,2,127125090,In > Out
Feb 2020,118,194,294,27273263,375219508,402492771,99,293,2,347946245,In > Out
Feb 2020,118,204,3,33884,1960924,1994808,3,3,1,1927040,In > Out
Feb 2020,118,206,113,14499820,191716074,206215894,54,113,2,177216254,In > Out
Feb 2020,118,207,433,83117952,2703838654,2786956606,160,429,7,2620720702,In > Out
Feb 2020,118,210,2886,1228733371,1425605330,2654338701,168,2573,5,196871959,In > Out
Feb 2020,118,213,899,63333419,2944080924,3007414343,299,865,2,2880747505,In > Out
Feb 2020,118,215,70,1065662,33455393,34521055,26,70,3,32389731,In > Out
Feb 2020,118,217,542,34063428,1183506676,1217570104,53,535,3,1149443248,In > Out
Feb 2020,118,218,17,398596,6437609,6836205,11,17,2,6039013,In > Out
Feb 2020,118,219,16,238206,13228030,13466236,14,16,2,12989824,In > Out
Feb 2020,118,225,539,148626173,7521185733,7669811906,138,537,3,7372559560,In > Out
Feb 2020,118,226,1,131955,7866,139821,1,1,1,124089,Out > In
Feb 2020,118,229,153,5343228,111604081,116947309,64,149,2,106260853,In > Out
Feb 2020,118,230,1180,5189204834,1877017742,7066222576,319,1136,2,3312187092,Out > In
Feb 2020,118,231,528,26598730,662759102,689357832,209,521,2,636160372,In > Out
Feb 2020,118,232,67,1511844,58582473,60094317,20,67,2,57070629,In > Out
Feb 2020,118,233,752,98555433,6288686433,6387241866,279,732,5,6190131000,In > Out
Feb 2020,118,234,8,43352,2564176,2607528,5,8,2,2520824,In > Out
Feb 2020,118,240,36,2795194,39274253,42069447,24,36,2,36479059,In > Out
Feb 2020,118,242,875,154168136,8182606561,8336774697,144,849,5,8028438425,In > Out
Feb 2020,118,246,422,65729922,845431487,911161409,173,417,3,779701565,In > Out
Feb 2020,118,247,532,156593437,8806038972,8962632409,260,521,92,8649445535,In > Out
Feb 2020,118,250,2,456053,128777,584830,2,2,1,327276,Out > In
Feb 2020,118,253,239,12762842,440001110,452763952,102,238,2,427238268,In > Out
Feb 2020,118,254,159,11245351,44915630,56160981,58,159,2,33670279,In > Out
Feb 2020,118,26,405,59850209,7626527,67476736,15,405,2,52223682,Out > In
Feb 2020,118,27,899,1272306344,2391509400,3663815744,341,876,5,1119203056,In > Out
Feb 2020,118,28,649,61400883,819544637,880945520,173,646,5,758143754,In > Out
Feb 2020,118,31,436,16136307,773878296,790014603,64,433,2,757741989,In > Out
Feb 2020,118,33,64,1958464,80517583,82476047,24,64,2,78559119,In > Out
Feb 2020,118,34,24,1010215,21256942,22267157,11,24,2,20246727,In > Out
Feb 2020,118,46,203,40351580,83945374,124296954,30,202,2,43593794,In > Out
Feb 2020,118,47,223,81529638,239207290,320736928,46,222,2,157677652,In > Out
Feb 2020,118,48,1009,126588260,5142422117,5269010377,192,985,2,5015833857,In > Out
Feb 2020,118,53,27,1450079,33110264,34560343,12,27,2,31660185,In > Out
Feb 2020,118,54,6,653662,717286,1370948,5,6,2,63624,In > Out
Feb 2020,118,56,12,350829,17923928,18274757,7,12,2,17573099,In > Out
Feb 2020,118,57,185,14653989,63623291,78277280,97,185,2,48969302,In > Out
Feb 2020,118,58,275,5737555,499865058,505602613,24,275,2,494127503,In > Out
Feb 2020,118,59,201,27866626,103780906,131647532,119,193,14,75914280,In > Out
Feb 2020,118,63,122,2890805,304898625,307789430,13,114,3,302007820,In > Out
Feb 2020,118,70,36,4583363,16838771,21422134,18,36,2,12255408,In > Out
Feb 2020,118,71,712,46564647,582089120,628653767,125,691,2,535524473,In > Out
Feb 2020,118,72,128,61252685,22224951,83477636,28,122,2,39027734,Out > In
Feb 2020,118,73,88,4226211,42472888,46699099,56,87,2,38246677,In > Out
Feb 2020,118,74,3,174191,11294453,11468644,2,3,1,11120262,In > Out
Feb 2020,118,76,11,51930,3358431,3410361,5,11,2,3306501,In > Out
Feb 2020,118,77,8,872759,2357792,3230551,6,8,2,1485033,In > Out
Feb 2020,118,79,332,14604729,348845706,363450435,148,329,2,334240977,In > Out
Feb 2020,118,80,61,3007263,91396991,94404254,15,61,2,88389728,In > Out
Feb 2020,118,81,10,326589,2169665,2496254,4,10,1,1843076,In > Out
Feb 2020,118,82,815,175094595,1105001197,1280095792,205,805,3,929906602,In > Out
Feb 2020,118,83,196,15618247,116648308,132266555,120,195,2,101030061,In > Out
Feb 2020,118,84,10,353852,3686886,4040738,6,10,2,3333034,In > Out
Feb 2020,118,85,90,2205998,470886894,473092892,34,90,3,468680896,In > Out
Feb 2020,118,97,97,63173703,722769733,785943436,45,97,3,659596030,In > Out
Feb 2020,118,99,82,1828045,312546249,314374294,30,82,2,310718204,In > Out
Feb 2020,119,102,7,452117,66085948,66538065,5,7,2,65633831,In > Out
Feb 2020,119,103,12,177333,12688009,12865342,6,12,2,12510676,In > Out
Feb 2020,119,105,1,177652,30972136,31149788,1,1,1,30794484,In > Out
Feb 2020,119,107,133,2952788,220367232,223320020,36,129,2,217414444,In > Out
Feb 2020,119,108,56,1483690,84907277,86390967,18,56,2,83423587,In > Out
Feb 2020,119,109,453,57882696,295848721,353731417,82,446,2,237966025,In > Out
Feb 2020,119,110,431,25944142,302539099,328483241,89,426,2,276594957,In > Out
Feb 2020,119,114,3,649604,37465064,38114668,3,3,1,36815460,In > Out
Feb 2020,119,120,679,22482665601,1640295076,24122960677,220,661,3,20842370525,Out > In
Feb 2020,119,122,471,28939055,1627332442,1656271497,103,469,8,1598393387,In > Out
Feb 2020,119,125,2060,122464762,1624161798,1746626560,521,1958,2,1501697036,In > Out
Feb 2020,119,126,10,266264,2712648,2978912,6,10,1,2446384,In > Out
Feb 2020,119,134,26,2957948,103344242,106302190,9,26,1,100386294,In > Out
Feb 2020,119,135,303,21554864,150120989,171675853,78,299,2,128566125,In > Out
Feb 2020,119,137,430,87534669,315842109,403376778,187,428,2,228307440,In > Out
Feb 2020,119,141,93,2996211,131685058,134681269,25,93,2,128688847,In > Out
Feb 2020,119,143,580,25495968,985127180,1010623148,83,561,2,959631212,In > Out
Feb 2020,119,144,17,713481,19332574,20046055,8,17,2,18619093,In > Out
Feb 2020,119,148,495,76386122,3424706940,3501093062,140,488,4,3348320818,In > Out
Feb 2020,119,150,110,4294395,76971066,81265461,39,110,2,72676671,In > Out
Feb 2020,119,151,18,864727,22599137,23463864,13,18,2,21734410,In > Out
Feb 2020,119,152,989,218825268,2937399804,3156225072,331,941,29,2718574536,In > Out
Feb 2020,119,153,18,6818308,3152446,9970754,13,18,2,3665862,Out > In
Feb 2020,119,154,42,1041994,57395759,58437753,16,42,2,56353765,In > Out
Feb 2020,119,155,144,28373406,73588612,101962018,61,144,2,45215206,In > Out
Feb 2020,119,159,265,442413394,373985302,816398696,177,253,97,68428092,Out > In
Feb 2020,119,16,2,79295,6519173,6598468,1,2,1,6439878,In > Out
Feb 2020,119,160,80,2181457,31133375,33314832,36,80,2,28951918,In > Out
Feb 2020,119,162,972,141908858,1204191003,1346099861,106,946,2,1062282145,In > Out
Feb 2020,119,168,11,23001673,1169820,24171493,4,8,11,21831853,Out > In
Feb 2020,119,171,433,358739724,487063961,845803685,159,416,3,128324237,In > Out
Feb 2020,119,172,117,5461336,229216553,234677889,19,115,2,223755217,In > Out
Feb 2020,119,178,288,21074239,422238886,443313125,69,288,5,401164647,In > Out
Feb 2020,119,18,13,952569,72734227,73686796,7,13,2,71781658,In > Out
Feb 2020,119,181,221,17564523,614839957,632404480,68,218,2,597275434,In > Out
Feb 2020,119,183,537,32508987,561181415,593690402,173,528,2,528672428,In > Out
Feb 2020,119,184,32,2839247,91244776,94084023,15,32,2,88405529,In > Out
Feb 2020,119,19,291,26755886,218360805,245116691,72,290,2,191604919,In > Out
Feb 2020,119,194,1299,650113581,1978444685,2628558266,343,1262,2,1328331104,In > Out
Feb 2020,119,196,151,7172881,170842483,178015364,59,151,2,163669602,In > Out
Feb 2020,119,204,1,6091,137308,143399,1,1,1,131217,In > Out
Feb 2020,119,211,18,900584,6188198,7088782,10,18,2,5287614,In > Out
Feb 2020,119,213,276,31923311,91945707,123869018,66,274,3,60022396,In > Out
Feb 2020,119,214,109,44623286,279635321,324258607,34,108,3,235012035,In > Out
Feb 2020,119,218,252,8093672,88758590,96852262,45,251,2,80664918,In > Out
Feb 2020,119,23,38,1025636,20385887,21411523,17,38,2,19360251,In > Out
Feb 2020,119,28,527,31775767,688627541,720403308,161,515,2,656851774,In > Out
Feb 2020,119,32,260,258668817,3735797867,3994466684,59,260,5,3477129050,In > Out
Feb 2020,119,34,26,941251,10228761,11170012,16,26,3,9287510,In > Out
Feb 2020,119,38,461,56291598,442084935,498376533,207,458,2,385793337,In > Out
Feb 2020,119,41,391,72950363,1283746466,1356696829,137,389,4,1210796103,In > Out
Feb 2020,119,58,21,623110,15539544,16162654,11,21,2,14916434,In > Out
Feb 2020,119,59,2,111426,8505538,8616964,1,2,1,8394112,In > Out
Feb 2020,119,64,184,8742043,343560403,352302446,67,184,2,334818360,In > Out
Feb 2020,119,72,2,290848,105084,395932,2,2,1,185764,Out > In
Feb 2020,119,73,90,10531750,79147713,89679463,61,90,2,68615963,In > Out
Feb 2020,119,74,62,2626309,103793785,106420094,21,62,2,101167476,In > Out
Feb 2020,119,75,28,944139,26520340,27464479,15,28,2,25576201,In > Out
Feb 2020,119,77,493,43506202,296776089,340282291,148,485,3,253269887,In > Out
Feb 2020,119,78,196,27268834,31782714,59051548,80,195,2,4513880,In > Out
Feb 2020,119,80,884,72119856,2407461205,2479581061,288,884,2,2335341349,In > Out
Feb 2020,119,95,7,1363404,962652,2326056,3,7,2,400752,Out > In
Feb 2020,119,96,7,2389543,856220,3245763,1,1,1,1533323,Out > In
Feb 2020,120,101,71,2123663,100714585,102838248,18,71,2,98590922,In > Out
Feb 2020,120,105,537,35483559,378229155,413712714,167,535,2,342745596,In > Out
Feb 2020,120,107,50,6443667,277162747,283606414,22,50,2,270719080,In > Out
Feb 2020,120,126,739,64672386,322517786,387190172,80,718,2,257845400,In > Out
Feb 2020,120,167,307,33286805,263218371,296505176,71,304,2,229931566,In > Out
Feb 2020,120,179,84,4368384,46774511,51142895,45,84,2,42406127,In > Out
Feb 2020,120,207,626,48294113,586909629,635203742,255,622,2,538615516,In > Out
Feb 2020,120,35,603,216992605,282715206,499707811,141,594,2,65722601,In > Out
Feb 2020,120,52,138,8613718,215587504,224201222,50,138,2,206973786,In > Out
Feb 2020,120,54,446,62592087,404047193,466639280,161,439,3,341455106,In > Out
Feb 2020,120,71,547,27250623,1208562332,1235812955,17,542,2,1181311709,In > Out
Feb 2020,120,85,649,96869614,1206791560,1303661174,207,640,2,1109921946,In > Out
Feb 2020,122,10,21,3597824,2136154,5733978,11,1,2,1461670,Out > In
Feb 2020,122,108,1667,32408478,1187717864,1220126342,116,1483,3,1155309386,In > Out
Feb 2020,122,119,1437,235863005,251127106,486990111,56,1352,4,15264101,In > Out
Feb 2020,122,160,1201,230867757,1910031565,2140899322,311,1163,6,1679163808,In > Out
Feb 2020,122,161,39,8453424,806140,9259564,2,1,1,7647284,Out > In
Feb 2020,122,165,215,15423331,388649027,404072358,44,215,1,373225696,In > Out
Feb 2020,122,176,44,127277686,13052784355,13180062041,18,44,1,12925506669,In > Out
Feb 2020,122,196,258,14479344,187582339,202061683,118,256,2,173102995,In > Out
Feb 2020,122,205,1084,147049184,975526995,1122576179,193,1041,5,828477811,In > Out
Feb 2020,122,214,6,2826858,927008,3753866,6,1,4,1899850,Out > In
Feb 2020,122,222,2104,5638335591,867517827,6505853418,603,522,614,4770817764,Out > In
Feb 2020,122,227,2,37377,316877,354254,2,2,1,279500,In > Out
Feb 2020,122,237,23,29110434,67946574,97057008,4,10,17,38836140,In > Out
Feb 2020,122,87,43,785428,22418882,23204310,25,43,2,21633454,In > Out
Feb 2020,123,101,671,185441805,3866908668,4052350473,192,665,5,3681466863,In > Out
Feb 2020,123,103,196,153541389,404823230,558364619,106,196,3,251281841,In > Out
Feb 2020,123,104,893,134963870,2510241585,2645205455,249,848,7,2375277715,In > Out
Feb 2020,123,105,1089,468546581,25352073191,25820619772,308,1073,7,24883526610,In > Out
Feb 2020,123,107,1064,685130231,6061477603,6746607834,280,1046,6,5376347372,In > Out
Feb 2020,123,11,1295,237381884,4169586128,4406968012,376,1259,5,3932204244,In > Out
Feb 2020,123,110,740,137578142,2010995098,2148573240,284,720,20,1873416956,In > Out
Feb 2020,123,111,908,212149822,3076417880,3288567702,220,883,19,2864268058,In > Out
Feb 2020,123,112,1150,126433737,5464914443,5591348180,340,1132,5,5338480706,In > Out
Feb 2020,123,113,914,525071425,3987733148,4512804573,194,894,6,3462661723,In > Out
Feb 2020,123,116,678,462994902,6897489033,7360483935,227,659,8,6434494131,In > Out
Feb 2020,123,117,246,189130546,1515660790,1704791336,139,244,7,1326530244,In > Out
Feb 2020,123,119,719,67843178,1339296413,1407139591,124,712,8,1271453235,In > Out
Feb 2020,123,124,1046,2643489544,5241516978,7885006522,304,1021,14,2598027434,In > Out
Feb 2020,123,126,1106,867569505,3384000945,4251570450,356,1075,7,2516431440,In > Out
Feb 2020,123,128,1121,165721263,5110322603,5276043866,312,1105,6,4944601340,In > Out
Feb 2020,123,129,632,233286686,2394284112,2627570798,192,617,11,2160997426,In > Out
Feb 2020,123,130,289,59610117,3970966901,4030577018,116,288,3,3911356784,In > Out
Feb 2020,123,131,626,136134299,1983293159,2119427458,232,613,9,1847158860,In > Out
Feb 2020,123,132,978,1030328808,4073154178,5103482986,187,962,8,3042825370,In > Out
Feb 2020,123,133,582,118915881,5783218424,5902134305,242,576,8,5664302543,In > Out
Feb 2020,123,134,480,79427128,2839736949,2919164077,179,479,6,2760309821,In > Out
Feb 2020,123,135,183,158833217,724036316,882869533,70,161,4,565203099,In > Out
Feb 2020,123,136,330,280641452,15376784968,15657426420,138,327,3,15096143516,In > Out
Feb 2020,123,137,800,151902888,7496176637,7648079525,273,792,6,7344273749,In > Out
Feb 2020,123,138,986,407269680,14514536614,14921806294,349,956,6,14107266934,In > Out
Feb 2020,123,139,213,75664191,2466497345,2542161536,99,213,2,2390833154,In > Out
Feb 2020,123,140,971,190364958,9537493080,9727858038,153,962,6,9347128122,In > Out
Feb 2020,123,141,681,67697158,2765369533,2833066691,213,674,6,2697672375,In > Out
Feb 2020,123,142,898,427294605,4564568023,4991862628,225,873,4,4137273418,In > Out
Feb 2020,123,143,624,53262681,1416209359,1469472040,127,604,5,1362946678,In > Out
Feb 2020,123,144,1217,765054547,12817415868,13582470415,286,1189,15,12052361321,In > Out
Feb 2020,123,145,221,333003922,551137044,884140966,97,221,4,218133122,In > Out
Feb 2020,123,146,1301,112581494,4251822448,4364403942,202,1260,4,4139240954,In > Out
Feb 2020,123,148,1207,142159909,4337216452,4479376361,336,1172,6,4195056543,In > Out
Feb 2020,123,149,1131,1212932634,5119613116,6332545750,336,1092,7,3906680482,In > Out
Feb 2020,123,150,1001,92873577,5967522901,6060396478,337,969,9,5874649324,In > Out
Feb 2020,123,151,844,237554394,9875844404,10113398798,268,826,9,9638290010,In > Out
Feb 2020,123,152,1184,234841730,5764213992,5999055722,393,1151,3,5529372262,In > Out
Feb 2020,123,153,500,205971387,8687922339,8893893726,182,496,4,8481950952,In > Out
Feb 2020,123,154,395,43484273,1240033254,1283517527,194,387,7,1196548981,In > Out
Feb 2020,123,155,580,813039764,1780727569,2593767333,140,573,6,967687805,In > Out
Feb 2020,123,156,811,81416814,2798392968,2879809782,244,798,7,2716976154,In > Out
Feb 2020,123,157,608,53166593,1371424593,1424591186,173,605,3,1318258000,In > Out
Feb 2020,123,158,1054,106271605,2439750489,2546022094,260,1016,22,2333478884,In > Out
Feb 2020,123,159,1208,276924148,11884937982,12161862130,327,1181,7,11608013834,In > Out
Feb 2020,123,16,1814,232563067,7648005352,7880568419,358,1745,6,7415442285,In > Out
Feb 2020,123,163,802,166952862,5311933095,5478885957,262,788,8,5144980233,In > Out
Feb 2020,123,164,903,582643096,7424545181,8007188277,236,888,4,6841902085,In > Out
Feb 2020,123,166,1642,557613563,6849372015,7406985578,334,1564,10,6291758452,In > Out
Feb 2020,123,167,360,49504291,1735724148,1785228439,164,357,6,1686219857,In > Out
Feb 2020,123,168,708,114693880,2056168963,2170862843,297,691,5,1941475083,In > Out
Feb 2020,123,169,389,272301810,1661583112,1933884922,118,384,6,1389281302,In > Out
Feb 2020,123,17,4101,412967019,26033611505,26446578524,414,3971,7,25620644486,In > Out
Feb 2020,123,170,724,90444367,2130400142,2220844509,215,712,6,2039955775,In > Out
Feb 2020,123,171,720,57090235,1725624754,1782714989,193,715,4,1668534519,In > Out
Feb 2020,123,172,434,61016039,3869976004,3930992043,164,428,6,3808959965,In > Out
Feb 2020,123,173,515,184824414,3646269137,3831093551,185,514,6,3461444723,In > Out
Feb 2020,123,174,1191,1048892112,4079250109,5128142221,194,1161,8,3030357997,In > Out
Feb 2020,123,177,891,80766199,1244974834,1325741033,191,869,6,1164208635,In > Out
Feb 2020,123,178,996,86154100,1708189743,1794343843,196,987,7,1622035643,In > Out
Feb 2020,123,179,211,33325795,1835546792,1868872587,108,211,6,1802220997,In > Out
Feb 2020,123,180,374,35887219,956391995,992279214,148,372,5,920504776,In > Out
Feb 2020,123,183,632,67456218,2978857235,3046313453,173,628,5,2911401017,In > Out
Feb 2020,123,187,544,502765285,2688985405,3191750690,208,536,8,2186220120,In > Out
Feb 2020,123,189,780,136026444,5159378662,5295405106,228,770,4,5023352218,In > Out
Feb 2020,123,190,1367,351404066,23676087702,24027491768,310,1342,6,23324683636,In > Out
Feb 2020,123,191,965,323575239,2748010414,3071585653,254,931,14,2424435175,In > Out
Feb 2020,123,192,1128,120808248,2716713271,2837521519,182,1118,7,2595905023,In > Out
Feb 2020,123,197,840,198680634,8796758066,8995438700,186,818,4,8598077432,In > Out
Feb 2020,123,198,850,107352243,3269810887,3377163130,241,833,6,3162458644,In > Out
Feb 2020,123,199,423,71033716,2040785345,2111819061,154,420,5,1969751629,In > Out
Feb 2020,123,20,414,248276554,1959525717,2207802271,135,410,6,1711249163,In > Out
Feb 2020,123,200,289,49026306,4124498066,4173524372,122,289,5,4075471760,In > Out
Feb 2020,123,201,565,110304106,909608617,1019912723,162,565,7,799304511,In > Out
Feb 2020,123,203,864,259171316,3265964892,3525136208,257,840,31,3006793576,In > Out
Feb 2020,123,204,819,686494273,949712677,1636206950,285,797,10,263218404,In > Out
Feb 2020,123,206,534,221890649,4335780821,4557671470,202,520,15,4113890172,In > Out
Feb 2020,123,208,1796,886414807,6736003032,7622417839,547,1736,17,5849588225,In > Out
Feb 2020,123,21,215,53242269,1587372010,1640614279,87,214,7,1534129741,In > Out
Feb 2020,123,211,319,125400941,4223739639,4349140580,147,318,5,4098338698,In > Out
Feb 2020,123,212,1102,83001407,3404768866,3487770273,227,1086,5,3321767459,In > Out
Feb 2020,123,216,524,125693847,4688778036,4814471883,136,500,5,4563084189,In > Out
Feb 2020,123,217,752,901750245,3624538188,4526288433,206,737,10,2722787943,In > Out
Feb 2020,123,219,681,60087917,1820378050,1880465967,155,650,4,1760290133,In > Out
Feb 2020,123,22,292,64539354,1136387435,1200926789,150,291,8,1071848081,In > Out
Feb 2020,123,221,814,98121751,2112635806,2210757557,227,797,4,2014514055,In > Out
Feb 2020,123,222,761,534519615,3153471747,3687991362,290,748,17,2618952132,In > Out
Feb 2020,123,223,607,64558262,1934671068,1999229330,220,604,4,1870112806,In > Out
Feb 2020,123,23,294,50211360,1207282839,1257494199,151,292,5,1157071479,In > Out
Feb 2020,123,24,799,122934361,2086672556,2209606917,227,774,19,1963738195,In > Out
Feb 2020,123,25,322,27916677,649675244,677591921,108,321,7,621758567,In > Out
Feb 2020,123,27,1387,160281349,4853209245,5013490594,330,1352,9,4692927896,In > Out
Feb 2020,123,28,381,4322046644,13349712707,17671759351,121,377,6,9027666063,In > Out
Feb 2020,123,29,182,16538089,727967113,744505202,39,182,3,711429024,In > Out
Feb 2020,123,31,1106,1454518710,35291002924,36745521634,301,1092,15,33836484214,In > Out
Feb 2020,123,33,819,181251218,4289964324,4471215542,279,797,9,4108713106,In > Out
Feb 2020,123,35,758,112741459,3963261969,4076003428,216,747,22,3850520510,In > Out
Feb 2020,123,36,337,25916823,1022727430,1048644253,131,337,4,996810607,In > Out
Feb 2020,123,37,624,146032252,4679260970,4825293222,226,617,5,4533228718,In > Out
Feb 2020,123,38,775,395553093,9792125836,10187678929,267,771,3,9396572743,In > Out
Feb 2020,123,39,930,321441136,17634201060,17955642196,235,920,6,17312759924,In > Out
Feb 2020,123,4,664,126660166,3291924026,3418584192,258,652,7,3165263860,In > Out
Feb 2020,123,40,935,119035525,5570359469,5689394994,215,908,6,5451323944,In > Out
Feb 2020,123,41,512,42472962,888506065,930979027,96,497,3,846033103,In > Out
Feb 2020,123,42,660,73546227,2572828321,2646374548,221,649,10,2499282094,In > Out
Feb 2020,123,43,805,151118232,3074779325,3225897557,194,798,8,2923661093,In > Out
Feb 2020,123,45,296,50795347,1635262927,1686058274,148,292,7,1584467580,In > Out
Feb 2020,123,48,573,168546919,2085613446,2254160365,175,558,7,1917066527,In > Out
Feb 2020,123,5,371,65320399,3010125757,3075446156,170,368,4,2944805358,In > Out
Feb 2020,123,53,346,159955975,3096026574,3255982549,140,335,14,2936070599,In > Out
Feb 2020,123,54,369,84444217,746245200,830689417,119,368,5,661800983,In > Out
Feb 2020,123,55,243,22514808,504180606,526695414,77,238,3,481665798,In > Out
Feb 2020,123,56,286,107484676,892992506,1000477182,111,285,6,785507830,In > Out
Feb 2020,123,57,530,48509088,697034125,745543213,190,526,3,648525037,In > Out
Feb 2020,123,58,755,89698200,2109285347,2198983547,142,749,4,2019587147,In > Out
Feb 2020,123,59,1019,602615640,7528856874,8131472514,355,991,8,6926241234,In > Out
Feb 2020,123,60,429,60463518,1038897024,1099360542,193,426,5,978433506,In > Out
Feb 2020,123,61,879,128045451,6258906097,6386951548,222,862,5,6130860646,In > Out
Feb 2020,123,62,1176,213150648,3599742567,3812893215,301,1149,6,3386591919,In > Out
Feb 2020,123,63,165,18475803,239473054,257948857,81,165,3,220997251,In > Out
Feb 2020,123,64,751,251162840,2851610808,3102773648,233,739,4,2600447968,In > Out
Feb 2020,123,65,454,155406001,12269994935,12425400936,145,449,3,12114588934,In > Out
Feb 2020,123,66,538,67773096,2002806904,2070580000,246,531,4,1935033808,In > Out
Feb 2020,123,68,484,159474142,6557142653,6716616795,154,484,5,6397668511,In > Out
Feb 2020,123,70,542,148928132,6087022455,6235950587,217,533,3,5938094323,In > Out
Feb 2020,123,72,1870,243830229,5514124768,5757954997,486,1813,12,5270294539,In > Out
Feb 2020,123,74,1351,512939526,5453741739,5966681265,278,1317,5,4940802213,In > Out
Feb 2020,123,75,1020,397079703,2455186702,2852266405,228,1006,6,2058106999,In > Out
Feb 2020,123,77,973,642433310,11689866053,12332299363,296,943,8,11047432743,In > Out
Feb 2020,123,79,590,112655760,4970506568,5083162328,202,584,4,4857850808,In > Out
Feb 2020,123,81,1778,3536118766,141557545782,145093664548,352,1695,6,138021427016,In > Out
Feb 2020,123,82,972,76567164,1858928809,1935495973,195,934,5,1782361645,In > Out
Feb 2020,123,86,277,66668854,2503215515,2569884369,102,276,4,2436546661,In > Out
Feb 2020,123,87,1179,906027119,4717722916,5623750035,302,1153,9,3811695797,In > Out
Feb 2020,123,89,824,1483383762,2956900722,4440284484,248,806,5,1473516960,In > Out
Feb 2020,123,90,1275,114997659,2619118990,2734116649,337,1243,10,2504121331,In > Out
Feb 2020,123,92,1398,94665191,5377267185,5471932376,331,1369,3,5282601994,In > Out
Feb 2020,123,93,777,475057909,7237684153,7712742062,335,731,60,6762626244,In > Out
Feb 2020,123,94,470,264805426,5020750165,5285555591,120,465,5,4755944739,In > Out
Feb 2020,123,96,291,25324024,570501021,595825045,124,290,5,545176997,In > Out
Feb 2020,123,97,1107,190942802,2288182254,2479125056,209,1081,6,2097239452,In > Out
Feb 2020,123,98,503,115201197,1180575902,1295777099,169,499,7,1065374705,In > Out
Feb 2020,123,99,1179,556568703,4888811385,5445380088,173,1119,10,4332242682,In > Out
Feb 2020,124,10,220,8082878,370020269,378103147,42,220,2,361937391,In > Out
Feb 2020,124,100,943,594528400,1910508768,2505037168,179,918,15,1315980368,In > Out
Feb 2020,124,101,266,23199717,456336965,479536682,93,266,4,433137248,In > Out
Feb 2020,124,104,572,38532718,2332027747,2370560465,138,564,4,2293495029,In > Out
Feb 2020,124,105,678,193496560,9414796867,9608293427,120,665,7,9221300307,In > Out
Feb 2020,124,106,377,48989229,2073602852,2122592081,124,374,6,2024613623,In > Out
Feb 2020,124,108,697,140212946,4199607880,4339820826,261,693,11,4059394934,In > Out
Feb 2020,124,109,119,7197924,295047933,302245857,40,118,1,287850009,In > Out
Feb 2020,124,11,1236,211704847,4572130514,4783835361,238,1204,7,4360425667,In > Out
Feb 2020,124,110,491,52838082,1255362462,1308200544,146,481,5,1202524380,In > Out
Feb 2020,124,112,226,14041687,406647702,420689389,112,226,4,392606015,In > Out
Feb 2020,124,113,173,57468254,1586274488,1643742742,72,171,1,1528806234,In > Out
Feb 2020,124,115,923,79273124,4022958115,4102231239,240,907,4,3943684991,In > Out
Feb 2020,124,116,705,126911598,6741561466,6868473064,118,698,5,6614649868,In > Out
Feb 2020,124,117,579,149583729,10820531798,10970115527,172,573,4,10670948069,In > Out
Feb 2020,124,118,248,31124527,1314054055,1345178582,95,246,3,1282929528,In > Out
Feb 2020,124,120,667,736310276,822014704,1558324980,134,657,4,85704428,In > Out
Feb 2020,124,121,510,78127673,1013037017,1091164690,139,507,6,934909344,In > Out
Feb 2020,124,124,190,49619320,3428948105,3478567425,116,190,5,3379328785,In > Out
Feb 2020,124,125,173,16122478,159880623,176003101,53,173,3,143758145,In > Out
Feb 2020,124,126,226,36595512,1228667001,1265262513,87,226,5,1192071489,In > Out
Feb 2020,124,128,562,59489292,1611983059,1671472351,191,558,5,1552493767,In > Out
Feb 2020,124,129,799,259451233,3247456603,3506907836,165,789,5,2988005370,In > Out
Feb 2020,124,130,726,139604947,2868114199,3007719146,244,716,12,2728509252,In > Out
Feb 2020,124,131,386,67746330,1260560004,1328306334,128,379,4,1192813674,In > Out
Feb 2020,124,132,213,11980476,681820532,693801008,98,213,4,669840056,In > Out
Feb 2020,124,133,623,152201961,5006241201,5158443162,133,542,48,4854039240,In > Out
Feb 2020,124,134,510,103005491,2574892149,2677897640,107,506,5,2471886658,In > Out
Feb 2020,124,135,134,11103434,116115765,127219199,73,133,4,105012331,In > Out
Feb 2020,124,136,416,83222528,1188823616,1272046144,168,415,12,1105601088,In > Out
Feb 2020,124,137,208,22112472,796577682,818690154,108,208,3,774465210,In > Out
Feb 2020,124,138,1497,173783497,8368049912,8541833409,310,1444,3,8194266415,In > Out
Feb 2020,124,139,1043,110579534,2522589528,2633169062,162,1017,4,2412009994,In > Out
Feb 2020,124,14,383,33130845,461551537,494682382,92,383,6,428420692,In > Out
Feb 2020,124,140,226,211401871,1142984345,1354386216,86,223,8,931582474,In > Out
Feb 2020,124,141,1297,158727501,5110017233,5268744734,349,1252,8,4951289732,In > Out
Feb 2020,124,142,390,715090979,1219183369,1934274348,212,281,8,504092390,In > Out
Feb 2020,124,143,703,119832025,2116987735,2236819760,180,694,5,1997155710,In > Out
Feb 2020,124,144,271,27296003,1689651170,1716947173,62,271,2,1662355167,In > Out
Feb 2020,124,145,147,107074329,549267208,656341537,76,146,3,442192879,In > Out
Feb 2020,124,146,726,186485482,4199527377,4386012859,240,707,5,4013041895,In > Out
Feb 2020,124,147,633,174704069,780199500,954903569,156,624,10,605495431,In > Out
Feb 2020,124,148,1642,1969826668,5545323646,7515150314,271,1586,12,3575496978,In > Out
Feb 2020,124,149,587,258687352,6062588788,6321276140,178,578,6,5803901436,In > Out
Feb 2020,124,150,768,125579398,7376520120,7502099518,132,764,3,7250940722,In > Out
Feb 2020,124,151,538,146481864,4374357431,4520839295,168,529,5,4227875567,In > Out
Feb 2020,124,152,763,401627673,1652415897,2054043570,180,757,5,1250788224,In > Out
Feb 2020,124,153,974,580673352,3857825728,4438499080,224,932,7,3277152376,In > Out
Feb 2020,124,154,102,18278351,690133929,708412280,56,102,3,671855578,In > Out
Feb 2020,124,155,279,24748219,413151434,437899653,103,276,7,388403215,In > Out
Feb 2020,124,156,800,90112231,2526720794,2616833025,202,799,6,2436608563,In > Out
Feb 2020,124,157,658,310126554,1661903288,1972029842,193,649,7,1351776734,In > Out
Feb 2020,124,158,116,107915926,284307570,392223496,71,116,3,176391644,In > Out
Feb 2020,124,159,831,193926201,3753438177,3947364378,205,816,8,3559511976,In > Out
Feb 2020,124,16,618,95321840,709743141,805064981,251,608,11,614421301,In > Out
Feb 2020,124,160,942,74274408,1591230170,1665504578,296,906,7,1516955762,In > Out
Feb 2020,124,161,2077,186801540,3287385508,3474187048,285,1962,11,3100583968,In > Out
Feb 2020,124,162,527,75906723,2337883886,2413790609,120,523,4,2261977163,In > Out
Feb 2020,124,163,329,36236623,615581294,651817917,148,328,6,579344671,In > Out
Feb 2020,124,164,812,338350491,4935681243,5274031734,214,800,6,4597330752,In > Out
Feb 2020,124,165,531,53578765,1492973106,1546551871,147,528,7,1439394341,In > Out
Feb 2020,124,166,436,334837497,1050671781,1385509278,118,429,8,715834284,In > Out
Feb 2020,124,167,352,32859134,776290374,809149508,119,349,6,743431240,In > Out
Feb 2020,124,168,300,21142350,641477876,662620226,114,298,3,620335526,In > Out
Feb 2020,124,169,815,112524475,3729415052,3841939527,242,793,5,3616890577,In > Out
Feb 2020,124,17,1531,929387263,32421226901,33350614164,374,1459,6,31491839638,In > Out
Feb 2020,124,170,419,39346176,1343445278,1382791454,126,416,6,1304099102,In > Out
Feb 2020,124,171,762,445730675,21586822971,22032553646,161,751,5,21141092296,In > Out
Feb 2020,124,172,24,1542352,28010029,29552381,18,24,2,26467677,In > Out
Feb 2020,124,173,331,35256328,992275353,1027531681,119,329,2,957019025,In > Out
Feb 2020,124,174,1169,352899325,2139676588,2492575913,239,1156,9,1786777263,In > Out
Feb 2020,124,176,503,59420124,1014740807,1074160931,90,500,3,955320683,In > Out
Feb 2020,124,177,188,42293096,2285749549,2328042645,80,188,3,2243456453,In > Out
Feb 2020,124,178,595,744520412,1032315962,1776836374,123,587,3,287795550,In > Out
Feb 2020,124,179,487,218403793,1629121291,1847525084,184,482,7,1410717498,In > Out
Feb 2020,124,18,288,51196128,1186431880,1237628008,138,284,4,1135235752,In > Out
Feb 2020,124,181,233,28416663,698821662,727238325,120,233,2,670404999,In > Out
Feb 2020,124,182,776,118915138,4485153783,4604068921,272,757,5,4366238645,In > Out
Feb 2020,124,183,497,116881425,9904642849,10021524274,170,492,3,9787761424,In > Out
Feb 2020,124,184,2469,197089643,10168077375,10365167018,328,2351,5,9970987732,In > Out
Feb 2020,124,185,321,392699863,1177861151,1570561014,133,320,6,785161288,In > Out
Feb 2020,124,186,153,97301596,1936853997,2034155593,77,151,6,1839552401,In > Out
Feb 2020,124,187,431,195213339,1718572335,1913785674,135,426,8,1523358996,In > Out
Feb 2020,124,188,1150,217943086,5812150976,6030094062,450,1059,71,5594207890,In > Out
Feb 2020,124,189,894,196402957,3712239622,3908642579,259,872,7,3515836665,In > Out
Feb 2020,124,19,513,7181360604,11071405715,18252766319,129,402,25,3890045111,In > Out
Feb 2020,124,190,457,382039427,1729416185,2111455612,189,452,6,1347376758,In > Out
Feb 2020,124,191,1288,323693889,19912643676,20236337565,479,1200,22,19588949787,In > Out
Feb 2020,124,192,990,1138658031,57181298222,58319956253,308,974,4,56042640191,In > Out
Feb 2020,124,193,408,63766326,530052508,593818834,70,407,4,466286182,In > Out
Feb 2020,124,195,613,547983026,857257418,1405240444,163,602,5,309274392,In > Out
Feb 2020,124,197,1591,315425553,11896354318,12211779871,244,1572,4,11580928765,In > Out
Feb 2020,124,199,201,27286032,480930483,508216515,96,200,2,453644451,In > Out
Feb 2020,124,20,732,143112993,6299073494,6442186487,188,709,5,6155960501,In > Out
Feb 2020,124,200,320,42246920,1386781122,1429028042,102,315,4,1344534202,In > Out
Feb 2020,124,201,452,144339766,1428835168,1573174934,173,436,6,1284495402,In > Out
Feb 2020,124,202,645,107452858,2224700641,2332153499,123,642,6,2117247783,In > Out
Feb 2020,124,203,205,36260045,3473323390,3509583435,109,204,3,3437063345,In > Out
Feb 2020,124,204,1153,310196400,1863334300,2173530700,322,1121,9,1553137900,In > Out
Feb 2020,124,205,876,425750913,3260808812,3686559725,202,869,5,2835057899,In > Out
Feb 2020,124,206,97,12771050,306611682,319382732,49,97,4,293840632,In > Out
Feb 2020,124,207,998,201390303,6351889269,6553279572,304,993,18,6150498966,In > Out
Feb 2020,124,208,428,209918441,3079888338,3289806779,138,420,4,2869969897,In > Out
Feb 2020,124,21,273,190477176,2129203962,2319681138,134,271,5,1938726786,In > Out
Feb 2020,124,211,541,116589422,1641246282,1757835704,181,527,7,1524656860,In > Out
Feb 2020,124,212,505,23754557,767246822,791001379,128,498,4,743492265,In > Out
Feb 2020,124,213,884,178117084,3650486957,3828604041,293,861,26,3472369873,In > Out
Feb 2020,124,214,308,27275912,1035812328,1063088240,70,308,3,1008536416,In > Out
Feb 2020,124,215,205,44349027,1293713075,1338062102,84,205,7,1249364048,In > Out
Feb 2020,124,216,1101,471880727,8311709843,8783590570,254,1045,6,7839829116,In > Out
Feb 2020,124,219,592,101810146,3162335829,3264145975,177,582,7,3060525683,In > Out
Feb 2020,124,22,451,214260619,6941503901,7155764520,138,450,4,6727243282,In > Out
Feb 2020,124,221,318,35825043,2342890623,2378715666,118,313,3,2307065580,In > Out
Feb 2020,124,223,1241,619180209,15289425543,15908605752,412,1064,75,14670245334,In > Out
Feb 2020,124,23,20,1211411,6127859,7339270,15,20,1,4916448,In > Out
Feb 2020,124,24,3023,354264190,16983710085,17337974275,600,2851,11,16629445895,In > Out
Feb 2020,124,25,690,82729725,1054801092,1137530817,230,683,9,972071367,In > Out
Feb 2020,124,26,135,1970983796,1519561125,3490544921,58,132,9,451422671,Out > In
Feb 2020,124,27,255,392673327,709266225,1101939552,83,254,5,316592898,In > Out
Feb 2020,124,29,865,53511111,2326106379,2379617490,111,841,5,2272595268,In > Out
Feb 2020,124,32,388,61944705,2736286240,2798230945,172,383,4,2674341535,In > Out
Feb 2020,124,33,749,138016277,5835713161,5973729438,228,744,4,5697696884,In > Out
Feb 2020,124,35,764,348795359,5129792906,5478588265,213,745,17,4780997547,In > Out
Feb 2020,124,36,725,174787968,6427773388,6602561356,259,707,6,6252985420,In > Out
Feb 2020,124,37,1367,158741695,2359467282,2518208977,292,1308,4,2200725587,In > Out
Feb 2020,124,39,654,39846722,815310228,855156950,194,643,3,775463506,In > Out
Feb 2020,124,40,118,4906282,97387841,102294123,52,118,2,92481559,In > Out
Feb 2020,124,41,372,36570243,1092065056,1128635299,128,370,3,1055494813,In > Out
Feb 2020,124,43,891,235045076,12162008276,12397053352,207,874,5,11926963200,In > Out
Feb 2020,124,44,1622,1057788262,4137022721,5194810983,233,1578,6,3079234459,In > Out
Feb 2020,124,45,151,13884800,153823262,167708062,65,151,4,139938462,In > Out
Feb 2020,124,46,1139,263092039,10503709690,10766801729,239,1110,35,10240617651,In > Out
Feb 2020,124,48,286,52530437,723824360,776354797,98,284,5,671293923,In > Out
Feb 2020,124,5,684,95757954,3850965221,3946723175,209,675,3,3755207267,In > Out
Feb 2020,124,51,1045,252322368,4554713603,4807035971,223,1032,7,4302391235,In > Out
Feb 2020,124,52,588,467944749,1936664593,2404609342,212,584,5,1468719844,In > Out
Feb 2020,124,53,280,32699674,697263031,729962705,112,280,3,664563357,In > Out
Feb 2020,124,54,723,29903046,740957516,770860562,228,711,3,711054470,In > Out
Feb 2020,124,55,1876,937197304,4263177873,5200375177,173,1764,6,3325980569,In > Out
Feb 2020,124,56,852,119470332,4529643245,4649113577,212,842,7,4410172913,In > Out
Feb 2020,124,58,116,11239909,329547444,340787353,60,116,4,318307535,In > Out
Feb 2020,124,59,289,34704214,598777759,633481973,94,288,4,564073545,In > Out
Feb 2020,124,60,540,137431595,4352911991,4490343586,163,533,8,4215480396,In > Out
Feb 2020,124,64,150,26420781,399443765,425864546,50,149,3,373022984,In > Out
Feb 2020,124,65,2653,156020758,14401286449,14557307207,205,2620,4,14245265691,In > Out
Feb 2020,124,67,486,174188467,1957496906,2131685373,114,464,4,1783308439,In > Out
Feb 2020,124,68,255,31145561,416355172,447500733,122,254,5,385209611,In > Out
Feb 2020,124,69,865,204191682,3016981034,3221172716,140,858,7,2812789352,In > Out
Feb 2020,124,70,211,98849732,422691519,521541251,96,211,4,323841787,In > Out
Feb 2020,124,71,1676,180094899,4046739081,4226833980,383,1592,10,3866644182,In > Out
Feb 2020,124,73,356,42115478,906904444,949019922,109,350,3,864788966,In > Out
Feb 2020,124,74,280,122736657,984006085,1106742742,90,275,4,861269428,In > Out
Feb 2020,124,77,428,51454869,1846545225,1898000094,128,425,8,1795090356,In > Out
Feb 2020,124,78,345,113767298,3892176036,4005943334,109,340,3,3778408738,In > Out
Feb 2020,124,79,948,53748806,1197221343,1250970149,263,901,8,1143472537,In > Out
Feb 2020,124,8,473,226830681,5770183697,5997014378,220,468,3,5543353016,In > Out
Feb 2020,124,81,2491,282415303,12565014811,12847430114,478,2336,8,12282599508,In > Out
Feb 2020,124,82,300,16241194,624843443,641084637,89,299,3,608602249,In > Out
Feb 2020,124,83,278,33900530,592269630,626170160,90,277,6,558369100,In > Out
Feb 2020,124,85,843,98380393,5696061027,5794441420,151,823,4,5597680634,In > Out
Feb 2020,124,87,455,190926085,3412442563,3603368648,143,429,7,3221516478,In > Out
Feb 2020,124,9,345,31267132,741586997,772854129,118,336,3,710319865,In > Out
Feb 2020,124,91,509,56318987,4227402216,4283721203,136,509,8,4171083229,In > Out
Feb 2020,124,92,113,17602334,908790027,926392361,51,113,3,891187693,In > Out
Feb 2020,124,96,1199,1002876869,2164110202,3166987071,141,1156,10,1161233333,In > Out
Feb 2020,124,97,710,663784659,5337452996,6001237655,294,703,10,4673668337,In > Out
Feb 2020,124,98,957,170780304,7643336654,7814116958,196,952,4,7472556350,In > Out
Feb 2020,125,119,19,559475,11982902,12542377,15,19,2,11423427,In > Out
Feb 2020,125,134,44,6460826,1233149473,1239610299,21,44,2,1226688647,In > Out
Feb 2020,125,142,351,397144980,401270783,798415763,163,350,2,4125803,In > Out
Feb 2020,125,154,302,6126582,136641584,142768166,79,298,2,130515002,In > Out
Feb 2020,125,156,1123,75236747,2502849054,2578085801,236,1104,4,2427612307,In > Out
Feb 2020,125,160,251,9254755,165010425,174265180,113,240,2,155755670,In > Out
Feb 2020,125,162,756,84666628,3148777554,3233444182,190,736,3,3064110926,In > Out
Feb 2020,125,167,24,934974,37452437,38387411,9,24,2,36517463,In > Out
Feb 2020,125,170,86,3407103,209734424,213141527,14,85,2,206327321,In > Out
Feb 2020,125,174,98,7411551,296186911,303598462,35,98,2,288775360,In > Out
Feb 2020,125,178,2,28469,2630507,2658976,2,2,1,2602038,In > Out
Feb 2020,125,182,1305,2860328389,20343200904,23203529293,255,1287,4,17482872515,In > Out
Feb 2020,125,185,184,9405192,311413902,320819094,40,184,2,302008710,In > Out
Feb 2020,125,193,755,49511299,5584382839,5633894138,258,732,5,5534871540,In > Out
Feb 2020,125,194,1451,2393787914,172881222341,175275010255,736,360,658,170487434427,In > Out
Feb 2020,125,196,753,69288965,2128126113,2197415078,261,738,3,2058837148,In > Out
Feb 2020,125,201,1901,268559159,3265390838,3533949997,377,1767,4,2996831679,In > Out
Feb 2020,125,206,1252,2798573885,5626249298,8424823183,287,1225,2,2827675413,In > Out
Feb 2020,125,210,113,16325463,1976733057,1993058520,30,113,2,1960407594,In > Out
Feb 2020,125,39,2,101115,5580376,5681491,2,2,1,5479261,In > Out
Feb 2020,125,46,9,1054390,4726876,5781266,7,9,1,3672486,In > Out
Feb 2020,125,49,684,53552682,1674772513,1728325195,221,682,3,1621219831,In > Out
Feb 2020,125,52,770,32234166,1651966561,1684200727,251,759,4,1619732395,In > Out
Feb 2020,125,53,651,55086030,541725108,596811138,180,644,2,486639078,In > Out
Feb 2020,125,58,52,2804586,206265814,209070400,26,52,3,203461228,In > Out
Feb 2020,125,64,875,281728172,714859507,996587679,204,853,2,433131335,In > Out
Feb 2020,125,65,3,110972,5373239,5484211,3,3,2,5262267,In > Out
Feb 2020,125,66,139,20251443,145780561,166032004,75,137,2,125529118,In > Out
Feb 2020,125,69,289,22753732,429632431,452386163,109,286,2,406878699,In > Out
Feb 2020,126,14,1,11636,1367428,1379064,1,1,1,1355792,In > Out
Feb 2020,126,25,9,472116,85733567,86205683,4,9,2,85261451,In > Out
Feb 2020,126,26,1,568325,144235839,144804164,1,1,1,143667514,In > Out
Feb 2020,127,10,361,24450570,993713854,1018164424,148,360,4,969263284,In > Out
Feb 2020,127,100,391,53998029,1655238148,1709236177,160,378,5,1601240119,In > Out
Feb 2020,127,103,438,84683193,5154631117,5239314310,174,434,6,5069947924,In > Out
Feb 2020,127,105,495,41196499,2087388712,2128585211,224,489,4,2046192213,In > Out
Feb 2020,127,106,525,628774443,3810577758,4439352201,185,517,6,3181803315,In > Out
Feb 2020,127,109,146,12551674,586853563,599405237,73,146,3,574301889,In > Out
Feb 2020,127,11,2229,959164607,6869999766,7829164373,468,2153,11,5910835159,In > Out
Feb 2020,127,111,249,59227139,511983838,571210977,108,248,2,452756699,In > Out
Feb 2020,127,114,1787,183633636,3564235032,3747868668,379,1734,7,3380601396,In > Out
Feb 2020,127,117,516,79888504,1628051283,1707939787,178,513,2,1548162779,In > Out
Feb 2020,127,119,420,60100296,2037664194,2097764490,158,407,6,1977563898,In > Out
Feb 2020,127,121,828,125182513,4872921119,4998103632,172,825,2,4747738606,In > Out
Feb 2020,127,122,1681,407888507,48450945647,48858834154,339,1645,29,48043057140,In > Out
Feb 2020,127,123,578,63025644,1970817886,2033843530,196,571,5,1907792242,In > Out
Feb 2020,127,124,1291,272812244,8530163858,8802976102,261,1246,9,8257351614,In > Out
Feb 2020,127,126,740,775236333,4586525686,5361762019,150,721,5,3811289353,In > Out
Feb 2020,127,128,495,255468286,2864435739,3119904025,161,485,5,2608967453,In > Out
Feb 2020,127,129,1385,3267382775,11249246668,14516629443,237,1362,10,7981863893,In > Out
Feb 2020,127,13,1408,437218154,31052500570,31489718724,224,1367,11,30615282416,In > Out
Feb 2020,127,130,816,77862381,1945934434,2023796815,239,803,5,1868072053,In > Out
Feb 2020,127,131,428,55981329,1407262089,1463243418,170,424,6,1351280760,In > Out
Feb 2020,127,132,532,67584371,1593712222,1661296593,180,517,20,1526127851,In > Out
Feb 2020,127,133,998,151617223,8042988205,8194605428,270,971,7,7891370982,In > Out
Feb 2020,127,134,731,51840817,1999772795,2051613612,87,728,5,1947931978,In > Out
Feb 2020,127,135,1283,253936518,2624151534,2878088052,314,1232,24,2370215016,In > Out
Feb 2020,127,136,746,77439561,1317773776,1395213337,189,731,4,1240334215,In > Out
Feb 2020,127,137,1394,101455971,2945119702,3046575673,223,1344,5,2843663731,In > Out
Feb 2020,127,138,367,90467971,2957240851,3047708822,113,361,5,2866772880,In > Out
Feb 2020,127,139,503,82416438,871323760,953740198,210,500,4,788907322,In > Out
Feb 2020,127,14,286,918751611,4437712075,5356463686,81,285,10,3518960464,In > Out
Feb 2020,127,140,816,97100355,2159178486,2256278841,268,793,11,2062078131,In > Out
Feb 2020,127,141,430,281726963,8349179018,8630905981,136,429,4,8067452055,In > Out
Feb 2020,127,142,657,90446442,2083474272,2173920714,185,647,5,1993027830,In > Out
Feb 2020,127,143,1400,360153543,3442804006,3802957549,233,1387,15,3082650463,In > Out
Feb 2020,127,144,558,137024901,3875525335,4012550236,138,544,5,3738500434,In > Out
Feb 2020,127,145,192,25142699,961384642,986527341,50,192,3,936241943,In > Out
Feb 2020,127,146,765,212509216,2353879059,2566388275,305,737,23,2141369843,In > Out
Feb 2020,127,147,769,89468402,1702790613,1792259015,113,769,5,1613322211,In > Out
Feb 2020,127,148,269,84046945,1017235262,1101282207,100,264,6,933188317,In > Out
Feb 2020,127,149,685,111700637,1634689581,1746390218,254,675,7,1522988944,In > Out
Feb 2020,127,150,732,128349421,3100372691,3228722112,190,727,28,2972023270,In > Out
Feb 2020,127,151,928,829806178,2564209403,3394015581,284,918,8,1734403225,In > Out
Feb 2020,127,152,746,368195256,15480213873,15848409129,207,743,5,15112018617,In > Out
Feb 2020,127,154,474,635844280,449687978,1085532258,180,469,7,186156302,Out > In
Feb 2020,127,155,790,88690627,1584348842,1673039469,183,786,7,1495658215,In > Out
Feb 2020,127,156,163,29842458,482857374,512699832,70,160,5,453014916,In > Out
Feb 2020,127,157,516,98946290,685959315,784905605,123,490,4,587013025,In > Out
Feb 2020,127,158,314,4646782603,421663254,5068445857,108,310,5,4225119349,Out > In
Feb 2020,127,159,505,83081626,2543984409,2627066035,156,501,3,2460902783,In > Out
Feb 2020,127,160,777,161091728,5524149768,5685241496,119,771,3,5363058040,In > Out
Feb 2020,127,161,686,80401438,1024052024,1104453462,227,665,6,943650586,In > Out
Feb 2020,127,162,169,183234206,1539794936,1723029142,77,169,6,1356560730,In > Out
Feb 2020,127,163,672,156906784,3000323943,3157230727,269,662,8,2843417159,In > Out
Feb 2020,127,164,629,84987213,2866721882,2951709095,170,628,6,2781734669,In > Out
Feb 2020,127,165,132,8494612,202380647,210875259,42,131,5,193886035,In > Out
Feb 2020,127,166,782,566896885,2677045127,3243942012,233,764,9,2110148242,In > Out
Feb 2020,127,167,271,18896245,722121479,741017724,67,270,5,703225234,In > Out
Feb 2020,127,168,2273,732509440,5934043312,6666552752,199,2228,9,5201533872,In > Out
Feb 2020,127,169,449,232376040,2886061986,3118438026,191,442,3,2653685946,In > Out
Feb 2020,127,17,183,38913359,766252251,805165610,82,183,2,727338892,In > Out
Feb 2020,127,170,588,915262749,1557299703,2472562452,150,575,5,642036954,In > Out
Feb 2020,127,172,144,42936144,698704839,741640983,72,144,2,655768695,In > Out
Feb 2020,127,173,1420,199876776,2539318468,2739195244,418,1355,8,2339441692,In > Out
Feb 2020,127,174,712,2010370931,1017030432,3027401363,246,691,6,993340499,Out > In
Feb 2020,127,175,1511,1428916459,3773906954,5202823413,288,1435,20,2344990495,In > Out
Feb 2020,127,176,615,226357573,1296241751,1522599324,212,609,7,1069884178,In > Out
Feb 2020,127,177,1221,91937977,2268188884,2360126861,345,1178,8,2176250907,In > Out
Feb 2020,127,178,339,66423264,996651002,1063074266,117,336,5,930227738,In > Out
Feb 2020,127,179,676,44326112,596761643,641087755,112,674,3,552435531,In > Out
Feb 2020,127,180,1424,118387053,4805092027,4923479080,154,1403,22,4686704974,In > Out
Feb 2020,127,181,452,65459984,3233733600,3299193584,217,444,6,3168273616,In > Out
Feb 2020,127,182,452,54852676,2411281672,2466134348,139,441,3,2356428996,In > Out
Feb 2020,127,183,709,1300636308,2688791540,3989427848,211,693,4,1388155232,In > Out
Feb 2020,127,184,1081,549446760,2066730993,2616177753,194,1042,5,1517284233,In > Out
Feb 2020,127,185,2841,709854072,29737362028,30447216100,323,2666,6,29027507956,In > Out
Feb 2020,127,186,1373,54962942,5905918365,5960881307,163,1361,5,5850955423,In > Out
Feb 2020,127,187,684,265953872,2539849145,2805803017,112,667,7,2273895273,In > Out
Feb 2020,127,188,180,185192235,747511487,932703722,80,180,5,562319252,In > Out
Feb 2020,127,189,987,666878571,5430660287,6097538858,272,969,7,4763781716,In > Out
Feb 2020,127,190,783,557849102,5616480547,6174329649,205,769,4,5058631445,In > Out
Feb 2020,127,191,416,77094325,3712798896,3789893221,154,413,5,3635704571,In > Out
Feb 2020,127,192,636,68612810,1878741607,1947354417,163,629,4,1810128797,In > Out
Feb 2020,127,193,595,651528412,2545560413,3197088825,162,587,10,1894032001,In > Out
Feb 2020,127,194,487,122136680,4809995893,4932132573,173,486,3,4687859213,In > Out
Feb 2020,127,195,355,343745056,1110756704,1454501760,121,354,5,767011648,In > Out
Feb 2020,127,196,574,538330711,11583712250,12122042961,231,564,4,11045381539,In > Out
Feb 2020,127,197,816,99439824,1583545410,1682985234,244,799,8,1484105586,In > Out
Feb 2020,127,198,178,25584561,631460224,657044785,68,177,3,605875663,In > Out
Feb 2020,127,199,559,468268984,11264815031,11733084015,171,516,12,10796546047,In > Out
Feb 2020,127,200,623,357426057,4443081140,4800507197,187,606,16,4085655083,In > Out
Feb 2020,127,201,852,341991756,3028020151,3370011907,233,829,15,2686028395,In > Out
Feb 2020,127,202,136,3708487,65543869,69252356,34,136,3,61835382,In > Out
Feb 2020,127,203,510,216985822,1772974419,1989960241,208,509,8,1555988597,In > Out
Feb 2020,127,204,224,53212447,231255677,284468124,139,223,14,178043230,In > Out
Feb 2020,127,205,881,1324671786,5586769520,6911441306,284,872,7,4262097734,In > Out
Feb 2020,127,206,632,163737479,2997269007,3161006486,187,629,17,2833531528,In > Out
Feb 2020,127,207,2302,492085640,3834476655,4326562295,300,2205,8,3342391015,In > Out
Feb 2020,127,208,579,112195222,2362618112,2474813334,125,569,3,2250422890,In > Out
Feb 2020,127,209,239,18129162,737573621,755702783,95,239,5,719444459,In > Out
Feb 2020,127,21,454,105586859,7240523166,7346110025,191,451,4,7134936307,In > Out
Feb 2020,127,210,527,47203804,1220228474,1267432278,125,521,8,1173024670,In > Out
Feb 2020,127,211,345,54408157,490334271,544742428,95,344,6,435926114,In > Out
Feb 2020,127,212,422,46799574,1575400228,1622199802,105,420,5,1528600654,In > Out
Feb 2020,127,213,352,257989708,1225120681,1483110389,115,348,7,967130973,In > Out
Feb 2020,127,214,357,186827169,2416473648,2603300817,130,350,8,2229646479,In > Out
Feb 2020,127,215,540,50117427,1576648717,1626766144,154,527,5,1526531290,In > Out
Feb 2020,127,216,625,69702635,2293451506,2363154141,185,612,5,2223748871,In > Out
Feb 2020,127,217,1841,168966308,6141618753,6310585061,196,1778,8,5972652445,In > Out
Feb 2020,127,218,553,124918238,3733228583,3858146821,138,547,14,3608310345,In > Out
Feb 2020,127,219,707,229679054,2749529099,2979208153,164,682,5,2519850045,In > Out
Feb 2020,127,220,411,32576975,1007833450,1040410425,158,411,5,975256475,In > Out
Feb 2020,127,221,403,52650859,1046832675,1099483534,131,400,4,994181816,In > Out
Feb 2020,127,222,622,95168629,2431146207,2526314836,128,608,3,2335977578,In > Out
Feb 2020,127,223,556,474047006,5481076179,5955123185,236,493,25,5007029173,In > Out
Feb 2020,127,23,589,237016747,1383018047,1620034794,176,586,6,1146001300,In > Out
Feb 2020,127,24,486,118515439,1099174844,1217690283,119,483,4,980659405,In > Out
Feb 2020,127,26,259,105264894,3105768033,3211032927,105,258,5,3000503139,In > Out
Feb 2020,127,27,187,22015999,376113203,398129202,105,187,4,354097204,In > Out
Feb 2020,127,28,371,81781105,2187275829,2269056934,142,371,3,2105494724,In > Out
Feb 2020,127,29,489,214382926,873750686,1088133612,139,489,6,659367760,In > Out
Feb 2020,127,31,427,108833479,5171412681,5280246160,162,423,5,5062579202,In > Out
Feb 2020,127,32,1105,297758540,4946362225,5244120765,287,1073,6,4648603685,In > Out
Feb 2020,127,35,471,168326792,10206386645,10374713437,145,470,5,10038059853,In > Out
Feb 2020,127,36,337,27688660,1782230712,1809919372,124,328,7,1754542052,In > Out
Feb 2020,127,37,469,1570587859,4217953398,5788541257,133,463,6,2647365539,In > Out
Feb 2020,127,39,886,171935582,4423950150,4595885732,253,863,6,4252014568,In > Out
Feb 2020,127,40,775,107839238,2300693558,2408532796,290,766,4,2192854320,In > Out
Feb 2020,127,41,1127,329630696,6621502595,6951133291,342,1107,14,6291871899,In > Out
Feb 2020,127,42,361,79795503,2869228084,2949023587,128,357,6,2789432581,In > Out
Feb 2020,127,44,551,234202957,22202891853,22437094810,180,539,9,21968688896,In > Out
Feb 2020,127,45,290,40712732,1615483349,1656196081,112,288,4,1574770617,In > Out
Feb 2020,127,48,340,41855639,1725816477,1767672116,83,337,5,1683960838,In > Out
Feb 2020,127,5,1272,1152107447,6606435734,7758543181,302,1225,21,5454328287,In > Out
Feb 2020,127,50,186,31091114,995880111,1026971225,82,186,4,964788997,In > Out
Feb 2020,127,52,1945,124919547,4134432903,4259352450,179,1890,7,4009513356,In > Out
Feb 2020,127,54,439,44889317,7416980311,7461869628,156,432,3,7372090994,In > Out
Feb 2020,127,55,227,77771519,1089972730,1167744249,95,227,4,1012201211,In > Out
Feb 2020,127,56,515,106449162,3090092089,3196541251,120,511,4,2983642927,In > Out
Feb 2020,127,59,286,40343015,1729641569,1769984584,100,281,2,1689298554,In > Out
Feb 2020,127,62,859,310559189,1938731125,2249290314,149,837,8,1628171936,In > Out
Feb 2020,127,63,739,389654675,2815286393,3204941068,243,729,6,2425631718,In > Out
Feb 2020,127,64,812,923499978,6050463057,6973963035,166,801,6,5126963079,In > Out
Feb 2020,127,65,929,123095480,6831095115,6954190595,311,909,6,6707999635,In > Out
Feb 2020,127,66,293,27105614,2791078776,2818184390,114,292,2,2763973162,In > Out
Feb 2020,127,67,1122,389402111,28264435250,28653837361,308,1102,3,27875033139,In > Out
Feb 2020,127,7,1348,746999465,14408111688,15155111153,430,1303,13,13661112223,In > Out
Feb 2020,127,71,446,91185119,1817098314,1908283433,178,444,7,1725913195,In > Out
Feb 2020,127,73,608,653793166,2407387132,3061180298,193,601,8,1753593966,In > Out
Feb 2020,127,74,75,25189482,865901010,891090492,34,74,2,840711528,In > Out
Feb 2020,127,76,285,41932609,1549064565,1590997174,121,280,5,1507131956,In > Out
Feb 2020,127,77,540,114563900,3743101301,3857665201,203,536,4,3628537401,In > Out
Feb 2020,127,8,376,741117569,927229230,1668346799,126,374,5,186111661,In > Out
Feb 2020,127,80,685,173826748,3637064845,3810891593,177,672,4,3463238097,In > Out
Feb 2020,127,81,863,127973836,4754897179,4882871015,269,841,9,4626923343,In > Out
Feb 2020,127,82,1011,431008451,5966712051,6397720502,275,969,10,5535703600,In > Out
Feb 2020,127,83,1523,290552896,9234204439,9524757335,369,1457,6,8943651543,In > Out
Feb 2020,127,84,835,82613830,1905709178,1988323008,255,827,6,1823095348,In > Out
Feb 2020,127,88,546,169892490,9562605417,9732497907,196,542,5,9392712927,In > Out
Feb 2020,127,89,658,364686751,1419187218,1783873969,107,641,5,1054500467,In > Out
Feb 2020,127,90,920,224679982,3845108714,4069788696,216,912,11,3620428732,In > Out
Feb 2020,127,92,61,20102210,48140885,68243095,32,61,1,28038675,In > Out
Feb 2020,127,93,132,16492799,681813792,698306591,55,132,1,665320993,In > Out
Feb 2020,127,94,1220,562165007,7348801158,7910966165,288,1195,8,6786636151,In > Out
Feb 2020,127,95,175,17406570,649177721,666584291,72,175,4,631771151,In > Out
Feb 2020,127,98,147,11320329,139465329,150785658,75,147,3,128145000,In > Out
Feb 2020,127,99,1782,1385705938,4766092250,6151798188,312,1681,14,3380386312,In > Out
Feb 2020,128,101,640,120426753,2040714166,2161140919,173,638,5,1920287413,In > Out
Feb 2020,128,102,1225,244109931,6753512732,6997622663,260,1165,6,6509402801,In > Out
Feb 2020,128,103,798,146444901,6896105001,7042549902,284,787,11,6749660100,In > Out
Feb 2020,128,105,1296,331416092,9577828200,9909244292,399,1132,108,9246412108,In > Out
Feb 2020,128,107,690,157924416,4425094278,4583018694,205,681,5,4267169862,In > Out
Feb 2020,128,110,1061,95393555,2274251593,2369645148,186,1051,8,2178858038,In > Out
Feb 2020,128,111,960,65872413,2310787218,2376659631,206,941,5,2244914805,In > Out
Feb 2020,128,112,539,134682430,5901670931,6036353361,180,537,4,5766988501,In > Out
Feb 2020,128,116,292,116190993,2048795854,2164986847,155,289,6,1932604861,In > Out
Feb 2020,128,118,887,302893254,2989254721,3292147975,293,864,7,2686361467,In > Out
Feb 2020,128,12,581,331913714,4333144972,4665058686,259,576,7,4001231258,In > Out
Feb 2020,128,120,846,91942041,1845265338,1937207379,231,833,8,1753323297,In > Out
Feb 2020,128,121,876,425879685,7492372974,7918252659,214,855,10,7066493289,In > Out
Feb 2020,128,124,629,145249393,6064918903,6210168296,177,616,5,5919669510,In > Out
Feb 2020,128,125,856,3550399986,1855138569,5405538555,242,823,8,1695261417,Out > In
Feb 2020,128,126,203,57303410,751319007,808622417,82,202,8,694015597,In > Out
Feb 2020,128,127,1810,220809382,6982065654,7202875036,260,1741,9,6761256272,In > Out
Feb 2020,128,129,588,343183437,1779202427,2122385864,186,578,10,1436018990,In > Out
Feb 2020,128,13,596,80259214,3561884380,3642143594,202,580,4,3481625166,In > Out
Feb 2020,128,130,975,363464890,3537037007,3900501897,232,964,8,3173572117,In > Out
Feb 2020,128,132,627,65214363,5044422416,5109636779,234,624,6,4979208053,In > Out
Feb 2020,128,135,839,318250442,6688057826,7006308268,235,811,5,6369807384,In > Out
Feb 2020,128,138,667,47699252,1392157816,1439857068,215,659,6,1344458564,In > Out
Feb 2020,128,139,785,99549361,5940216294,6039765655,287,778,9,5840666933,In > Out
Feb 2020,128,14,464,56039858,1171624132,1227663990,166,458,5,1115584274,In > Out
Feb 2020,128,141,496,212847730,909758709,1122606439,107,488,10,696910979,In > Out
Feb 2020,128,142,795,73950494,1292851830,1366802324,211,780,8,1218901336,In > Out
Feb 2020,128,146,677,1450280887,1727847156,3178128043,269,658,9,277566269,In > Out
Feb 2020,128,147,1277,353582520,2992357327,3345939847,189,1262,10,2638774807,In > Out
Feb 2020,128,149,269,27486102,653751870,681237972,142,267,4,626265768,In > Out
Feb 2020,128,151,797,175774057,3669439777,3845213834,288,790,5,3493665720,In > Out
Feb 2020,128,152,313,35640393,1608351603,1643991996,116,312,3,1572711210,In > Out
Feb 2020,128,153,642,210096576,9202809197,9412905773,199,629,5,8992712621,In > Out
Feb 2020,128,154,333,85654295,2657506467,2743160762,121,328,2,2571852172,In > Out
Feb 2020,128,155,1263,117148575,3237315947,3354464522,211,1221,4,3120167372,In > Out
Feb 2020,128,156,548,281187265,3843964057,4125151322,229,541,8,3562776792,In > Out
Feb 2020,128,157,467,126596453,1357984851,1484581304,180,465,7,1231388398,In > Out
Feb 2020,128,158,885,273513877,2124859347,2398373224,249,873,4,1851345470,In > Out
Feb 2020,128,159,1009,7951229598,5828143210,13779372808,264,963,25,2123086388,Out > In
Feb 2020,128,16,334,203473958,1300599056,1504073014,151,333,12,1097125098,In > Out
Feb 2020,128,161,486,250316292,2154429868,2404746160,217,485,7,1904113576,In > Out
Feb 2020,128,162,702,319487771,6303927034,6623414805,265,696,7,5984439263,In > Out
Feb 2020,128,163,1801,767210080,5971895685,6739105765,492,1714,9,5204685605,In > Out
Feb 2020,128,164,1073,378848871,2616157163,2995006034,306,1047,7,2237308292,In > Out
Feb 2020,128,165,1221,481557450,11936660327,12418217777,311,1203,23,11455102877,In > Out
Feb 2020,128,171,628,149908025,3507964466,3657872491,193,620,3,3358056441,In > Out
Feb 2020,128,177,587,30360367,1447480176,1477840543,197,576,5,1417119809,In > Out
Feb 2020,128,178,1319,254549608,8809174267,9063723875,404,1276,6,8554624659,In > Out
Feb 2020,128,18,1208,94821534,2962124316,3056945850,220,1178,5,2867302782,In > Out
Feb 2020,128,181,638,62082521,1448228163,1510310684,195,630,2,1386145642,In > Out
Feb 2020,128,182,3151,920558413,6747357601,7667916014,452,3020,8,5826799188,In > Out
Feb 2020,128,186,1045,260948080,2858142419,3119090499,332,1031,7,2597194339,In > Out
Feb 2020,128,187,814,133185617,3571962512,3705148129,228,798,4,3438776895,In > Out
Feb 2020,128,189,241,23317391,547838734,571156125,101,241,4,524521343,In > Out
Feb 2020,128,19,604,356956322,6318437690,6675394012,207,597,7,5961481368,In > Out
Feb 2020,128,191,633,128206678,8340497023,8468703701,200,629,6,8212290345,In > Out
Feb 2020,128,192,880,503604107,2009829804,2513433911,284,860,5,1506225697,In > Out
Feb 2020,128,193,2043,242574731,22942226260,23184800991,452,1960,6,22699651529,In > Out
Feb 2020,128,194,549,84751928,4290697274,4375449202,222,539,7,4205945346,In > Out
Feb 2020,128,195,1117,505745147,2460239794,2965984941,325,1090,9,1954494647,In > Out
Feb 2020,128,197,394,96861381,1217477517,1314338898,127,392,2,1120616136,In > Out
Feb 2020,128,198,706,159570977,9623101867,9782672844,289,697,6,9463530890,In > Out
Feb 2020,128,199,871,102870529,3458199794,3561070323,282,860,4,3355329265,In > Out
Feb 2020,128,20,1297,265960504,6554138499,6820099003,378,1262,6,6288177995,In > Out
Feb 2020,128,200,1511,319014712,5358130114,5677144826,346,1470,8,5039115402,In > Out
Feb 2020,128,202,2694,345452025,12441933269,12787385294,405,2535,8,12096481244,In > Out
Feb 2020,128,204,1238,222475806,6297322151,6519797957,238,1154,5,6074846345,In > Out
Feb 2020,128,206,575,93542347,2414711405,2508253752,247,561,5,2321169058,In > Out
Feb 2020,128,207,1182,368813810,1774517503,2143331313,193,1157,7,1405703693,In > Out
Feb 2020,128,21,860,203055496,5803115773,6006171269,286,846,9,5600060277,In > Out
Feb 2020,128,210,360,44280327,484408945,528689272,145,355,3,440128618,In > Out
Feb 2020,128,211,1178,221818750,5874619856,6096438606,392,1156,19,5652801106,In > Out
Feb 2020,128,212,758,455254383,3546057599,4001311982,230,735,7,3090803216,In > Out
Feb 2020,128,214,657,178050912,4757380525,4935431437,213,647,6,4579329613,In > Out
Feb 2020,128,215,1268,956871563,8680182429,9637053992,375,1231,19,7723310866,In > Out
Feb 2020,128,216,716,96892038,3250922260,3347814298,165,709,7,3154030222,In > Out
Feb 2020,128,219,450,377187451,3652586965,4029774416,145,446,4,3275399514,In > Out
Feb 2020,128,22,479,106945444,4131830235,4238775679,152,470,6,4024884791,In > Out
Feb 2020,128,220,556,79936380,3621150703,3701087083,179,552,8,3541214323,In > Out
Feb 2020,128,223,1104,270327245,5023073550,5293400795,269,1066,7,4752746305,In > Out
Feb 2020,128,23,718,1590661070,2434358629,4025019699,269,706,22,843697559,In > Out
Feb 2020,128,25,1085,117219337,4534541954,4651761291,383,1052,8,4417322617,In > Out
Feb 2020,128,27,1836,426043263,6270211559,6696254822,493,1759,8,5844168296,In > Out
Feb 2020,128,29,2213,1013663619,7244506997,8258170616,332,2113,13,6230843378,In > Out
Feb 2020,128,31,864,690693197,2086004228,2776697425,211,843,15,1395311031,In > Out
Feb 2020,128,36,1059,313226099,2446556768,2759782867,284,1019,10,2133330669,In > Out
Feb 2020,128,37,1164,501135140,6641015838,7142150978,283,1120,7,6139880698,In > Out
Feb 2020,128,38,1027,136753265,6173129036,6309882301,246,1006,8,6036375771,In > Out
Feb 2020,128,4,1343,696276493,5823989267,6520265760,413,1296,29,5127712774,In > Out
Feb 2020,128,41,719,797763020,3281807611,4079570631,271,709,15,2484044591,In > Out
Feb 2020,128,44,860,191626383,2670447859,2862074242,185,845,4,2478821476,In > Out
Feb 2020,128,45,1191,87781772,1551699698,1639481470,286,1167,9,1463917926,In > Out
Feb 2020,128,46,1327,229369096,6978332045,7207701141,279,1311,11,6748962949,In > Out
Feb 2020,128,48,783,11446859153,6754100742,18200959895,271,767,18,4692758411,Out > In
Feb 2020,128,50,1077,101290077,4874532542,4975822619,318,969,90,4773242465,In > Out
Feb 2020,128,51,790,206961225,5936891427,6143852652,141,780,3,5729930202,In > Out
Feb 2020,128,54,637,186575920,2000295965,2186871885,195,629,6,1813720045,In > Out
Feb 2020,128,57,1352,84603452,2971459914,3056063366,217,1336,4,2886856462,In > Out
Feb 2020,128,60,876,100562990,3087463368,3188026358,181,859,6,2986900378,In > Out
Feb 2020,128,62,503,270020517,12870902622,13140923139,217,473,20,12600882105,In > Out
Feb 2020,128,63,606,131883477,757746332,889629809,97,598,3,625862855,In > Out
Feb 2020,128,65,912,364993953,7623691414,7988685367,386,902,5,7258697461,In > Out
Feb 2020,128,68,919,622312878,2078817431,2701130309,223,906,6,1456504553,In > Out
Feb 2020,128,69,843,136856554,4372916989,4509773543,218,830,8,4236060435,In > Out
Feb 2020,128,70,682,259085462,6891518110,7150603572,208,658,6,6632432648,In > Out
Feb 2020,128,71,640,51779117,1680700593,1732479710,160,635,4,1628921476,In > Out
Feb 2020,128,72,841,428784334,9848484048,10277268382,259,826,5,9419699714,In > Out
Feb 2020,128,76,474,49440691,1887913045,1937353736,187,467,5,1838472354,In > Out
Feb 2020,128,77,1053,437352058,7624192575,8061544633,305,1016,12,7186840517,In > Out
Feb 2020,128,79,1145,1053606034,24301763458,25355369492,303,1108,9,23248157424,In > Out
Feb 2020,128,8,1814,605865069,8019742142,8625607211,351,1709,8,7413877073,In > Out
Feb 2020,128,80,709,61720423,1185537237,1247257660,184,704,4,1123816814,In > Out
Feb 2020,128,84,2054,305026741,8264090965,8569117706,457,1960,6,7959064224,In > Out
Feb 2020,128,87,1492,1818492233,6584056812,8402549045,434,1458,12,4765564579,In > Out
Feb 2020,128,89,2388,475665224,22326442171,22802107395,479,2299,49,21850776947,In > Out
Feb 2020,128,94,817,133154556,2532383347,2665537903,241,806,12,2399228791,In > Out
Feb 2020,128,96,890,208477830,2166527332,2375005162,277,872,8,1958049502,In > Out
Feb 2020,128,99,550,38056967,1170771327,1208828294,143,548,4,1132714360,In > Out
Feb 2020,129,100,10,511716,4552338,5064054,2,10,1,4040622,In > Out
Feb 2020,129,105,30,1642439,53187575,54830014,26,30,1,51545136,In > Out
Feb 2020,129,107,155,9110322,134073813,143184135,89,155,2,124963491,In > Out
Feb 2020,129,108,6,391897,1655806,2047703,6,6,2,1263909,In > Out
Feb 2020,129,115,213,15965166,190083226,206048392,80,213,2,174118060,In > Out
Feb 2020,129,119,174,9884363,294855722,304740085,27,174,2,284971359,In > Out
Feb 2020,129,120,9,477149,13015405,13492554,6,9,1,12538256,In > Out
Feb 2020,129,123,434,9489788,68506069,77995857,6,434,2,59016281,In > Out
Feb 2020,129,126,115,5776982,76949539,82726521,53,113,2,71172557,In > Out
Feb 2020,129,127,66,16360075,20125630,36485705,1,66,1,3765555,In > Out
Feb 2020,129,130,33,1382370,11702568,13084938,22,33,2,10320198,In > Out
Feb 2020,129,134,113,42116867,128695183,170812050,60,113,2,86578316,In > Out
Feb 2020,129,135,218,7830616,216239134,224069750,87,211,2,208408518,In > Out
Feb 2020,129,137,158,8019803,91957891,99977694,79,156,2,83938088,In > Out
Feb 2020,129,14,10,540528,1015985,1556513,4,10,1,475457,In > Out
Feb 2020,129,140,410,727932149,966290689,1694222838,176,410,2,238358540,In > Out
Feb 2020,129,141,107,6041221,187013960,193055181,61,107,2,180972739,In > Out
Feb 2020,129,144,2,57766,1026815,1084581,2,2,2,969049,In > Out
Feb 2020,129,145,10,13991063,15086447,29077510,7,10,2,1095384,In > Out
Feb 2020,129,146,18,14866507,145412498,160279005,4,18,2,130545991,In > Out
Feb 2020,129,147,35,25554931,13619691,39174622,1,35,1,11935240,Out > In
Feb 2020,129,148,3,626955,612398,1239353,2,3,2,14557,Out > In
Feb 2020,129,153,3,670601,1433123,2103724,2,3,1,762522,In > Out
Feb 2020,129,154,263,13236470,294402438,307638908,135,261,2,281165968,In > Out
Feb 2020,129,155,7,1973534,75219,2048753,2,7,2,1898315,Out > In
Feb 2020,129,157,198,62917772,222774952,285692724,99,198,2,159857180,In > Out
Feb 2020,129,158,198,33373707,2177125863,2210499570,59,198,3,2143752156,In > Out
Feb 2020,129,16,455,39954437,617531666,657486103,170,452,4,577577229,In > Out
Feb 2020,129,166,4,697281,2271545,2968826,2,4,1,1574264,In > Out
Feb 2020,129,168,553,107925689,191594428,299520117,133,553,5,83668739,In > Out
Feb 2020,129,169,99,22388070,142309880,164697950,48,99,2,119921810,In > Out
Feb 2020,129,170,11,566048,5721518,6287566,8,11,2,5155470,In > Out
Feb 2020,129,171,35,1620432869,304649656,1925082525,18,35,3,1315783213,Out > In
Feb 2020,129,174,570,24613608,306393387,331006995,155,561,3,281779779,In > Out
Feb 2020,129,175,4,794406,5838131,6632537,2,4,1,5043725,In > Out
Feb 2020,129,176,214,18826992,142906109,161733101,99,213,2,124079117,In > Out
Feb 2020,129,177,708,106516357,1695138971,1801655328,193,689,2,1588622614,In > Out
Feb 2020,129,179,74,30771441,732064759,762836200,22,74,2,701293318,In > Out
Feb 2020,129,18,102,421239111,143097638,564336749,63,102,2,278141473,Out > In
Feb 2020,129,180,268,12786245,157957254,170743499,116,267,3,145171009,In > Out
Feb 2020,129,181,70,212018743,56735034,268753777,41,70,2,155283709,Out > In
Feb 2020,129,185,128,10398907,50229570,60628477,68,127,2,39830663,In > Out
Feb 2020,129,186,23,3558289,3221631,6779920,13,23,1,336658,Out > In
Feb 2020,129,187,96,6284738,46619051,52903789,41,96,1,40334313,In > Out
Feb 2020,129,188,333,30406368,650023039,680429407,105,331,3,619616671,In > Out
Feb 2020,129,191,3,908803,1268756,2177559,3,3,1,359953,In > Out
Feb 2020,129,192,22,2312560,30276314,32588874,13,22,2,27963754,In > Out
Feb 2020,129,193,442,53967890,695247774,749215664,126,438,2,641279884,In > Out
Feb 2020,129,194,57,2192335,114086137,116278472,17,57,2,111893802,In > Out
Feb 2020,129,196,57,9681710,30297755,39979465,24,57,2,20616045,In > Out
Feb 2020,129,199,6,121601,2354920,2476521,4,6,1,2233319,In > Out
Feb 2020,129,200,6,55770488,661576395,717346883,2,4,2,605805907,In > Out
Feb 2020,129,201,4,63323,1307037,1370360,2,4,1,1243714,In > Out
Feb 2020,129,202,4,1442095,2093872,3535967,3,4,1,651777,In > Out
Feb 2020,129,204,282,33484687,510526180,544010867,45,282,3,477041493,In > Out
Feb 2020,129,207,132,31341451,112512649,143854100,88,132,2,81171198,In > Out
Feb 2020,129,208,386,46205138,423138040,469343178,150,380,2,376932902,In > Out
Feb 2020,129,209,661,94119210,273451049,367570259,107,661,4,179331839,In > Out
Feb 2020,129,21,86,11276834717,1076180999,12353015716,1,86,1,10200653718,Out > In
Feb 2020,129,212,1033,288162986,7965631338,8253794324,90,999,2,7677468352,In > Out
Feb 2020,129,215,415,63992244,1018894673,1082886917,151,405,9,954902429,In > Out
Feb 2020,129,216,2,100226,1559398,1659624,2,2,1,1459172,In > Out
Feb 2020,129,218,6,219223,1922806,2142029,5,6,1,1703583,In > Out
Feb 2020,129,219,320,11500151,360877363,372377514,130,316,2,349377212,In > Out
Feb 2020,129,224,55,15932477,74805721,90738198,9,55,1,58873244,In > Out
Feb 2020,129,225,40,1764780,12037797,13802577,18,40,2,10273017,In > Out
Feb 2020,129,228,17,1951190,18236647,20187837,11,17,5,16285457,In > Out
Feb 2020,129,229,32,12650416,11319432,23969848,2,1,1,1330984,Out > In
Feb 2020,129,23,21,1157703,18589609,19747312,17,21,1,17431906,In > Out
Feb 2020,129,230,10,34328,4560769,4595097,1,10,10,4526441,In > Out
Feb 2020,129,234,2,133556,5429847,5563403,1,2,1,5296291,In > Out
Feb 2020,129,236,5,12954,1964881,1977835,3,5,1,1951927,In > Out
Feb 2020,129,237,7,88619,3041904,3130523,7,7,1,2953285,In > Out
Feb 2020,129,24,1,1699,118330,120029,1,1,1,116631,In > Out
Feb 2020,129,240,326,334894149,391683848,726577997,125,326,2,56789699,In > Out
Feb 2020,129,242,5,24896,754895,779791,4,5,1,729999,In > Out
Feb 2020,129,243,513,63316364,144631988,207948352,25,512,2,81315624,In > Out
Feb 2020,129,245,4,72401,734390,806791,2,4,1,661989,In > Out
Feb 2020,129,246,1,82079296,87350016,169429312,1,1,1,5270720,In > Out
Feb 2020,129,249,180,22994683,72244720,95239403,78,180,2,49250037,In > Out
Feb 2020,129,252,171,273846942,1215040322,1488887264,1,2,2,941193380,In > Out
Feb 2020,129,253,27,2676519,75966522,78643041,17,27,2,73290003,In > Out
Feb 2020,129,254,608,87616621,206893339,294509960,119,593,2,119276718,In > Out
Feb 2020,129,29,1523,384455616,21058210241,21442665857,213,1494,2,20673754625,In > Out
Feb 2020,129,30,21,1906576,6555174,8461750,16,21,2,4648598,In > Out
Feb 2020,129,31,175,14829877,964702967,979532844,56,173,3,949873090,In > Out
Feb 2020,129,33,2310,177646074,12929607496,13107253570,502,2198,4,12751961422,In > Out
Feb 2020,129,34,397,113311071,4855542500,4968853571,155,396,2,4742231429,In > Out
Feb 2020,129,36,17,473509,14087491,14561000,9,16,2,13613982,In > Out
Feb 2020,129,37,62,5647682,25254108,30901790,32,62,2,19606426,In > Out
Feb 2020,129,38,127,13357117,854351155,867708272,56,125,2,840994038,In > Out
Feb 2020,129,40,3,20498,958356,978854,3,3,2,937858,In > Out
Feb 2020,129,41,27,954347952,145430033,1099777985,11,27,2,808917919,Out > In
Feb 2020,129,44,164,19679206,1742899512,1762578718,44,164,2,1723220306,In > Out
Feb 2020,129,46,629,83395936,5624011371,5707407307,45,622,4,5540615435,In > Out
Feb 2020,129,47,1,15939872,22112896,38052768,1,1,1,6173024,In > Out
Feb 2020,129,51,3,7063,506311,513374,2,3,1,499248,In > Out
Feb 2020,129,54,25,2654843,26120094,28774937,13,25,2,23465251,In > Out
Feb 2020,129,57,238,8911952,1290521263,1299433215,59,236,2,1281609311,In > Out
Feb 2020,129,58,43,25567469,22706722,48274191,24,43,2,2860747,Out > In
Feb 2020,129,62,10,443425,13030915,13474340,9,10,2,12587490,In > Out
Feb 2020,129,63,282,23609467,465515824,489125291,138,278,3,441906357,In > Out
Feb 2020,129,68,19,2794901,6007165,8802066,16,19,2,3212264,In > Out
Feb 2020,129,69,15,19071909,12896876,31968785,1,15,1,6175033,Out > In
Feb 2020,129,70,78,11806194,82235261,94041455,41,78,1,70429067,In > Out
Feb 2020,129,71,240,14728724,331611995,346340719,64,240,2,316883271,In > Out
Feb 2020,129,72,1591,537489639,9139143152,9676632791,80,1521,3,8601653513,In > Out
Feb 2020,129,76,45,3061257,286697255,289758512,19,45,2,283635998,In > Out
Feb 2020,129,79,3012,6307792131,11253984283,17561776414,738,2824,10,4946192152,In > Out
Feb 2020,129,80,6,781863,1410957,2192820,4,6,1,629094,In > Out
Feb 2020,129,84,1,29032,969660,998692,1,1,1,940628,In > Out
Feb 2020,129,85,16,1201881,28567400,29769281,9,16,2,27365519,In > Out
Feb 2020,129,87,492,35845727,97900338,133746065,100,483,2,62054611,In > Out
Feb 2020,129,88,9,2371527,3112150,5483677,3,9,1,740623,In > Out
Feb 2020,129,89,1401,109245789,1831629842,1940875631,313,1344,2,1722384053,In > Out
Feb 2020,129,9,324,39114175,839603943,878718118,36,321,3,800489768,In > Out
Feb 2020,129,90,304,22475500,205149676,227625176,124,303,3,182674176,In > Out
Feb 2020,129,94,612,301497928,1361240243,1662738171,214,595,4,1059742315,In > Out
Feb 2020,129,95,115,16334021,133586117,149920138,32,115,2,117252096,In > Out
Feb 2020,129,96,7,288415,5683227,5971642,6,7,1,5394812,In > Out
Feb 2020,129,97,1177,121939109,2096727606,2218666715,255,1130,2,1974788497,In > Out
Feb 2020,129,98,3,418877,1174118,1592995,3,3,2,755241,In > Out
Feb 2020,13,16,8,353252,17533028,17886280,5,8,2,17179776,In > Out
Feb 2020,13,17,6,1140819,432670,1573489,3,6,1,708149,Out > In
Feb 2020,130,101,607,45688318,395562333,441250651,209,601,2,349874015,In > Out
Feb 2020,130,102,84,15793782,456267332,472061114,50,83,2,440473550,In > Out
Feb 2020,130,103,552,113480287,4654495379,4767975666,213,547,2,4541015092,In > Out
Feb 2020,130,104,456,52701295,255122504,307823799,216,449,2,202421209,In > Out
Feb 2020,130,105,187,24694499,1200951597,1225646096,29,187,3,1176257098,In > Out
Feb 2020,130,106,744,183305588,1656615197,1839920785,246,739,3,1473309609,In > Out
Feb 2020,130,107,176,12337974,116874471,129212445,100,175,3,104536497,In > Out
Feb 2020,130,108,428,83378768,1642880356,1726259124,156,423,2,1559501588,In > Out
Feb 2020,130,109,215,11785334,395475396,407260730,67,214,2,383690062,In > Out
Feb 2020,130,110,20,711002,21583421,22294423,14,20,2,20872419,In > Out
Feb 2020,130,112,203,10238362,402443009,412681371,81,203,2,392204647,In > Out
Feb 2020,130,113,520,36837334,1350539648,1387376982,118,513,2,1313702314,In > Out
Feb 2020,130,114,9,3777396,4119714,7897110,3,9,1,342318,In > Out
Feb 2020,130,115,323,23791719,199646470,223438189,130,316,2,175854751,In > Out
Feb 2020,130,116,336,5727490607,318211372,6045701979,126,333,2,5409279235,Out > In
Feb 2020,130,117,554,61786943,1239839451,1301626394,185,549,2,1178052508,In > Out
Feb 2020,130,118,171,12782325,127991734,140774059,74,170,2,115209409,In > Out
Feb 2020,130,119,5,363261,1121099,1484360,2,5,4,757838,In > Out
Feb 2020,130,120,115,19596283,147569487,167165770,59,115,3,127973204,In > Out
Feb 2020,130,121,247,26978977,280063723,307042700,33,243,2,253084746,In > Out
Feb 2020,130,122,363,9497421,557220446,566717867,125,357,2,547723025,In > Out
Feb 2020,130,123,26,1262056,49797947,51060003,14,26,2,48535891,In > Out
Feb 2020,130,124,154,39698080,301587121,341285201,56,154,4,261889041,In > Out
Feb 2020,130,127,171,20835659,482474861,503310520,50,168,2,461639202,In > Out
Feb 2020,130,128,1,12239,726041,738280,1,1,1,713802,In > Out
Feb 2020,130,135,519,36069889,366447889,402517778,163,514,3,330378000,In > Out
Feb 2020,130,138,645,41621872,1313810386,1355432258,187,638,2,1272188514,In > Out
Feb 2020,130,139,588,112651544,386202562,498854106,139,573,2,273551018,In > Out
Feb 2020,130,140,474,58418523,564053154,622471677,101,466,2,505634631,In > Out
Feb 2020,130,141,269,42534977,281399929,323934906,28,269,2,238864952,In > Out
Feb 2020,130,174,1018,131440545,368701834,500142379,213,982,5,237261289,In > Out
Feb 2020,130,190,26,1945813,9479767,11425580,11,26,2,7533954,In > Out
Feb 2020,130,29,1845,145770256,4274317011,4420087267,332,1764,3,4128546755,In > Out
Feb 2020,130,3,33,921905,13282486,14204391,17,33,2,12360581,In > Out
Feb 2020,130,51,569,40409513,1308528478,1348937991,208,563,2,1268118965,In > Out
Feb 2020,130,52,32,1414613,25592461,27007074,20,31,2,24177848,In > Out
Feb 2020,130,53,802,72248452,509210908,581459360,304,795,3,436962456,In > Out
Feb 2020,130,54,14,5829921,349842956,355672877,10,14,2,344013035,In > Out
Feb 2020,130,55,122,9423689,94613816,104037505,65,122,2,85190127,In > Out
Feb 2020,130,56,605,89249382,1694381233,1783630615,141,598,2,1605131851,In > Out
Feb 2020,130,57,10,37224,1625353,1662577,9,10,2,1588129,In > Out
Feb 2020,130,58,34,2932217,11000928,13933145,18,34,2,8068711,In > Out
Feb 2020,130,59,112,3728554,74983377,78711931,56,112,2,71254823,In > Out
Feb 2020,130,60,1,4707,183332,188039,1,1,1,178625,In > Out
Feb 2020,130,61,430,151110997,409462233,560573230,116,426,2,258351236,In > Out
Feb 2020,130,62,706,2171905965,794762750,2966668715,78,695,7,1377143215,Out > In
Feb 2020,130,63,357,28290609,497129406,525420015,171,350,4,468838797,In > Out
Feb 2020,130,64,264,45304789,374622224,419927013,91,262,4,329317435,In > Out
Feb 2020,130,65,2591,20553391,992954010,1013507401,130,2363,2,972400619,In > Out
Feb 2020,130,67,900,239189010,1031265177,1270454187,348,883,3,792076167,In > Out
Feb 2020,130,68,85,4396595,71301004,75697599,52,85,2,66904409,In > Out
Feb 2020,130,69,448,31064751,152953787,184018538,88,447,1,121889036,In > Out
Feb 2020,130,71,17,1155276,10695268,11850544,10,17,2,9539992,In > Out
Feb 2020,130,72,72,6810978,105130458,111941436,47,72,2,98319480,In > Out
Feb 2020,130,74,361,20372722,499892578,520265300,114,359,3,479519856,In > Out
Feb 2020,130,75,73,2301190,59835883,62137073,47,73,2,57534693,In > Out
Feb 2020,130,76,4,1180344,105198901,106379245,3,4,1,104018557,In > Out
Feb 2020,130,77,117,35573451,890898479,926471930,47,117,3,855325028,In > Out
Feb 2020,130,79,2176,250144757,3471242828,3721387585,454,2030,3,3221098071,In > Out
Feb 2020,130,81,386,58251799,183620452,241872251,132,381,3,125368653,In > Out
Feb 2020,130,82,678,11905169,455411727,467316896,125,664,3,443506558,In > Out
Feb 2020,130,86,1026,72569215,1715006776,1787575991,218,1002,2,1642437561,In > Out
Feb 2020,130,87,314,9353280,117208305,126561585,90,308,2,107855025,In > Out
Feb 2020,130,88,393,28755632,793819231,822574863,129,368,3,765063599,In > Out
Feb 2020,130,89,98,7769828,76080364,83850192,56,98,2,68310536,In > Out
Feb 2020,130,93,119,3141786,41992180,45133966,66,118,2,38850394,In > Out
Feb 2020,130,95,539,88195453,6153167078,6241362531,233,533,2,6064971625,In > Out
Feb 2020,130,96,48,8217560,28215561,36433121,29,48,2,19998001,In > Out
Feb 2020,130,97,28,1674519,44323925,45998444,20,28,3,42649406,In > Out
Feb 2020,131,100,414,115408656,1351473833,1466882489,138,412,6,1236065177,In > Out
Feb 2020,131,102,306,28251227,642115717,670366944,135,302,3,613864490,In > Out
Feb 2020,131,104,398,35135145,862259263,897394408,125,395,6,827124118,In > Out
Feb 2020,131,105,700,221610499,3849012569,4070623068,203,695,8,3627402070,In > Out
Feb 2020,131,108,678,1137578199,3242353533,4379931732,187,671,7,2104775334,In > Out
Feb 2020,131,110,1457,295840826,5472376322,5768217148,324,1410,10,5176535496,In > Out
Feb 2020,131,111,1413,107568851,2355022949,2462591800,260,1378,11,2247454098,In > Out
Feb 2020,131,112,1460,487665092,9414781992,9902447084,208,1408,8,8927116900,In > Out
Feb 2020,131,113,438,2316037615,1383715450,3699753065,166,434,6,932322165,Out > In
Feb 2020,131,114,1188,141646392,5730353403,5871999795,244,1159,13,5588707011,In > Out
Feb 2020,131,115,992,110386296,3851009610,3961395906,317,965,7,3740623314,In > Out
Feb 2020,131,118,1957,369971528,13326182208,13696153736,321,1898,9,12956210680,In > Out
Feb 2020,131,12,823,797389853,7668895734,8466285587,251,815,14,6871505881,In > Out
Feb 2020,131,121,324,1141088625,2410318080,3551406705,155,324,3,1269229455,In > Out
Feb 2020,131,122,241,53193107,2039272895,2092466002,109,239,3,1986079788,In > Out
Feb 2020,131,123,1001,126308616,1899805725,2026114341,287,977,4,1773497109,In > Out
Feb 2020,131,124,453,68652314,3555934220,3624586534,111,444,5,3487281906,In > Out
Feb 2020,131,125,765,33923274,777385429,811308703,193,756,6,743462155,In > Out
Feb 2020,131,127,375,75832219,4649862782,4725695001,97,363,5,4574030563,In > Out
Feb 2020,131,128,875,325846363,10332213420,10658059783,163,844,16,10006367057,In > Out
Feb 2020,131,129,1528,387776048,3997989248,4385765296,162,1466,9,3610213200,In > Out
Feb 2020,131,130,522,98156604,1703015622,1801172226,201,510,17,1604859018,In > Out
Feb 2020,131,131,2728,112654139,9527178641,9639832780,233,2663,6,9414524502,In > Out
Feb 2020,131,132,578,87756975,1576384666,1664141641,182,571,6,1488627691,In > Out
Feb 2020,131,133,920,185952999,5224206640,5410159639,274,908,12,5038253641,In > Out
Feb 2020,131,134,810,167540907,5824617425,5992158332,270,795,5,5657076518,In > Out
Feb 2020,131,136,396,40991215,486886868,527878083,153,387,12,445895653,In > Out
Feb 2020,131,137,139,10929702,259057611,269987313,46,139,4,248127909,In > Out
Feb 2020,131,138,1660,1172685216,10691812842,11864498058,549,1626,6,9519127626,In > Out
Feb 2020,131,139,590,56922044,1515438395,1572360439,188,585,7,1458516351,In > Out
Feb 2020,131,14,742,627934933,1886589359,2514524292,250,736,12,1258654426,In > Out
Feb 2020,131,140,1323,324245608,7226071360,7550316968,385,1272,6,6901825752,In > Out
Feb 2020,131,141,700,37458094,1366710883,1404168977,144,675,3,1329252789,In > Out
Feb 2020,131,142,563,47485602,1337553816,1385039418,204,549,4,1290068214,In > Out
Feb 2020,131,143,446,42673822,690166825,732840647,183,442,4,647493003,In > Out
Feb 2020,131,145,127,17609089,184152307,201761396,42,127,3,166543218,In > Out
Feb 2020,131,147,628,357370491,1918293426,2275663917,214,610,8,1560922935,In > Out
Feb 2020,131,150,524,89987563,3464796794,3554784357,159,522,12,3374809231,In > Out
Feb 2020,131,151,1064,104300410,1464038698,1568339108,238,1009,10,1359738288,In > Out
Feb 2020,131,152,890,1713296098,2690608354,4403904452,208,877,8,977312256,In > Out
Feb 2020,131,154,537,53069064,1509074873,1562143937,237,528,6,1456005809,In > Out
Feb 2020,131,155,160,8692351,278946796,287639147,61,159,3,270254445,In > Out
Feb 2020,131,156,1186,367614309,19660052835,20027667144,429,1154,4,19292438526,In > Out
Feb 2020,131,159,887,92730245,3112396423,3205126668,228,870,7,3019666178,In > Out
Feb 2020,131,162,538,137724709,5865102152,6002826861,210,535,7,5727377443,In > Out
Feb 2020,131,163,66,2171617,59097661,61269278,22,65,1,56926044,In > Out
Feb 2020,131,167,294,20733010,648013551,668746561,111,291,6,627280541,In > Out
Feb 2020,131,171,678,1794282613,3338742537,5133025150,283,663,9,1544459924,In > Out
Feb 2020,131,172,800,92777652,3932451700,4025229352,229,790,4,3839674048,In > Out
Feb 2020,131,175,414,252715576,18249415930,18502131506,166,410,3,17996700354,In > Out
Feb 2020,131,176,1379,366624020,4541155113,4907779133,208,1323,12,4174531093,In > Out
Feb 2020,131,177,424,974409184,6216814287,7191223471,169,423,6,5242405103,In > Out
Feb 2020,131,178,1429,331011214,11963838575,12294849789,328,1372,5,11632827361,In > Out
Feb 2020,131,179,550,168689797,1638486679,1807176476,204,546,6,1469796882,In > Out
Feb 2020,131,18,1375,725856111,6150787486,6876643597,347,1265,39,5424931375,In > Out
Feb 2020,131,180,829,263514242,11650459430,11913973672,171,815,4,11386945188,In > Out
Feb 2020,131,181,516,69304799,1342111701,1411416500,130,511,5,1272806902,In > Out
Feb 2020,131,183,200,32616436,1506644945,1539261381,85,197,4,1474028509,In > Out
Feb 2020,131,184,1255,170976218,6366839733,6537815951,240,1220,6,6195863515,In > Out
Feb 2020,131,185,736,313357157,4519123570,4832480727,177,724,8,4205766413,In > Out
Feb 2020,131,186,422,89473219,584156133,673629352,140,421,10,494682914,In > Out
Feb 2020,131,188,551,32237950,1196120129,1228358079,143,544,4,1163882179,In > Out
Feb 2020,131,189,375,265691882,2798599859,3064291741,129,371,6,2532907977,In > Out
Feb 2020,131,192,1146,248889883,15072926953,15321816836,335,1112,18,14824037070,In > Out
Feb 2020,131,193,422,471189533,4239305301,4710494834,149,419,8,3768115768,In > Out
Feb 2020,131,194,167,31555363,863278228,894833591,60,166,5,831722865,In > Out
Feb 2020,131,196,1122,469010578,7634446516,8103457094,289,1102,10,7165435938,In > Out
Feb 2020,131,197,850,290166209,5205853949,5496020158,327,842,25,4915687740,In > Out
Feb 2020,131,198,1868,245413444,10811928412,11057341856,286,1782,9,10566514968,In > Out
Feb 2020,131,199,309,24877160,783992022,808869182,117,308,3,759114862,In > Out
Feb 2020,131,20,1026,113827030,6420033628,6533860658,252,1000,5,6306206598,In > Out
Feb 2020,131,200,633,587759732,2325678092,2913437824,257,621,9,1737918360,In > Out
Feb 2020,131,201,659,1813113089,3769495066,5582608155,162,641,9,1956381977,In > Out
Feb 2020,131,203,726,108660197,3482287798,3590947995,260,717,12,3373627601,In > Out
Feb 2020,131,204,1045,374625066,1837122100,2211747166,213,1020,5,1462497034,In > Out
Feb 2020,131,205,740,289466733,11145626592,11435093325,232,721,9,10856159859,In > Out
Feb 2020,131,206,352,381026840,879599836,1260626676,68,352,6,498572996,In > Out
Feb 2020,131,207,480,58423311,937162590,995585901,156,478,6,878739279,In > Out
Feb 2020,131,208,1434,298258531,28188561339,28486819870,345,1400,5,27890302808,In > Out
Feb 2020,131,21,537,152302840,5124289771,5276592611,147,534,5,4971986931,In > Out
Feb 2020,131,210,633,243864832,3222427885,3466292717,169,631,4,2978563053,In > Out
Feb 2020,131,211,767,78469901,1670951145,1749421046,203,749,6,1592481244,In > Out
Feb 2020,131,212,1731,253891164,11464965000,11718856164,318,1675,11,11211073836,In > Out
Feb 2020,131,214,674,119196876,1998741055,2117937931,246,659,3,1879544179,In > Out
Feb 2020,131,216,709,1148935928,3086442612,4235378540,145,703,2,1937506684,In > Out
Feb 2020,131,217,1915,3175772755,4968523694,8144296449,300,1864,7,1792750939,In > Out
Feb 2020,131,218,171,570984678,477969018,1048953696,67,169,8,93015660,Out > In
Feb 2020,131,219,1088,4222705348,12637722883,16860428231,435,1063,9,8415017535,In > Out
Feb 2020,131,220,773,233666410,5212615763,5446282173,254,765,8,4978949353,In > Out
Feb 2020,131,222,865,6566672220,7892337212,14459009432,269,855,13,1325664992,In > Out
Feb 2020,131,23,633,465335020,2970645750,3435980770,201,624,20,2505310730,In > Out
Feb 2020,131,24,536,52161994,6432585197,6484747191,166,534,4,6380423203,In > Out
Feb 2020,131,27,261,46539435,1953847550,2000386985,132,260,3,1907308115,In > Out
Feb 2020,131,28,468,145483695,10288827127,10434310822,219,453,4,10143343432,In > Out
Feb 2020,131,29,355,102998376,3192769845,3295768221,94,353,4,3089771469,In > Out
Feb 2020,131,30,146,379204078,2341159995,2720364073,78,146,4,1961955917,In > Out
Feb 2020,131,32,456,74214416,2018671113,2092885529,171,452,4,1944456697,In > Out
Feb 2020,131,33,489,64642651,2782939329,2847581980,146,481,5,2718296678,In > Out
Feb 2020,131,34,576,361437276,475994833,837432109,224,570,7,114557557,In > Out
Feb 2020,131,35,970,242995512,7740384421,7983379933,215,961,5,7497388909,In > Out
Feb 2020,131,36,1054,239520022,13643277475,13882797497,278,1031,10,13403757453,In > Out
Feb 2020,131,37,1092,130651607,1357621121,1488272728,177,1083,6,1226969514,In > Out
Feb 2020,131,39,1613,249717318,10466948564,10716665882,251,1548,3,10217231246,In > Out
Feb 2020,131,40,431,198148490,5718198633,5916347123,155,429,5,5520050143,In > Out
Feb 2020,131,41,687,557069266,7087813184,7644882450,176,655,11,6530743918,In > Out
Feb 2020,131,42,856,95015316,3651609947,3746625263,219,849,6,3556594631,In > Out
Feb 2020,131,45,717,133739173,7057479997,7191219170,187,714,3,6923740824,In > Out
Feb 2020,131,46,552,491200473,4473802823,4965003296,165,549,6,3982602350,In > Out
Feb 2020,131,48,442,43746965,1080796015,1124542980,152,441,3,1037049050,In > Out
Feb 2020,131,49,958,232487804,4573953493,4806441297,201,926,4,4341465689,In > Out
Feb 2020,131,52,2194,462796550,33592673733,34055470283,377,2060,15,33129877183,In > Out
Feb 2020,131,53,1264,285418185,7767116008,8052534193,221,1240,8,7481697823,In > Out
Feb 2020,131,54,209,43239056,3147033232,3190272288,82,208,4,3103794176,In > Out
Feb 2020,131,55,381,47374236,1559160751,1606534987,125,373,5,1511786515,In > Out
Feb 2020,131,56,299,75921174,2278364213,2354285387,142,297,7,2202443039,In > Out
Feb 2020,131,57,1805,255745284,3970198968,4225944252,511,1758,7,3714453684,In > Out
Feb 2020,131,59,989,441048519,12462141314,12903189833,191,970,3,12021092795,In > Out
Feb 2020,131,61,968,1788525737,7600372813,9388898550,238,938,11,5811847076,In > Out
Feb 2020,131,62,1888,135280554,5802311261,5937591815,192,1865,9,5667030707,In > Out
Feb 2020,131,64,594,1867444086,6803218441,8670662527,243,583,6,4935774355,In > Out
Feb 2020,131,66,859,280400047,7005524787,7285924834,364,846,5,6725124740,In > Out
Feb 2020,131,67,1061,180289946,3374620524,3554910470,325,1010,42,3194330578,In > Out
Feb 2020,131,72,560,103638442,1338504203,1442142645,105,558,9,1234865761,In > Out
Feb 2020,131,73,1146,108594550,2977669653,3086264203,286,1109,8,2869075103,In > Out
Feb 2020,131,74,134,12716001,326947390,339663391,73,133,4,314231389,In > Out
Feb 2020,131,75,583,320839345,1149963723,1470803068,157,578,8,829124378,In > Out
Feb 2020,131,76,447,236318544,1089934911,1326253455,220,436,4,853616367,In > Out
Feb 2020,131,77,195,248352294,344191707,592544001,84,195,7,95839413,In > Out
Feb 2020,131,78,281,260852066,1364681640,1625533706,132,281,5,1103829574,In > Out
Feb 2020,131,79,891,251030368,11951654584,12202684952,221,873,15,11700624216,In > Out
Feb 2020,131,8,304,36636880,1264540491,1301177371,107,303,3,1227903611,In > Out
Feb 2020,131,83,315,78506767,3471969908,3550476675,89,311,4,3393463141,In > Out
Feb 2020,131,85,4942,435886460,10856540831,11292427291,3151,3072,1371,10420654371,In > Out
Feb 2020,131,86,738,113284092,2547219640,2660503732,204,732,7,2433935548,In > Out
Feb 2020,131,87,1110,151451452,3382562214,3534013666,312,1080,7,3231110762,In > Out
Feb 2020,131,90,1482,247351953,8860494635,9107846588,368,1449,5,8613142682,In > Out
Feb 2020,131,91,392,145702369,787250790,932953159,105,389,6,641548421,In > Out
Feb 2020,131,92,1360,681246354,3594496185,4275742539,242,1319,6,2913249831,In > Out
Feb 2020,131,94,423,45342231,1274338120,1319680351,145,420,3,1228995889,In > Out
Feb 2020,131,97,234,28107975,415882900,443990875,106,233,4,387774925,In > Out
Feb 2020,131,98,1286,477699726,4303343907,4781043633,375,1241,4,3825644181,In > Out
Feb 2020,132,10,1031,315041191,12536317630,12851358821,330,961,72,12221276439,In > Out
Feb 2020,132,100,1015,146410260,3224576652,3370986912,163,991,5,3078166392,In > Out
Feb 2020,132,101,233,14034715,611949977,625984692,75,233,4,597915262,In > Out
Feb 2020,132,102,460,44213775,1151723820,1195937595,95,458,4,1107510045,In > Out
Feb 2020,132,105,619,398031262,1886606746,2284638008,169,607,9,1488575484,In > Out
Feb 2020,132,106,552,1854332393,9040640307,10894972700,195,545,7,7186307914,In > Out
Feb 2020,132,108,160,12681919,365702831,378384750,67,160,4,353020912,In > Out
Feb 2020,132,11,611,59618410,1011934538,1071552948,155,605,6,952316128,In > Out
Feb 2020,132,110,509,33611979,829997686,863609665,123,508,4,796385707,In > Out
Feb 2020,132,112,253,713402148,195980563,909382711,58,252,3,517421585,Out > In
Feb 2020,132,113,213,55378352,3322287190,3377665542,87,213,2,3266908838,In > Out
Feb 2020,132,115,452,110751021,3502638294,3613389315,177,450,9,3391887273,In > Out
Feb 2020,132,116,492,376076872,1818624314,2194701186,159,486,6,1442547442,In > Out
Feb 2020,132,117,71,7798711,16924166,24722877,27,71,2,9125455,In > Out
Feb 2020,132,118,387,62619615,2686860680,2749480295,176,380,9,2624241065,In > Out
Feb 2020,132,119,460,128056286,1446538522,1574594808,190,460,5,1318482236,In > Out
Feb 2020,132,12,795,193920938,7425866705,7619787643,113,795,4,7231945767,In > Out
Feb 2020,132,120,423,15008161,728855785,743863946,104,419,2,713847624,In > Out
Feb 2020,132,121,774,442481626,3228709005,3671190631,186,752,10,2786227379,In > Out
Feb 2020,132,122,329,714533617,1189179995,1903713612,112,324,5,474646378,In > Out
Feb 2020,132,123,303,28388749,448097075,476485824,107,300,6,419708326,In > Out
Feb 2020,132,124,240,56065526,879716872,935782398,109,240,5,823651346,In > Out
Feb 2020,132,127,257,68642301,999070877,1067713178,84,253,6,930428576,In > Out
Feb 2020,132,128,341,49191895,2185996996,2235188891,121,338,6,2136805101,In > Out
Feb 2020,132,129,207,1498508826,951201092,2449709918,70,205,7,547307734,Out > In
Feb 2020,132,132,655,134345590,2929201453,3063547043,186,643,4,2794855863,In > Out
Feb 2020,132,134,467,301482739,1253127894,1554610633,132,464,4,951645155,In > Out
Feb 2020,132,135,424,105324827,5720430528,5825755355,144,421,9,5615105701,In > Out
Feb 2020,132,137,1188,160354598,4425887843,4586242441,273,1163,3,4265533245,In > Out
Feb 2020,132,139,1398,620108267,12815945574,13436053841,267,1334,13,12195837307,In > Out
Feb 2020,132,14,346,152568246,5846628999,5999197245,120,339,5,5694060753,In > Out
Feb 2020,132,140,891,170172393,4207811107,4377983500,303,857,7,4037638714,In > Out
Feb 2020,132,141,1455,436891789,1807239925,2244131714,223,1433,16,1370348136,In > Out
Feb 2020,132,142,552,259371424,1794664930,2054036354,182,540,6,1535293506,In > Out
Feb 2020,132,143,761,171764864,3281034670,3452799534,233,747,6,3109269806,In > Out
Feb 2020,132,145,262,20911261,567115735,588026996,94,260,4,546204474,In > Out
Feb 2020,132,147,415,84645462,2277387584,2362033046,120,415,5,2192742122,In > Out
Feb 2020,132,148,622,74160383,2348394861,2422555244,151,606,4,2274234478,In > Out
Feb 2020,132,150,156,46210752,259627279,305838031,69,155,5,213416527,In > Out
Feb 2020,132,151,350,26311419,1020640009,1046951428,111,347,2,994328590,In > Out
Feb 2020,132,152,487,81470927,1229847776,1311318703,173,483,10,1148376849,In > Out
Feb 2020,132,153,368,24984338,896203210,921187548,150,367,5,871218872,In > Out
Feb 2020,132,154,1217,161871704,15388542395,15550414099,315,1157,12,15226670691,In > Out
Feb 2020,132,155,999,3680535523,1888958063,5569493586,233,984,5,1791577460,Out > In
Feb 2020,132,157,626,407352285,5303248097,5710600382,224,621,8,4895895812,In > Out
Feb 2020,132,158,1055,176339157,3835879323,4012218480,277,1030,5,3659540166,In > Out
Feb 2020,132,162,636,215365287,4646711013,4862076300,275,619,6,4431345726,In > Out
Feb 2020,132,164,542,39410898,1401864904,1441275802,132,542,5,1362454006,In > Out
Feb 2020,132,165,616,47743175,1004066980,1051810155,187,614,4,956323805,In > Out
Feb 2020,132,166,379,41546371,1264640146,1306186517,128,378,6,1223093775,In > Out
Feb 2020,132,168,191,111574545,561505118,673079663,110,189,4,449930573,In > Out
Feb 2020,132,169,1023,420572493,29489624823,29910197316,349,1008,7,29069052330,In > Out
Feb 2020,132,17,349,36398398,892055198,928453596,127,346,5,855656800,In > Out
Feb 2020,132,170,1121,207610113,3263268727,3470878840,315,1096,27,3055658614,In > Out
Feb 2020,132,171,1108,151417314,5379295461,5530712775,226,1084,4,5227878147,In > Out
Feb 2020,132,172,473,95241430,1910806129,2006047559,177,471,4,1815564699,In > Out
Feb 2020,132,173,922,81838159,1694232532,1776070691,183,917,7,1612394373,In > Out
Feb 2020,132,174,680,185858798,7636247524,7822106322,231,672,5,7450388726,In > Out
Feb 2020,132,175,274,55797055,1035070464,1090867519,131,274,6,979273409,In > Out
Feb 2020,132,176,1380,101044559,2853804164,2954848723,225,1341,5,2752759605,In > Out
Feb 2020,132,178,740,88306759,1236954368,1325261127,164,738,6,1148647609,In > Out
Feb 2020,132,179,715,356684064,976739758,1333423822,165,701,7,620055694,In > Out
Feb 2020,132,18,527,129882953,4740839857,4870722810,140,527,8,4610956904,In > Out
Feb 2020,132,181,978,158779721,4926460067,5085239788,241,958,7,4767680346,In > Out
Feb 2020,132,182,441,42771567,976803753,1019575320,119,437,5,934032186,In > Out
Feb 2020,132,183,143,76785610,203915485,280701095,69,143,3,127129875,In > Out
Feb 2020,132,184,447,175914724,7390974560,7566889284,167,446,5,7215059836,In > Out
Feb 2020,132,185,502,561164582,2497238491,3058403073,174,498,8,1936073909,In > Out
Feb 2020,132,186,576,97106930,1183574741,1280681671,167,569,7,1086467811,In > Out
Feb 2020,132,187,1780,141654034,3206944125,3348598159,267,1680,26,3065290091,In > Out
Feb 2020,132,19,700,129123861,5307926081,5437049942,175,692,7,5178802220,In > Out
Feb 2020,132,190,966,106668725,3657292869,3763961594,187,963,5,3550624144,In > Out
Feb 2020,132,191,1274,352301825,6173051276,6525353101,239,1233,6,5820749451,In > Out
Feb 2020,132,193,191,12717486,252510472,265227958,70,191,5,239792986,In > Out
Feb 2020,132,194,986,213315619,2545310289,2758625908,229,975,11,2331994670,In > Out
Feb 2020,132,196,392,85973905,2917696364,3003670269,122,388,4,2831722459,In > Out
Feb 2020,132,197,1267,571414760,5511345311,6082760071,351,1222,14,4939930551,In > Out
Feb 2020,132,20,315,24991267,1604406339,1629397606,85,313,3,1579415072,In > Out
Feb 2020,132,200,1439,802042091,6088102401,6890144492,319,1401,19,5286060310,In > Out
Feb 2020,132,201,1407,529275609,4945975217,5475250826,266,1386,6,4416699608,In > Out
Feb 2020,132,202,1058,548017275,6538697635,7086714910,218,1016,6,5990680360,In > Out
Feb 2020,132,203,478,166227966,3113437118,3279665084,144,476,5,2947209152,In > Out
Feb 2020,132,204,1086,486027444,5744701866,6230729310,283,1022,29,5258674422,In > Out
Feb 2020,132,205,144,8394679,242272742,250667421,77,144,4,233878063,In > Out
Feb 2020,132,206,256,197518349,8058419900,8255938249,115,256,3,7860901551,In > Out
Feb 2020,132,21,441,268233508,1669429575,1937663083,109,433,31,1401196067,In > Out
Feb 2020,132,214,605,155767068,9053940378,9209707446,138,603,3,8898173310,In > Out
Feb 2020,132,215,683,108083348,2166247034,2274330382,167,671,6,2058163686,In > Out
Feb 2020,132,216,522,87581123,3387958013,3475539136,115,517,12,3300376890,In > Out
Feb 2020,132,219,1201,95286913,3865459460,3960746373,222,1183,3,3770172547,In > Out
Feb 2020,132,22,386,42490786,2606421671,2648912457,128,382,6,2563930885,In > Out
Feb 2020,132,220,903,209235827,2205765397,2415001224,253,882,30,1996529570,In > Out
Feb 2020,132,221,590,293090352,5032056488,5325146840,201,585,4,4738966136,In > Out
Feb 2020,132,222,1110,167466461,3437761568,3605228029,153,1104,7,3270295107,In > Out
Feb 2020,132,223,699,307360884,14236504823,14543865707,252,690,8,13929143939,In > Out
Feb 2020,132,23,738,97651119,1852228350,1949879469,207,725,9,1754577231,In > Out
Feb 2020,132,25,570,124493276,7146025687,7270518963,226,563,4,7021532411,In > Out
Feb 2020,132,26,246,701528214,10184381261,10885909475,120,244,6,9482853047,In > Out
Feb 2020,132,27,241,23299012,646257990,669557002,65,241,4,622958978,In > Out
Feb 2020,132,28,425,93721096,1895870758,1989591854,97,415,5,1802149662,In > Out
Feb 2020,132,29,1373,867841287,3584651146,4452492433,301,1328,19,2716809859,In > Out
Feb 2020,132,30,385,630147541,1553578013,2183725554,138,378,3,923430472,In > Out
Feb 2020,132,31,1802,254078836,6118413260,6372492096,357,1754,6,5864334424,In > Out
Feb 2020,132,32,738,604736329,4710423858,5315160187,321,721,6,4105687529,In > Out
Feb 2020,132,33,790,95218827,3710309500,3805528327,244,781,4,3615090673,In > Out
Feb 2020,132,34,648,474832617,4125541005,4600373622,115,632,7,3650708388,In > Out
Feb 2020,132,35,1128,1719431244,6541118089,8260549333,263,1089,8,4821686845,In > Out
Feb 2020,132,36,724,187358205,3628950109,3816308314,217,712,6,3441591904,In > Out
Feb 2020,132,4,894,76192984,1319917633,1396110617,244,874,5,1243724649,In > Out
Feb 2020,132,40,519,64061476,3113977210,3178038686,157,515,4,3049915734,In > Out
Feb 2020,132,41,226,1305273577,4010583146,5315856723,86,226,5,2705309569,In > Out
Feb 2020,132,42,700,751486802,3881258392,4632745194,183,690,4,3129771590,In > Out
Feb 2020,132,43,792,969098829,10420693055,11389791884,253,778,5,9451594226,In > Out
Feb 2020,132,44,487,37636831,771548483,809185314,153,478,4,733911652,In > Out
Feb 2020,132,46,384,34631660,933605350,968237010,107,381,3,898973690,In > Out
Feb 2020,132,48,697,130516153,1806081230,1936597383,205,679,13,1675565077,In > Out
Feb 2020,132,49,2003,596775792,22954118652,23550894444,334,1902,4,22357342860,In > Out
Feb 2020,132,5,472,79978601,3202910776,3282889377,143,467,2,3122932175,In > Out
Feb 2020,132,50,541,40791561,1255459985,1296251546,230,474,75,1214668424,In > Out
Feb 2020,132,51,983,422862288,17162902878,17585765166,282,979,4,16740040590,In > Out
Feb 2020,132,54,569,88296116,5542450983,5630747099,172,554,4,5454154867,In > Out
Feb 2020,132,55,341,88845479,3080339145,3169184624,141,338,3,2991493666,In > Out
Feb 2020,132,56,319,173624994,1489785937,1663410931,128,319,8,1316160943,In > Out
Feb 2020,132,57,326,32343465,610422757,642766222,156,321,7,578079292,In > Out
Feb 2020,132,58,531,141039031,6280505893,6421544924,133,523,3,6139466862,In > Out
Feb 2020,132,59,300,37158788,1017714265,1054873053,111,297,6,980555477,In > Out
Feb 2020,132,6,650,93509684,2995113305,3088622989,145,641,3,2901603621,In > Out
Feb 2020,132,60,1295,149768663,7562624844,7712393507,246,1239,6,7412856181,In > Out
Feb 2020,132,61,371,50884667,1876061506,1926946173,103,370,4,1825176839,In > Out
Feb 2020,132,62,540,24424467,367101899,391526366,157,535,9,342677432,In > Out
Feb 2020,132,63,382,77935524,3689180355,3767115879,155,376,10,3611244831,In > Out
Feb 2020,132,65,684,196958331,7860494506,8057452837,231,677,6,7663536175,In > Out
Feb 2020,132,66,742,243679978,6224302789,6467982767,271,732,6,5980622811,In > Out
Feb 2020,132,67,252,458358280,3095399334,3553757614,90,251,3,2637041054,In > Out
Feb 2020,132,68,497,126053673,9948348876,10074402549,159,496,4,9822295203,In > Out
Feb 2020,132,7,391,43210744,1688702173,1731912917,128,381,17,1645491429,In > Out
Feb 2020,132,70,898,207706534,4119650911,4327357445,297,883,8,3911944377,In > Out
Feb 2020,132,71,595,62893926,2210758374,2273652300,176,580,8,2147864448,In > Out
Feb 2020,132,72,257,54626344,1411762238,1466388582,93,255,4,1357135894,In > Out
Feb 2020,132,73,665,84346340,2684912545,2769258885,227,659,4,2600566205,In > Out
Feb 2020,132,74,555,110836710,1840440249,1951276959,117,550,6,1729603539,In > Out
Feb 2020,132,75,1450,522252941,6463652002,6985904943,344,1414,7,5941399061,In > Out
Feb 2020,132,76,162,18232713,251840461,270073174,91,161,5,233607748,In > Out
Feb 2020,132,77,153,15958908,237647079,253605987,54,153,5,221688171,In > Out
Feb 2020,132,78,474,96235972,1310964709,1407200681,175,464,5,1214728737,In > Out
Feb 2020,132,79,436,55865850,2218322961,2274188811,129,432,4,2162457111,In > Out
Feb 2020,132,80,573,3535622638,33474976289,37010598927,145,560,11,29939353651,In > Out
Feb 2020,132,82,559,104445050,1398023539,1502468589,182,554,12,1293578489,In > Out
Feb 2020,132,83,417,82563361,4191977475,4274540836,179,416,7,4109414114,In > Out
Feb 2020,132,85,708,125252222,2305137349,2430389571,251,693,5,2179885127,In > Out
Feb 2020,132,86,342,137962880,735966203,873929083,99,339,6,598003323,In > Out
Feb 2020,132,87,416,29205983,1281049226,1310255209,106,416,2,1251843243,In > Out
Feb 2020,132,88,186,80359636,598957312,679316948,91,185,4,518597676,In > Out
Feb 2020,132,89,553,160093705,524493175,684586880,161,552,9,364399470,In > Out
Feb 2020,132,9,163,3520185,59922067,63442252,74,163,6,56401882,In > Out
Feb 2020,132,93,342,34946407,1723121677,1758068084,146,339,4,1688175270,In > Out
Feb 2020,132,95,802,186397126,3451567172,3637964298,235,796,4,3265170046,In > Out
Feb 2020,132,96,1007,258183910,5422736331,5680920241,307,979,8,5164552421,In > Out
Feb 2020,132,97,1284,660243934,8052699985,8712943919,283,1247,17,7392456051,In > Out
Feb 2020,132,98,161,30706903,2265711115,2296418018,55,161,3,2235004212,In > Out
Feb 2020,132,99,562,704441099,1723941498,2428382597,194,559,4,1019500399,In > Out
Feb 2020,133,100,1000,147783378,9741913026,9889696404,288,945,4,9594129648,In > Out
Feb 2020,133,103,574,264291915,2402325629,2666617544,172,570,7,2138033714,In > Out
Feb 2020,133,104,952,396577135,7640111049,8036688184,282,924,7,7243533914,In > Out
Feb 2020,133,106,841,674684192,1918968412,2593652604,227,827,6,1244284220,In > Out
Feb 2020,133,107,785,194961595,5810634992,6005596587,240,771,12,5615673397,In > Out
Feb 2020,133,11,178,190309281,698092764,888402045,90,175,11,507783483,In > Out
Feb 2020,133,112,416,53744737,840785635,894530372,163,412,2,787040898,In > Out
Feb 2020,133,113,549,115930771,3149666994,3265597765,155,545,6,3033736223,In > Out
Feb 2020,133,114,656,492036560,2045700357,2537736917,144,644,14,1553663797,In > Out
Feb 2020,133,116,1382,150763750,3460409316,3611173066,381,1340,6,3309645566,In > Out
Feb 2020,133,118,397,204268122,2573165416,2777433538,124,396,3,2368897294,In > Out
Feb 2020,133,119,1481,347398940,3082147419,3429546359,299,1425,9,2734748479,In > Out
Feb 2020,133,120,479,64550005,1941931717,2006481722,164,465,5,1877381712,In > Out
Feb 2020,133,121,1107,308069078,10653285629,10961354707,337,1087,6,10345216551,In > Out
Feb 2020,133,123,632,147641977,5299369924,5447011901,256,627,6,5151727947,In > Out
Feb 2020,133,125,461,163787462,2777664357,2941451819,142,459,7,2613876895,In > Out
Feb 2020,133,126,1065,324426557,11029654244,11354080801,298,1052,23,10705227687,In > Out
Feb 2020,133,127,348,33347549,534268480,567616029,106,347,6,500920931,In > Out
Feb 2020,133,128,606,89293394,4955438912,5044732306,202,593,5,4866145518,In > Out
Feb 2020,133,129,1279,1479495432,6050730931,7530226363,255,1248,7,4571235499,In > Out
Feb 2020,133,130,604,431559883,1285624278,1717184161,157,594,17,854064395,In > Out
Feb 2020,133,131,899,526988784,4585120847,5112109631,215,885,8,4058132063,In > Out
Feb 2020,133,132,1397,340873964,5656590016,5997463980,330,1294,33,5315716052,In > Out
Feb 2020,133,135,688,482048508,5605807819,6087856327,246,678,6,5123759311,In > Out
Feb 2020,133,136,604,61889122,2496252412,2558141534,192,604,3,2434363290,In > Out
Feb 2020,133,137,518,179801428,7720578009,7900379437,214,513,4,7540776581,In > Out
Feb 2020,133,138,202,15044844,617759059,632803903,79,202,2,602714215,In > Out
Feb 2020,133,139,945,138919525,7618268199,7757187724,248,922,6,7479348674,In > Out
Feb 2020,133,14,1237,414423917,21106914094,21521338011,350,1211,7,20692490177,In > Out
Feb 2020,133,140,710,590571651,4339214037,4929785688,274,701,6,3748642386,In > Out
Feb 2020,133,141,631,215294590,655635911,870930501,231,621,8,440341321,In > Out
Feb 2020,133,142,1346,525260721,3125367839,3650628560,196,1316,14,2600107118,In > Out
Feb 2020,133,147,610,107764900,1453534907,1561299807,169,595,12,1345770007,In > Out
Feb 2020,133,149,647,684953515,2266180454,2951133969,214,633,3,1581226939,In > Out
Feb 2020,133,15,809,529148919,8449812789,8978961708,288,794,29,7920663870,In > Out
Feb 2020,133,150,448,39082006,1432391383,1471473389,102,444,6,1393309377,In > Out
Feb 2020,133,152,1171,2383673202,4542092260,6925765462,180,1140,17,2158419058,In > Out
Feb 2020,133,153,1106,215661287,4469424039,4685085326,353,1085,5,4253762752,In > Out
Feb 2020,133,155,931,410619287,2165020047,2575639334,227,917,10,1754400760,In > Out
Feb 2020,133,156,320,50244552,2016817765,2067062317,151,319,5,1966573213,In > Out
Feb 2020,133,157,118,1252948,25426598,26679546,9,118,1,24173650,In > Out
Feb 2020,133,159,1624,718322166,32028158403,32746480569,382,1578,18,31309836237,In > Out
Feb 2020,133,16,1229,1782830660,2441702939,4224533599,215,1198,11,658872279,In > Out
Feb 2020,133,160,702,193450286,1824854058,2018304344,182,690,10,1631403772,In > Out
Feb 2020,133,163,468,82121219,1256117894,1338239113,114,456,4,1173996675,In > Out
Feb 2020,133,164,1122,314138722,4655763253,4969901975,319,1097,5,4341624531,In > Out
Feb 2020,133,165,344,61634801,2490902767,2552537568,142,343,6,2429267966,In > Out
Feb 2020,133,168,843,97206110,3234155336,3331361446,209,826,7,3136949226,In > Out
Feb 2020,133,169,408,52375779,1856442671,1908818450,135,403,4,1804066892,In > Out
Feb 2020,133,17,348,37926966,1954092507,1992019473,125,344,3,1916165541,In > Out
Feb 2020,133,171,349,22783858,598611745,621395603,95,346,3,575827887,In > Out
Feb 2020,133,172,342,126143182,700771338,826914520,98,339,3,574628156,In > Out
Feb 2020,133,175,1381,107456261,3893759132,4001215393,351,1356,9,3786302871,In > Out
Feb 2020,133,176,1062,1176167584,6457256835,7633424419,352,1044,11,5281089251,In > Out
Feb 2020,133,177,1511,117728874,2993639588,3111368462,276,1484,11,2875910714,In > Out
Feb 2020,133,178,574,134633967,1269866019,1404499986,258,568,5,1135232052,In > Out
Feb 2020,133,179,658,1535435972,2118206278,3653642250,202,641,13,582770306,In > Out
Feb 2020,133,18,867,96574890,3779330768,3875905658,211,846,7,3682755878,In > Out
Feb 2020,133,183,578,77702745,2041948787,2119651532,139,569,7,1964246042,In > Out
Feb 2020,133,186,638,244223251,4760895248,5005118499,178,624,8,4516671997,In > Out
Feb 2020,133,188,733,137136624,3275705141,3412841765,211,729,6,3138568517,In > Out
Feb 2020,133,189,846,349253040,8924160438,9273413478,311,837,4,8574907398,In > Out
Feb 2020,133,19,1271,353872599,9338455379,9692327978,279,1233,9,8984582780,In > Out
Feb 2020,133,191,1192,143063390,2594829161,2737892551,321,1150,6,2451765771,In > Out
Feb 2020,133,192,745,252802998,2170257205,2423060203,247,737,10,1917454207,In > Out
Feb 2020,133,193,394,243731927,8401306345,8645038272,152,390,8,8157574418,In > Out
Feb 2020,133,194,1049,296714097,17279801868,17576515965,336,1039,6,16983087771,In > Out
Feb 2020,133,195,693,139267579,5405258271,5544525850,255,678,13,5265990692,In > Out
Feb 2020,133,198,900,257406630,2096904163,2354310793,216,885,6,1839497533,In > Out
Feb 2020,133,199,490,144176865,2175514966,2319691831,194,486,6,2031338101,In > Out
Feb 2020,133,201,554,116172317,3571145783,3687318100,188,546,3,3454973466,In > Out
Feb 2020,133,203,3097,1500341196,46064457068,47564798264,514,2897,5,44564115872,In > Out
Feb 2020,133,204,574,463738015,3892356174,4356094189,249,563,7,3428618159,In > Out
Feb 2020,133,206,479,85638332,1577307656,1662945988,167,475,5,1491669324,In > Out
Feb 2020,133,207,642,248769508,1988162269,2236931777,189,638,3,1739392761,In > Out
Feb 2020,133,208,460,207908492,11678855691,11886764183,182,455,13,11470947199,In > Out
Feb 2020,133,21,449,963030817,3142520769,4105551586,163,446,8,2179489952,In > Out
Feb 2020,133,211,744,266693923,5986556999,6253250922,225,730,10,5719863076,In > Out
Feb 2020,133,213,558,406033243,1609840838,2015874081,162,548,6,1203807595,In > Out
Feb 2020,133,215,509,346339895,2073091044,2419430939,161,504,7,1726751149,In > Out
Feb 2020,133,216,575,38812376,1041015385,1079827761,137,563,5,1002203009,In > Out
Feb 2020,133,217,171,222688793,275504316,498193109,86,171,6,52815523,In > Out
Feb 2020,133,218,1236,241563810,8163283068,8404846878,308,1205,17,7921719258,In > Out
Feb 2020,133,220,820,227409476,8612071875,8839481351,240,811,8,8384662399,In > Out
Feb 2020,133,221,858,115626771,6449203691,6564830462,290,847,17,6333576920,In > Out
Feb 2020,133,222,595,71854901,1703147855,1775002756,228,593,5,1631292954,In > Out
Feb 2020,133,223,330,127749728,1424751840,1552501568,133,328,4,1297002112,In > Out
Feb 2020,133,25,532,218513753,1726877151,1945390904,156,526,3,1508363398,In > Out
Feb 2020,133,26,288,86235726,514144341,600380067,139,288,14,427908615,In > Out
Feb 2020,133,27,558,199395651,2151590741,2350986392,206,556,4,1952195090,In > Out
Feb 2020,133,28,821,125817374,6367642969,6493460343,235,811,4,6241825595,In > Out
Feb 2020,133,30,2435,179290996,2982112377,3161403373,317,2289,10,2802821381,In > Out
Feb 2020,133,31,953,165246125,5048680436,5213926561,231,926,12,4883434311,In > Out
Feb 2020,133,32,210,22672548,301485547,324158095,106,210,4,278812999,In > Out
Feb 2020,133,33,1024,486150950,7269559235,7755710185,285,997,12,6783408285,In > Out
Feb 2020,133,36,729,73218283,1550406893,1623625176,219,719,4,1477188610,In > Out
Feb 2020,133,37,1528,1205225519,32433239715,33638465234,276,1497,6,31228014196,In > Out
Feb 2020,133,4,647,98097846,1976913169,2075011015,278,640,6,1878815323,In > Out
Feb 2020,133,40,661,73188355,1783814540,1857002895,278,657,7,1710626185,In > Out
Feb 2020,133,44,1279,460255948,3444862325,3905118273,401,1222,44,2984606377,In > Out
Feb 2020,133,45,614,206043271,3107330298,3313373569,188,609,5,2901287027,In > Out
Feb 2020,133,46,611,749672206,13224609598,13974281804,167,602,6,12474937392,In > Out
Feb 2020,133,47,281,1749733363,3711234669,5460968032,133,278,7,1961501306,In > Out
Feb 2020,133,48,1363,261433375,14127418719,14388852094,371,1320,6,13865985344,In > Out
Feb 2020,133,5,706,147437921,5906418399,6053856320,209,696,11,5758980478,In > Out
Feb 2020,133,54,287,37912227,1692363567,1730275794,128,280,3,1654451340,In > Out
Feb 2020,133,55,1053,318341316,9628456894,9946798210,284,1034,9,9310115578,In > Out
Feb 2020,133,56,742,509961749,2564013366,3073975115,206,726,10,2054051617,In > Out
Feb 2020,133,57,693,164261976,7547233854,7711495830,148,677,7,7382971878,In > Out
Feb 2020,133,59,1402,521971282,6213495571,6735466853,320,1362,14,5691524289,In > Out
Feb 2020,133,60,1146,318210911,4577989963,4896200874,298,1119,6,4259779052,In > Out
Feb 2020,133,61,483,137782563,5971392386,6109174949,153,479,7,5833609823,In > Out
Feb 2020,133,62,665,113810081,925734254,1039544335,182,653,4,811924173,In > Out
Feb 2020,133,63,1190,130369580,2974503509,3104873089,305,1162,9,2844133929,In > Out
Feb 2020,133,64,257,56626111,323186740,379812851,115,248,11,266560629,In > Out
Feb 2020,133,65,2521,118522725,2754265997,2872788722,257,2405,5,2635743272,In > Out
Feb 2020,133,69,321,373578920,4722506543,5096085463,166,316,10,4348927623,In > Out
Feb 2020,133,70,1160,528439685,17738126357,18266566042,296,1094,8,17209686672,In > Out
Feb 2020,133,74,640,53111527,1182512932,1235624459,122,636,5,1129401405,In > Out
Feb 2020,133,75,1123,48689188,2472002342,2520691530,161,1114,6,2423313154,In > Out
Feb 2020,133,77,1343,388786281,8580201005,8968987286,260,1298,5,8191414724,In > Out
Feb 2020,133,81,297,176396212,3848903052,4025299264,84,293,4,3672506840,In > Out
Feb 2020,133,84,1098,419576219,3771839385,4191415604,321,1080,6,3352263166,In > Out
Feb 2020,133,86,725,218955569,2182311345,2401266914,162,707,18,1963355776,In > Out
Feb 2020,133,87,254,16856093,523089864,539945957,98,252,4,506233771,In > Out
Feb 2020,133,92,211,104698044,2075499068,2180197112,88,211,2,1970801024,In > Out
Feb 2020,133,93,1843,371624201,4220646716,4592270917,240,1779,7,3849022515,In > Out
Feb 2020,133,95,604,98712033,3992416480,4091128513,219,596,7,3893704447,In > Out
Feb 2020,133,98,1284,767108790,2973455481,3740564271,247,1245,5,2206346691,In > Out
Feb 2020,134,102,1229,99132200,3613341704,3712473904,197,1198,4,3514209504,In > Out
Feb 2020,134,103,754,271305170,6077701432,6349006602,231,743,10,5806396262,In > Out
Feb 2020,134,105,731,1217308273,8476189958,9693498231,165,712,6,7258881685,In > Out
Feb 2020,134,107,709,88696513,2096884022,2185580535,148,704,7,2008187509,In > Out
Feb 2020,134,109,646,401014413,1454019740,1855034153,211,634,7,1053005327,In > Out
Feb 2020,134,11,895,812363379,64410247337,65222610716,232,894,4,63597883958,In > Out
Feb 2020,134,110,236,31206725,870119025,901325750,132,236,5,838912300,In > Out
Feb 2020,134,113,617,81056304,2269186089,2350242393,139,593,6,2188129785,In > Out
Feb 2020,134,114,540,202905741,10178405788,10381311529,166,527,4,9975500047,In > Out
Feb 2020,134,115,586,574750364,2124483775,2699234139,168,575,11,1549733411,In > Out
Feb 2020,134,116,439,231676054,8111315133,8342991187,165,431,6,7879639079,In > Out
Feb 2020,134,117,434,78332378,3158927227,3237259605,133,427,4,3080594849,In > Out
Feb 2020,134,12,1525,954511465,5506936582,6461448047,270,1449,5,4552425117,In > Out
Feb 2020,134,120,454,628899777,4056284153,4685183930,187,446,4,3427384376,In > Out
Feb 2020,134,121,2417,124213243,9617099324,9741312567,255,2365,3,9492886081,In > Out
Feb 2020,134,122,521,86145582,1967911635,2054057217,205,514,8,1881766053,In > Out
Feb 2020,134,123,693,576461036,1984398768,2560859804,131,687,7,1407937732,In > Out
Feb 2020,134,124,1182,539368062,19097393260,19636761322,334,1147,16,18558025198,In > Out
Feb 2020,134,125,201,24875551,794072010,818947561,107,200,5,769196459,In > Out
Feb 2020,134,126,673,144733836,2104562024,2249295860,164,659,5,1959828188,In > Out
Feb 2020,134,127,1314,185248737,2484855169,2670103906,428,1296,21,2299606432,In > Out
Feb 2020,134,128,1864,157831954,6263238245,6421070199,421,1760,8,6105406291,In > Out
Feb 2020,134,129,509,96922168,2737326453,2834248621,94,506,4,2640404285,In > Out
Feb 2020,134,13,546,622130661,1721507295,2343637956,177,528,6,1099376634,In > Out
Feb 2020,134,130,345,52954621,2657018892,2709973513,118,344,3,2604064271,In > Out
Feb 2020,134,131,637,875052748,28213722530,29088775278,226,621,15,27338669782,In > Out
Feb 2020,134,132,440,705874932,865659847,1571534779,177,433,4,159784915,In > Out
Feb 2020,134,133,585,44089218,2120330307,2164419525,220,584,8,2076241089,In > Out
Feb 2020,134,134,581,146709771,8807028033,8953737804,240,572,7,8660318262,In > Out
Feb 2020,134,135,340,146436154,5515484000,5661920154,83,338,3,5369047846,In > Out
Feb 2020,134,136,433,140367276,3416105412,3556472688,164,430,4,3275738136,In > Out
Feb 2020,134,137,412,193269692,990227951,1183497643,140,398,6,796958259,In > Out
Feb 2020,134,138,716,59961093,1416863105,1476824198,131,712,4,1356902012,In > Out
Feb 2020,134,139,368,77523457,2899962390,2977485847,165,368,5,2822438933,In > Out
Feb 2020,134,140,959,683562852,4540502391,5224065243,207,940,9,3856939539,In > Out
Feb 2020,134,141,1066,193752718,7095416390,7289169108,286,1052,7,6901663672,In > Out
Feb 2020,134,142,176,90137966,339979047,430117013,62,176,6,249841081,In > Out
Feb 2020,134,143,931,4066292220,3932680540,7998972760,267,914,7,133611680,Out > In
Feb 2020,134,144,264,357999994,8380209481,8738209475,99,262,7,8022209487,In > Out
Feb 2020,134,145,820,88488826,2520370575,2608859401,280,803,6,2431881749,In > Out
Feb 2020,134,146,203,151255793,8580198242,8731454035,97,200,5,8428942449,In > Out
Feb 2020,134,147,996,442712353,25985223025,26427935378,307,971,7,25542510672,In > Out
Feb 2020,134,150,1229,132963598,2190053473,2323017071,200,1190,5,2057089875,In > Out
Feb 2020,134,152,1116,180134481,3235189063,3415323544,293,1087,5,3055054582,In > Out
Feb 2020,134,153,691,282207437,3264500666,3546708103,252,679,8,2982293229,In > Out
Feb 2020,134,154,658,506152833,3111830612,3617983445,252,533,46,2605677779,In > Out
Feb 2020,134,155,311,29038859,527581909,556620768,121,310,4,498543050,In > Out
Feb 2020,134,156,1213,320954837,4853956717,5174911554,241,1193,9,4533001880,In > Out
Feb 2020,134,157,1023,185639660,2768651898,2954291558,218,1006,8,2583012238,In > Out
Feb 2020,134,158,623,225128373,1832068066,2057196439,261,617,12,1606939693,In > Out
Feb 2020,134,159,443,105277183,1234941057,1340218240,117,437,4,1129663874,In > Out
Feb 2020,134,162,606,1165422263,2438699450,3604121713,199,600,8,1273277187,In > Out
Feb 2020,134,163,819,128341183,1835730547,1964071730,279,807,8,1707389364,In > Out
Feb 2020,134,164,241,442903122,1544515296,1987418418,114,239,6,1101612174,In > Out
Feb 2020,134,167,2089,243624431,16661728173,16905352604,370,2012,4,16418103742,In > Out
Feb 2020,134,168,596,528886813,2849358302,3378245115,187,574,4,2320471489,In > Out
Feb 2020,134,171,843,197415581,7064519607,7261935188,155,842,5,6867104026,In > Out
Feb 2020,134,174,984,356556977,2546644422,2903201399,230,956,9,2190087445,In > Out
Feb 2020,134,175,1096,1752926999,6033927531,7786854530,302,1069,4,4281000532,In > Out
Feb 2020,134,176,2613,1389251817,11490587533,12879839350,656,2483,10,10101335716,In > Out
Feb 2020,134,178,571,1296608110,1571320679,2867928789,206,558,9,274712569,In > Out
Feb 2020,134,179,1290,102772611,2837114912,2939887523,234,1271,2,2734342301,In > Out
Feb 2020,134,180,1046,116075880,2342042676,2458118556,278,1015,4,2225966796,In > Out
Feb 2020,134,181,655,73404265,1580682516,1654086781,205,653,4,1507278251,In > Out
Feb 2020,134,182,396,1730524614,3205235020,4935759634,205,388,6,1474710406,In > Out
Feb 2020,134,185,1530,461077842,3923801419,4384879261,523,1422,96,3462723577,In > Out
Feb 2020,134,187,614,104868084,2404626242,2509494326,256,610,6,2299758158,In > Out
Feb 2020,134,188,1076,305911857,1883255923,2189167780,363,1046,6,1577344066,In > Out
Feb 2020,134,19,781,370332415,14266489774,14636822189,252,776,9,13896157359,In > Out
Feb 2020,134,190,709,85777184,3404223931,3490001115,211,700,6,3318446747,In > Out
Feb 2020,134,192,295,17372841,685560822,702933663,88,295,3,668187981,In > Out
Feb 2020,134,194,1105,8855824066,6677092372,15532916438,240,1068,11,2178731694,Out > In
Feb 2020,134,196,829,82404086,1937670923,2020075009,156,821,5,1855266837,In > Out
Feb 2020,134,198,444,239195452,3762830785,4002026237,147,439,4,3523635333,In > Out
Feb 2020,134,20,1510,135272080,4884302496,5019574576,261,1464,7,4749030416,In > Out
Feb 2020,134,201,818,218485339,1878178301,2096663640,199,801,5,1659692962,In > Out
Feb 2020,134,202,1658,100184210,3545594242,3645778452,230,1614,14,3445410032,In > Out
Feb 2020,134,204,683,587551118,2135323215,2722874333,186,672,18,1547772097,In > Out
Feb 2020,134,205,303,37457454,849305324,886762778,103,298,4,811847870,In > Out
Feb 2020,134,206,809,93882500,1296952233,1390834733,101,788,5,1203069733,In > Out
Feb 2020,134,209,379,44829795,1407114579,1451944374,164,376,4,1362284784,In > Out
Feb 2020,134,212,1133,135942387,4798576719,4934519106,241,1076,8,4662634332,In > Out
Feb 2020,134,213,409,145512782,5616761182,5762273964,206,406,8,5471248400,In > Out
Feb 2020,134,214,492,146603749,3323613532,3470217281,145,491,4,3177009783,In > Out
Feb 2020,134,215,277,2117201859,1107829490,3225031349,124,274,7,1009372369,Out > In
Feb 2020,134,216,718,110893075,3883544165,3994437240,202,698,3,3772651090,In > Out
Feb 2020,134,217,1561,191088071,4238124124,4429212195,225,1503,5,4047036053,In > Out
Feb 2020,134,218,249,58677485,2928294253,2986971738,113,249,6,2869616768,In > Out
Feb 2020,134,220,538,56524796,2068477982,2125002778,160,534,3,2011953186,In > Out
Feb 2020,134,222,2144,529676127,15330953408,15860629535,326,2060,40,14801277281,In > Out
Feb 2020,134,223,609,128407366,3413944643,3542352009,164,584,33,3285537277,In > Out
Feb 2020,134,23,1608,298116427,3576579618,3874696045,296,1563,20,3278463191,In > Out
Feb 2020,134,24,408,37393767,584369447,621763214,176,404,3,546975680,In > Out
Feb 2020,134,26,132,24206476,747224157,771430633,59,130,2,723017681,In > Out
Feb 2020,134,28,812,83500594,3977927397,4061427991,207,798,5,3894426803,In > Out
Feb 2020,134,29,501,101349530,3559808194,3661157724,167,496,13,3458458664,In > Out
Feb 2020,134,30,503,129303703,2011899681,2141203384,167,498,7,1882595978,In > Out
Feb 2020,134,32,853,95080722,1781451879,1876532601,256,837,10,1686371157,In > Out
Feb 2020,134,33,589,136415067,2392940374,2529355441,234,574,9,2256525307,In > Out
Feb 2020,134,34,457,117653356,478033505,595686861,207,454,4,360380149,In > Out
Feb 2020,134,38,121,7541493,166856693,174398186,51,121,1,159315200,In > Out
Feb 2020,134,39,435,96785790,1047965344,1144751134,99,435,5,951179554,In > Out
Feb 2020,134,4,557,77550634,2058984478,2136535112,194,546,5,1981433844,In > Out
Feb 2020,134,40,578,101432472,1784166879,1885599351,171,574,5,1682734407,In > Out
Feb 2020,134,42,1636,959174699,12673089683,13632264382,391,1556,23,11713914984,In > Out
Feb 2020,134,43,571,132981253,2636375182,2769356435,161,559,13,2503393929,In > Out
Feb 2020,134,44,562,52794422,1722055435,1774849857,135,552,2,1669261013,In > Out
Feb 2020,134,45,328,582434881,1266529861,1848964742,122,325,6,684094980,In > Out
Feb 2020,134,47,475,120937208,1333662751,1454599959,213,469,12,1212725543,In > Out
Feb 2020,134,48,406,41567393,1924417147,1965984540,84,404,5,1882849754,In > Out
Feb 2020,134,5,880,74638948,2993690140,3068329088,204,861,5,2919051192,In > Out
Feb 2020,134,50,1513,218563349,7067808973,7286372322,332,1454,5,6849245624,In > Out
Feb 2020,134,52,743,103085708,3314184992,3417270700,220,714,16,3211099284,In > Out
Feb 2020,134,53,735,1548188396,6000154989,7548343385,218,716,6,4451966593,In > Out
Feb 2020,134,54,505,235656526,4454612214,4690268740,224,493,5,4218955688,In > Out
Feb 2020,134,55,1072,228002287,3263743422,3491745709,212,1039,5,3035741135,In > Out
Feb 2020,134,56,415,178196990,1185728721,1363925711,185,406,19,1007531731,In > Out
Feb 2020,134,58,726,84516979,1080903539,1165420518,207,724,10,996386560,In > Out
Feb 2020,134,60,358,194211327,2043161497,2237372824,186,355,4,1848950170,In > Out
Feb 2020,134,61,319,201040515,1280204068,1481244583,85,316,3,1079163553,In > Out
Feb 2020,134,62,600,75962893,3073912693,3149875586,156,593,2,2997949800,In > Out
Feb 2020,134,63,418,72209502,3614904956,3687114458,114,418,6,3542695454,In > Out
Feb 2020,134,64,725,307835867,2395756193,2703592060,236,699,21,2087920326,In > Out
Feb 2020,134,66,681,940149511,5532675848,6472825359,161,668,6,4592526337,In > Out
Feb 2020,134,67,1371,215154201,5615807468,5830961669,191,1306,4,5400653267,In > Out
Feb 2020,134,69,720,3358081263,4513221840,7871303103,233,710,8,1155140577,In > Out
Feb 2020,134,7,357,138793621,5585796279,5724589900,148,355,4,5447002658,In > Out
Feb 2020,134,71,689,94782668,3266334631,3361117299,266,682,5,3171551963,In > Out
Feb 2020,134,72,318,28981060,891198013,920179073,126,315,5,862216953,In > Out
Feb 2020,134,73,1292,327790710,22943305572,23271096282,391,1258,8,22615514862,In > Out
Feb 2020,134,74,559,76517909,1215206849,1291724758,179,542,5,1138688940,In > Out
Feb 2020,134,75,995,461990850,3690193402,4152184252,295,967,10,3228202552,In > Out
Feb 2020,134,76,761,128427513,3640138009,3768565522,193,755,6,3511710496,In > Out
Feb 2020,134,77,1068,168909722,3512184912,3681094634,308,1032,26,3343275190,In > Out
Feb 2020,134,78,588,651920360,12102116453,12754036813,190,574,6,11450196093,In > Out
Feb 2020,134,80,420,115415062,4095588714,4211003776,140,419,5,3980173652,In > Out
Feb 2020,134,81,903,667560322,2857542352,3525102674,186,891,6,2189982030,In > Out
Feb 2020,134,82,627,977826704,18509273154,19487099858,202,606,12,17531446450,In > Out
Feb 2020,134,84,637,73181045,2165021719,2238202764,207,631,5,2091840674,In > Out
Feb 2020,134,86,859,572559068,2987985743,3560544811,170,847,6,2415426675,In > Out
Feb 2020,134,87,337,49506652,2921048604,2970555256,133,336,4,2871541952,In > Out
Feb 2020,134,88,889,164414772,4495247968,4659662740,261,873,3,4330833196,In > Out
Feb 2020,134,89,859,135451613,3374484400,3509936013,273,854,6,3239032787,In > Out
Feb 2020,134,90,987,385089327,16374154805,16759244132,267,967,8,15989065478,In > Out
Feb 2020,134,91,623,71965776,7437252493,7509218269,145,611,5,7365286717,In > Out
Feb 2020,134,92,284,37543300,1041815817,1079359117,85,284,4,1004272517,In > Out
Feb 2020,134,94,941,475022891,6509578760,6984601651,287,907,7,6034555869,In > Out
Feb 2020,134,95,987,249901486,2708201098,2958102584,262,959,4,2458299612,In > Out
Feb 2020,134,97,286,23260136,846383845,869643981,114,283,4,823123709,In > Out
Feb 2020,134,98,380,68930467,662700098,731630565,141,380,3,593769631,In > Out
Feb 2020,134,99,521,30249626,793963913,824213539,109,500,3,763714287,In > Out
Feb 2020,135,30,56,493174,15362891,15856065,6,56,2,14869717,In > Out
Feb 2020,135,66,10,12700,5753514,5766214,1,1,1,5740814,In > Out
Feb 2020,138,100,20,536333,30194475,30730808,3,20,1,29658142,In > Out
Feb 2020,138,133,386,11123281,375139135,386262416,78,386,2,364015854,In > Out
Feb 2020,138,25,20,775492,39186721,39962213,7,20,1,38411229,In > Out
Feb 2020,138,56,549,22158630,822426124,844584754,139,535,2,800267494,In > Out
Feb 2020,138,63,636,25669961,1616907896,1642577857,147,597,2,1591237935,In > Out
Feb 2020,138,67,424,12875947,859032403,871908350,89,412,2,846156456,In > Out
Feb 2020,14,111,43,426555,39400889,39827444,10,43,1,38974334,In > Out
Feb 2020,14,114,407,31585698,201131642,232717340,163,403,2,169545944,In > Out
Feb 2020,14,12,17,1500150,102276492,103776642,8,17,1,100776342,In > Out
Feb 2020,14,15,449,33316164,470898167,504214331,100,443,2,437582003,In > Out
Feb 2020,14,16,1562,118260591,3374589810,3492850401,191,1487,2,3256329219,In > Out
Feb 2020,14,18,45,5876155,114691626,120567781,24,45,2,108815471,In > Out
Feb 2020,14,20,15,63587,4495175,4558762,4,15,2,4431588,In > Out
Feb 2020,14,21,153,7957674,454491371,462449045,70,153,5,446533697,In > Out
Feb 2020,14,40,80,5736500,530455773,536192273,13,80,69,524719273,In > Out
Feb 2020,14,42,32,1190220,84139731,85329951,8,32,28,82949511,In > Out
Feb 2020,141,104,1018,311764082,1920955806,2232719888,120,1010,2,1609191724,In > Out
Feb 2020,141,106,107,21808768,1540014305,1561823073,55,107,2,1518205537,In > Out
Feb 2020,141,109,237,7181845,262526812,269708657,77,234,2,255344967,In > Out
Feb 2020,141,110,13,1448228,56177728,57625956,10,13,2,54729500,In > Out
Feb 2020,141,113,44,1639282,49208620,50847902,34,44,2,47569338,In > Out
Feb 2020,141,114,39,2925311,52365905,55291216,26,39,1,49440594,In > Out
Feb 2020,141,131,1,460870,21453558,21914428,1,1,1,20992688,In > Out
Feb 2020,141,132,366,10180296,506130700,516310996,56,360,2,495950404,In > Out
Feb 2020,141,133,6,85959,1518139,1604098,3,6,2,1432180,In > Out
Feb 2020,141,149,40,2958137,88724725,91682862,21,38,3,85766588,In > Out
Feb 2020,141,157,32,1021311,30271062,31292373,15,30,3,29249751,In > Out
Feb 2020,141,161,433,21166734,260740639,281907373,197,431,2,239573905,In > Out
Feb 2020,141,165,268,811662883,196024923,1007687806,130,266,3,615637960,Out > In
Feb 2020,141,172,241,13710612,292773069,306483681,133,241,3,279062457,In > Out
Feb 2020,141,174,14,268316,4258246,4526562,8,14,1,3989930,In > Out
Feb 2020,141,182,4,379663,14068230,14447893,4,4,1,13688567,In > Out
Feb 2020,141,184,79,6505071,21635574,28140645,28,79,1,15130503,In > Out
Feb 2020,141,194,202,4767387,389806064,394573451,19,202,2,385038677,In > Out
Feb 2020,141,195,148,11987059,346801788,358788847,96,148,2,334814729,In > Out
Feb 2020,141,204,70,9192007,118611844,127803851,43,68,2,109419837,In > Out
Feb 2020,141,210,46,3751751,21425022,25176773,9,46,2,17673271,In > Out
Feb 2020,141,213,728,40466515,352741907,393208422,195,722,2,312275392,In > Out
Feb 2020,141,220,28,4302204,300363332,304665536,11,28,1,296061128,In > Out
Feb 2020,141,25,71,5156288,55650443,60806731,38,71,2,50494155,In > Out
Feb 2020,141,28,503,25944989,634072546,660017535,206,498,4,608127557,In > Out
Feb 2020,141,36,6,649217,18528802,19178019,5,6,1,17879585,In > Out
Feb 2020,141,40,410,44372468,205941257,250313725,122,406,2,161568789,In > Out
Feb 2020,141,53,274,24118700,716928841,741047541,84,274,2,692810141,In > Out
Feb 2020,141,68,1,10177,238513,248690,1,1,1,228336,In > Out
Feb 2020,141,74,163,14789183,467818522,482607705,95,163,2,453029339,In > Out
Feb 2020,141,81,64,11770354,55715572,67485926,38,64,2,43945218,In > Out
Feb 2020,141,84,92,2322435,110499052,112821487,28,92,2,108176617,In > Out
Feb 2020,141,85,455,50424125,459719990,510144115,195,425,5,409295865,In > Out
Feb 2020,141,88,827,2761400386,1210054103,3971454489,353,797,2,1551346283,Out > In
Feb 2020,141,91,144,3294786,225593224,228888010,16,140,2,222298438,In > Out
Feb 2020,141,96,228,16068367,269985496,286053863,95,226,3,253917129,In > Out
Feb 2020,141,98,2,176767,6914620,7091387,2,2,1,6737853,In > Out
Feb 2020,142,11,9,1025459,28680863,29706322,5,9,1,27655404,In > Out
Feb 2020,142,121,1,1337701,551200497,552538198,1,1,1,549862796,In > Out
Feb 2020,142,13,12,1915569,120373670,122289239,7,12,1,118458101,In > Out
Feb 2020,142,16,10,821483,204431619,205253102,3,10,2,203610136,In > Out
Feb 2020,142,17,309,1354764,55972776,57327540,2,1,294,54618012,In > Out
Feb 2020,142,18,4,751485,58882000,59633485,3,4,1,58130515,In > Out
Feb 2020,142,19,7,808941,91046430,91855371,5,7,2,90237489,In > Out
Feb 2020,142,21,4,232972,34204502,34437474,4,4,2,33971530,In > Out
Feb 2020,142,22,710,1364794,105022671,106387465,2,2,704,103657877,In > Out
Feb 2020,142,24,2,359654,95338027,95697681,2,2,2,94978373,In > Out
Feb 2020,142,27,8,495208,113003996,113499204,3,8,2,112508788,In > Out
Feb 2020,142,32,13,1497833,153579968,155077801,3,13,2,152082135,In > Out
Feb 2020,142,35,14,2020238,63161682,65181920,6,14,1,61141444,In > Out
Feb 2020,142,36,34,12592783,44920390,57513173,14,34,26,32327607,In > Out
Feb 2020,142,4,13,2315393,58613525,60928918,7,13,1,56298132,In > Out
Feb 2020,142,41,10,1008389,27969472,28977861,6,10,1,26961083,In > Out
Feb 2020,142,46,8,1278059,39561264,40839323,6,8,1,38283205,In > Out
Feb 2020,142,47,9,1489244,34439185,35928429,5,9,1,32949941,In > Out
Feb 2020,142,5,7,911452,26322638,27234090,3,7,1,25411186,In > Out
Feb 2020,142,50,16,1330783129836,8781839637,1339564969473,3,16,3,1322001290199,Out > In
Feb 2020,142,54,50,87382823,1690240,89073063,15,50,50,85692583,Out > In
Feb 2020,142,55,20,911326,147414535,148325861,4,20,2,146503209,In > Out
Feb 2020,142,56,379,87270052,1287912,88557964,1,379,374,85982140,Out > In
Feb 2020,142,57,753,239381198,7621988,247003186,10,746,733,231759210,Out > In
Feb 2020,142,58,463,286662210,4326452,290988662,11,461,457,282335758,Out > In
Feb 2020,142,60,9,2323413,257048957,259372370,4,9,1,254725544,In > Out
Feb 2020,142,61,12,1795011,145706503,147501514,3,12,2,143911492,In > Out
Feb 2020,142,63,13,1682413,183888246,185570659,5,13,2,182205833,In > Out
Feb 2020,142,67,6,464053,78837787,79301840,3,6,2,78373734,In > Out
Feb 2020,142,68,81,730902,19500734,20231636,3,81,1,18769832,In > Out
Feb 2020,142,69,388,23634230,898722932,922357162,9,387,3,875088702,In > Out
Feb 2020,142,70,10200,68910725,1579059213,1647969938,1,7483,1,1510148488,In > Out
Feb 2020,142,71,13404,138582212,4056725916,4195308128,9,8771,8,3918143704,In > Out
Feb 2020,142,72,10,981713,213395544,214377257,3,10,2,212413831,In > Out
Feb 2020,142,74,1187,153329186,8172147515,8325476701,5,1185,1,8018818329,In > Out
Feb 2020,142,75,13,1624665,167375688,169000353,3,13,2,165751023,In > Out
Feb 2020,142,76,1,171161,17877350,18048511,1,1,1,17706189,In > Out
Feb 2020,142,77,2,92551,11083909,11176460,2,2,2,10991358,In > Out
Feb 2020,142,79,1580,36072836,1297010034,1333082870,13,1505,2,1260937198,In > Out
Feb 2020,142,80,6,788851,127937885,128726736,2,6,2,127149034,In > Out
Feb 2020,142,81,8,1305200,38911683,40216883,5,8,1,37606483,In > Out
Feb 2020,142,84,11,1158366,32342818,33501184,6,11,1,31184452,In > Out
Feb 2020,142,86,85,947288,144554068,145501356,7,10,78,143606780,In > Out
Feb 2020,142,87,8,1560398,175412267,176972665,4,8,2,173851869,In > Out
Feb 2020,142,88,9,1694765,225656007,227350772,3,8,1,223961242,In > Out
Feb 2020,142,89,10,831575,186489272,187320847,4,10,2,185657697,In > Out
Feb 2020,142,9,13,1363430,59681911,61045341,6,13,1,58318481,In > Out
Feb 2020,142,90,8,577647,95035598,95613245,4,8,2,94457951,In > Out
Feb 2020,142,91,11,1457851,206709757,208167608,3,11,2,205251906,In > Out
Feb 2020,142,92,5,520207,68187016,68707223,3,5,2,67666809,In > Out
Feb 2020,142,93,6,655962,42943869,43599831,4,6,2,42287907,In > Out
Feb 2020,142,94,10,1583809,47013996,48597805,5,10,1,45430187,In > Out
Feb 2020,142,95,38,1546686,242650526,244197212,4,38,2,241103840,In > Out
Feb 2020,142,96,7,1185804,39841889,41027693,6,7,1,38656085,In > Out
Feb 2020,142,97,18,1634577,52757817,54392394,8,18,2,51123240,In > Out
Feb 2020,142,98,34,1468310,178307588,179775898,9,34,2,176839278,In > Out
Feb 2020,143,11,185,13459893,1125138512,1138598405,9,185,1,1111678619,In > Out
Feb 2020,143,128,4206,51518891319,79992602882,131511494201,728,3536,190,28473711563,In > Out
Feb 2020,143,129,141,45571498,3029027281,3074598779,26,141,2,2983455783,In > Out
Feb 2020,143,132,7185,4076413367,37789841894,41866255261,1339,6405,62,33713428527,In > Out
Feb 2020,143,140,1,8805,108504,117309,1,1,1,99699,In > Out
Feb 2020,143,148,1,111728,11810,123538,1,1,1,99918,Out > In
Feb 2020,143,152,6929,12296556272,22404369196,34700925468,1187,6099,13,10107812924,In > Out
Feb 2020,143,156,859,446038231,15079121379,15525159610,271,844,3,14633083148,In > Out
Feb 2020,143,168,1445,1433572918,5917149149,7350722067,478,1187,117,4483576231,In > Out
Feb 2020,143,186,750,70911131,6246574650,6317485781,226,745,2,6175663519,In > Out
Feb 2020,143,187,287,15342542277,6211719363,21554261640,159,282,10,9130822914,Out > In
Feb 2020,143,204,3915,790759740,32842122511,33632882251,213,3493,3,32051362771,In > Out
Feb 2020,143,205,5601,1853465073,37512377792,39365842865,938,4846,6,35658912719,In > Out
Feb 2020,143,208,378,53602509,3445741483,3499343992,34,378,2,3392138974,In > Out
Feb 2020,143,222,159,49294600,2875707589,2925002189,33,159,2,2826412989,In > Out
Feb 2020,143,23,767,52782475,3042038817,3094821292,30,767,2,2989256342,In > Out
Feb 2020,143,28,4833,1462530655,117383883593,118846414248,793,4389,20,115921352938,In > Out
Feb 2020,143,42,698,89010811,10155599929,10244610740,113,693,3,10066589118,In > Out
Feb 2020,143,43,199,21386580,410154825,431541405,69,198,1,388768245,In > Out
Feb 2020,144,106,29,624700,18591865,19216565,12,29,2,17967165,In > Out
Feb 2020,144,107,475,34090144,411314838,445404982,150,470,2,377224694,In > Out
Feb 2020,144,119,235,59543679,665351574,724895253,78,231,3,605807895,In > Out
Feb 2020,144,129,4895,326917917,1200406865,1527324782,370,4320,3,873488948,In > Out
Feb 2020,144,132,1,76143,2106876,2183019,1,1,1,2030733,In > Out
Feb 2020,144,165,4,35202,530985,566187,4,4,2,495783,In > Out
Feb 2020,144,17,2472,102592120,805199004,907791124,606,2315,3,702606884,In > Out
Feb 2020,144,191,133,8833358,63749327,72582685,75,132,2,54915969,In > Out
Feb 2020,144,210,269,93707943,264700861,358408804,119,267,2,170992918,In > Out
Feb 2020,144,34,27,1435594,20928171,22363765,16,27,2,19492577,In > Out
Feb 2020,144,60,10,633486,16048039,16681525,7,10,2,15414553,In > Out
Feb 2020,144,75,63,2838574,46998612,49837186,41,62,2,44160038,In > Out
Feb 2020,144,96,386,35487795,944745697,980233492,163,386,2,909257902,In > Out
Feb 2020,144,97,197,76701106,383133425,459834531,35,192,2,306432319,In > Out
Feb 2020,145,108,202,5262915,173608178,178871093,36,202,2,168345263,In > Out
Feb 2020,145,118,134,12638909,390354798,402993707,58,124,2,377715889,In > Out
Feb 2020,145,144,1,50974,3394068,3445042,1,1,1,3343094,In > Out
Feb 2020,145,152,37,504217,18985524,19489741,16,37,2,18481307,In > Out
Feb 2020,145,163,61,1432370,105467322,106899692,15,61,2,104034952,In > Out
Feb 2020,145,170,465,29000406,989953678,1018954084,75,460,2,960953272,In > Out
Feb 2020,145,187,1,30959,1784715,1815674,1,1,1,1753756,In > Out
Feb 2020,145,207,2,164588,4315172,4479760,2,2,1,4150584,In > Out
Feb 2020,145,208,1,7640,177398,185038,1,1,1,169758,In > Out
Feb 2020,145,212,214,4208974,284249764,288458738,19,214,2,280040790,In > Out
Feb 2020,145,217,1,59396,4281908,4341304,1,1,1,4222512,In > Out
Feb 2020,145,29,41,13934147,1459850250,1473784397,15,41,2,1445916103,In > Out
Feb 2020,145,46,39,834533,30639313,31473846,20,39,2,29804780,In > Out
Feb 2020,145,50,192,8386995,231019891,239406886,64,173,2,222632896,In > Out
Feb 2020,145,52,105,2030451,128533071,130563522,22,105,2,126502620,In > Out
Feb 2020,145,53,56,839404,58292538,59131942,15,56,2,57453134,In > Out
Feb 2020,145,64,130,2491119,112384716,114875835,44,130,2,109893597,In > Out
Feb 2020,145,65,81,1440138,70200888,71641026,25,81,2,68760750,In > Out
Feb 2020,145,71,45,598715,45009221,45607936,15,45,2,44410506,In > Out
Feb 2020,145,79,35,884285,53763366,54647651,16,35,2,52879081,In > Out
Feb 2020,145,88,149,3985035,190742656,194727691,36,149,2,186757621,In > Out
Feb 2020,145,89,62,2140798,105953757,108094555,19,62,2,103812959,In > Out
Feb 2020,145,9,272,13071727,565802814,578874541,86,270,2,552731087,In > Out
Feb 2020,145,90,28,1417696,34370958,35788654,21,28,2,32953262,In > Out
Feb 2020,145,94,381,10628974,611652972,622281946,39,366,2,601023998,In > Out
Feb 2020,145,95,612,26329282,1219248226,1245577508,118,583,2,1192918944,In > Out
Feb 2020,145,96,1274,24574172,264736370,289310542,12,1274,2,240162198,In > Out
Feb 2020,146,101,248,211825707,11381249,223206956,177,1,226,200444458,Out > In
Feb 2020,146,11,731,68753579,2524336938,2593090517,304,721,2,2455583359,In > Out
Feb 2020,146,119,187,10734350,136888072,147622422,91,187,2,126153722,In > Out
Feb 2020,146,127,172,6305747,122544608,128850355,62,172,2,116238861,In > Out
Feb 2020,146,128,100,10810096,33736347,44546443,48,100,2,22926251,In > Out
Feb 2020,146,148,152,9336401,82602421,91938822,72,150,2,73266020,In > Out
Feb 2020,146,15,525,28840228,366824246,395664474,200,522,2,337984018,In > Out
Feb 2020,146,152,422,56605014,339604799,396209813,148,417,2,282999785,In > Out
Feb 2020,146,157,865,33263534,530561179,563824713,198,848,2,497297645,In > Out
Feb 2020,146,159,112,22014681,80977494,102992175,33,111,2,58962813,In > Out
Feb 2020,146,165,977,67745147,1835241304,1902986451,315,945,3,1767496157,In > Out
Feb 2020,146,166,182,7944850,98561170,106506020,73,181,2,90616320,In > Out
Feb 2020,146,174,315,32762903,341846914,374609817,152,310,3,309084011,In > Out
Feb 2020,146,175,142,4240869,87066823,91307692,69,142,2,82825954,In > Out
Feb 2020,146,202,396,71793563,219060976,290854539,112,393,2,147267413,In > Out
Feb 2020,146,24,109,8418225,163675407,172093632,79,109,2,155257182,In > Out
Feb 2020,146,241,84,3503947,85323144,88827091,42,84,2,81819197,In > Out
Feb 2020,146,40,186,15138667,82383493,97522160,69,186,2,67244826,In > Out
Feb 2020,146,57,193,17930245,268505312,286435557,69,193,2,250575067,In > Out
Feb 2020,146,77,107,6028218,97685727,103713945,59,107,2,91657509,In > Out
Feb 2020,146,79,2814,133096500,3127890499,3260986999,615,2587,2,2994793999,In > Out
Feb 2020,146,8,744,32445717,590837966,623283683,194,727,2,558392249,In > Out
Feb 2020,146,83,97,2299791,74705713,77005504,16,97,2,72405922,In > Out
Feb 2020,149,10,3,13564,357261,370825,2,3,1,343697,In > Out
Feb 2020,149,100,29,7033863,529436615,536470478,13,29,2,522402752,In > Out
Feb 2020,149,103,1,6669,186453,193122,1,1,1,179784,In > Out
Feb 2020,149,105,2,7392,296647,304039,1,2,1,289255,In > Out
Feb 2020,149,106,148,159369224,260373534,419742758,57,148,2,101004310,In > Out
Feb 2020,149,108,1,5150,147056,152206,1,1,1,141906,In > Out
Feb 2020,149,109,2,10176,310276,320452,1,2,1,300100,In > Out
Feb 2020,149,11,1,19490,905319,924809,1,1,1,885829,In > Out
Feb 2020,149,112,1,12319,326073,338392,1,1,1,313754,In > Out
Feb 2020,149,113,1,11649,263187,274836,1,1,1,251538,In > Out
Feb 2020,149,114,64,2930251,87954572,90884823,24,62,2,85024321,In > Out
Feb 2020,149,115,296,24731306,118328010,143059316,88,291,2,93596704,In > Out
Feb 2020,149,116,200,20323001,326895892,347218893,105,199,2,306572891,In > Out
Feb 2020,149,119,10,281344,4174570,4455914,8,10,2,3893226,In > Out
Feb 2020,149,125,1,4070,103058,107128,1,1,1,98988,In > Out
Feb 2020,149,126,1,12489,340596,353085,1,1,1,328107,In > Out
Feb 2020,149,128,3,31209,1094383,1125592,2,3,2,1063174,In > Out
Feb 2020,149,129,1,3850,149880,153730,1,1,1,146030,In > Out
Feb 2020,149,13,18,2002027,5382927,7384954,9,18,1,3380900,In > Out
Feb 2020,149,130,523,35931476,446889427,482820903,227,519,2,410957951,In > Out
Feb 2020,149,132,2,11708,372012,383720,2,2,1,360304,In > Out
Feb 2020,149,133,45,4556658,103814304,108370962,23,45,2,99257646,In > Out
Feb 2020,149,134,5,35598,1028532,1064130,1,5,1,992934,In > Out
Feb 2020,149,135,110,4208146,190591787,194799933,31,110,2,186383641,In > Out
Feb 2020,149,136,1,5910,193500,199410,1,1,1,187590,In > Out
Feb 2020,149,137,2,11796,378120,389916,2,2,1,366324,In > Out
Feb 2020,149,138,1292,97313860,1350878674,1448192534,376,1248,2,1253564814,In > Out
Feb 2020,149,139,112,16800183,61216890,78017073,45,112,2,44416707,In > Out
Feb 2020,149,14,223,25221126,258535715,283756841,102,223,3,233314589,In > Out
Feb 2020,149,140,47,1017135,40368058,41385193,24,47,2,39350923,In > Out
Feb 2020,149,142,350,5459987,474831689,480291676,82,349,2,469371702,In > Out
Feb 2020,149,143,272,5749331,728093420,733842751,41,272,2,722344089,In > Out
Feb 2020,149,146,2,12138,340918,353056,1,2,1,328780,In > Out
Feb 2020,149,147,278,7678225,149290241,156968466,122,278,2,141612016,In > Out
Feb 2020,149,148,1,10889,281921,292810,1,1,1,271032,In > Out
Feb 2020,149,149,125,8833355,74412356,83245711,70,124,2,65579001,In > Out
Feb 2020,149,151,76,12023906,894739726,906763632,14,76,2,882715820,In > Out
Feb 2020,149,153,1,5846,191943,197789,1,1,1,186097,In > Out
Feb 2020,149,154,1,8070,198120,206190,1,1,1,190050,In > Out
Feb 2020,149,155,976,139738006,2041276957,2181014963,312,950,3,1901538951,In > Out
Feb 2020,149,157,2409,147967687,4719322380,4867290067,458,2269,2,4571354693,In > Out
Feb 2020,149,16,321,7312002,950023310,957335312,41,321,2,942711308,In > Out
Feb 2020,149,160,11,9971634,2440204,12411838,4,7,6,7531430,Out > In
Feb 2020,149,161,9,29971818,2341691754,2371663572,4,7,2,2311719936,In > Out
Feb 2020,149,162,91,15720278,101236004,116956282,16,89,2,85515726,In > Out
Feb 2020,149,163,159,16402800,106645614,123048414,64,159,2,90242814,In > Out
Feb 2020,149,166,1,8990,211620,220610,1,1,1,202630,In > Out
Feb 2020,149,168,740,58212763,740637962,798850725,300,729,2,682425199,In > Out
Feb 2020,149,169,1,6030,190620,196650,1,1,1,184590,In > Out
Feb 2020,149,17,36,13860779,160319763,174180542,23,36,1,146458984,In > Out
Feb 2020,149,170,307,22073068,209692078,231765146,151,305,2,187619010,In > Out
Feb 2020,149,171,9,331754,1996826,2328580,3,9,1,1665072,In > Out
Feb 2020,149,172,1,11049,303654,314703,1,1,1,292605,In > Out
Feb 2020,149,175,50,3718608,82082653,85801261,18,50,2,78364045,In > Out
Feb 2020,149,176,122,13829800,69774637,83604437,65,122,2,55944837,In > Out
Feb 2020,149,178,2,8998,321920,330918,2,2,1,312922,In > Out
Feb 2020,149,179,1,18146,922902,941048,1,1,1,904756,In > Out
Feb 2020,149,18,5,90347,3076042,3166389,2,5,2,2985695,In > Out
Feb 2020,149,180,225,2948865,427420405,430369270,31,224,3,424471540,In > Out
Feb 2020,149,183,441,18386006,1377870399,1396256405,63,433,2,1359484393,In > Out
Feb 2020,149,185,1,4870,142988,147858,1,1,1,138118,In > Out
Feb 2020,149,187,11,390859,3738830,4129689,2,1,10,3347971,In > Out
Feb 2020,149,188,987,87194643,692827020,780021663,193,956,3,605632377,In > Out
Feb 2020,149,189,743,90291271,209397883,299689154,104,729,2,119106612,In > Out
Feb 2020,149,19,1,6270,193596,199866,1,1,1,187326,In > Out
Feb 2020,149,190,204,33178955,1257098200,1290277155,54,204,2,1223919245,In > Out
Feb 2020,149,192,1,4182,121764,125946,1,1,1,117582,In > Out
Feb 2020,149,193,1,4707,108577,113284,1,1,1,103870,In > Out
Feb 2020,149,194,1,9030,210080,219110,1,1,1,201050,In > Out
Feb 2020,149,195,1,5044,174056,179100,1,1,1,169012,In > Out
Feb 2020,149,196,1,5486,164686,170172,1,1,1,159200,In > Out
Feb 2020,149,197,38,2326863,84476755,86803618,25,38,2,82149892,In > Out
Feb 2020,149,198,1,18861,1125857,1144718,1,1,1,1106996,In > Out
Feb 2020,149,199,1,5910,191799,197709,1,1,1,185889,In > Out
Feb 2020,149,200,3,17792,472066,489858,1,3,1,454274,In > Out
Feb 2020,149,204,1,17906,876819,894725,1,1,1,858913,In > Out
Feb 2020,149,205,225,43284317,2249095579,2292379896,81,215,2,2205811262,In > Out
Feb 2020,149,206,66,5302772,28204683,33507455,32,66,1,22901911,In > Out
Feb 2020,149,207,1,3764,100944,104708,1,1,1,97180,In > Out
Feb 2020,149,208,1,1869,126717,128586,1,1,1,124848,In > Out
Feb 2020,149,209,4,23907,610314,634221,2,4,1,586407,In > Out
Feb 2020,149,21,76,10889992,424251440,435141432,36,76,2,413361448,In > Out
Feb 2020,149,210,790,62712442,688904340,751616782,299,774,2,626191898,In > Out
Feb 2020,149,211,2,12970,320408,333378,1,2,1,307438,In > Out
Feb 2020,149,212,1,6150,193548,199698,1,1,1,187398,In > Out
Feb 2020,149,213,41,1512055,63736856,65248911,24,41,2,62224801,In > Out
Feb 2020,149,215,2,13516,391458,404974,2,2,1,377942,In > Out
Feb 2020,149,216,1,5606,185916,191522,1,1,1,180310,In > Out
Feb 2020,149,217,1,5870,182928,188798,1,1,1,177058,In > Out
Feb 2020,149,218,1927,84828408,3566661774,3651490182,46,1920,2,3481833366,In > Out
Feb 2020,149,220,51,4249991,89598889,93848880,30,51,1,85348898,In > Out
Feb 2020,149,221,21,19318538,256207543,275526081,12,21,1,236889005,In > Out
Feb 2020,149,222,418,25666215,264642373,290308588,183,413,2,238976158,In > Out
Feb 2020,149,226,2,20879,638054,658933,2,2,1,617175,In > Out
Feb 2020,149,227,33,1522844,14046756,15569600,25,33,2,12523912,In > Out
Feb 2020,149,229,1505,179340215,5111201110,5290541325,426,1442,2,4931860895,In > Out
Feb 2020,149,23,1,15686,279781,295467,1,1,1,264095,In > Out
Feb 2020,149,230,178,27580814,265222733,292803547,73,177,2,237641919,In > Out
Feb 2020,149,231,1,4044,136652,140696,1,1,1,132608,In > Out
Feb 2020,149,232,1,6030,193614,199644,1,1,1,187584,In > Out
Feb 2020,149,233,2,4236,224056,228292,1,2,1,219820,In > Out
Feb 2020,149,235,1,4924,134920,139844,1,1,1,129996,In > Out
Feb 2020,149,236,1,14809,450306,465115,1,1,1,435497,In > Out
Feb 2020,149,238,138,9875830,686734764,696610594,23,138,2,676858934,In > Out
Feb 2020,149,24,36,490025,8762670,9252695,5,36,3,8272645,In > Out
Feb 2020,149,241,1,5636,115959,121595,1,1,1,110323,In > Out
Feb 2020,149,242,1,6150,193596,199746,1,1,1,187446,In > Out
Feb 2020,149,243,1,5446,172428,177874,1,1,1,166982,In > Out
Feb 2020,149,246,1,4710,119608,124318,1,1,1,114898,In > Out
Feb 2020,149,247,769,166823927,457534112,624358039,133,749,2,290710185,In > Out
Feb 2020,149,248,1,4430,105066,109496,1,1,1,100636,In > Out
Feb 2020,149,249,2,11530,344597,356127,1,2,1,333067,In > Out
Feb 2020,149,25,102,483575,108436260,108919835,10,102,1,107952685,In > Out
Feb 2020,149,250,5,414878,18118771,18533649,4,5,2,17703893,In > Out
Feb 2020,149,251,474,10261896,1278091780,1288353676,64,473,2,1267829884,In > Out
Feb 2020,149,252,19,648103,14569203,15217306,8,19,3,13921100,In > Out
Feb 2020,149,254,273,11264007,567192725,578456732,41,272,2,555928718,In > Out
Feb 2020,149,26,4,29755,922923,952678,1,4,1,893168,In > Out
Feb 2020,149,27,1,13889,471306,485195,1,1,1,457417,In > Out
Feb 2020,149,28,873,78753801,630758502,709512303,340,841,2,552004701,In > Out
Feb 2020,149,30,1,15763,404095,419858,1,1,1,388332,In > Out
Feb 2020,149,31,30,3175808,37104603,40280411,15,30,1,33928795,In > Out
Feb 2020,149,32,2,18822,515354,534176,1,2,1,496532,In > Out
Feb 2020,149,33,204,13001406,109372030,122373436,72,204,2,96370624,In > Out
Feb 2020,149,35,1,5846,193596,199442,1,1,1,187750,In > Out
Feb 2020,149,36,2,9295,311667,320962,1,2,1,302372,In > Out
Feb 2020,149,37,26,1456270,85982034,87438304,12,26,2,84525764,In > Out
Feb 2020,149,39,1143,14187691406,2531840642,16719532048,130,1121,2,11655850764,Out > In
Feb 2020,149,40,1,36915,1507038,1543953,1,1,1,1470123,In > Out
Feb 2020,149,41,3,16959,465974,482933,2,3,1,449015,In > Out
Feb 2020,149,42,195,4563198,530969247,535532445,31,195,2,526406049,In > Out
Feb 2020,149,43,2,77192,2869362,2946554,2,2,1,2792170,In > Out
Feb 2020,149,44,570,22811151,2699928941,2722740092,79,557,3,2677117790,In > Out
Feb 2020,149,45,759,48234371,1422426955,1470661326,164,741,3,1374192584,In > Out
Feb 2020,149,46,1,6270,175635,181905,1,1,1,169365,In > Out
Feb 2020,149,53,161,13643648,302009072,315652720,79,161,2,288365424,In > Out
Feb 2020,149,54,2,25699,1114830,1140529,2,2,1,1089131,In > Out
Feb 2020,149,55,1,4180,123152,127332,1,1,1,118972,In > Out
Feb 2020,149,57,53,29876800,53596250,83473050,22,53,1,23719450,In > Out
Feb 2020,149,60,2,9400,306551,315951,1,2,1,297151,In > Out
Feb 2020,149,61,149,5997069,858788875,864785944,21,149,2,852791806,In > Out
Feb 2020,149,62,1,6030,193596,199626,1,1,1,187566,In > Out
Feb 2020,149,63,1,7550,175884,183434,1,1,1,168334,In > Out
Feb 2020,149,65,35,557134,24590217,25147351,4,35,2,24033083,In > Out
Feb 2020,149,66,1,5750,175476,181226,1,1,1,169726,In > Out
Feb 2020,149,68,1,3820,106661,110481,1,1,1,102841,In > Out
Feb 2020,149,69,955,252096161,1106472393,1358568554,265,933,5,854376232,In > Out
Feb 2020,149,70,657,49384204,1825812165,1875196369,37,647,2,1776427961,In > Out
Feb 2020,149,71,1,6030,193620,199650,1,1,1,187590,In > Out
Feb 2020,149,72,51,8988595,720636510,729625105,21,51,2,711647915,In > Out
Feb 2020,149,73,1,11889,337596,349485,1,1,1,325707,In > Out
Feb 2020,149,74,150,3936006,50857360,54793366,72,150,1,46921354,In > Out
Feb 2020,149,75,2,14100,384108,398208,1,2,1,370008,In > Out
Feb 2020,149,77,2,38005,1427639,1465644,1,2,1,1389634,In > Out
Feb 2020,149,78,13,139544,16264804,16404348,9,13,2,16125260,In > Out
Feb 2020,149,79,2,18815,584817,603632,1,2,1,566002,In > Out
Feb 2020,149,8,3193,180901398,3402545084,3583446482,526,2954,4,3221643686,In > Out
Feb 2020,149,80,1,5910,193476,199386,1,1,1,187566,In > Out
Feb 2020,149,81,14,938122,2366466,3304588,10,14,1,1428344,In > Out
Feb 2020,149,82,89,5821241,56690029,62511270,47,89,2,50868788,In > Out
Feb 2020,149,83,10,175028,7166624,7341652,8,10,1,6991596,In > Out
Feb 2020,149,85,6,139521,4232759,4372280,5,6,1,4093238,In > Out
Feb 2020,149,86,447,35782132,772720614,808502746,98,445,2,736938482,In > Out
Feb 2020,149,87,1,4470,111264,115734,1,1,1,106794,In > Out
Feb 2020,149,88,45,20638056,18250786,38888842,8,44,2,2387270,Out > In
Feb 2020,149,89,1,5590,188796,194386,1,1,1,183206,In > Out
Feb 2020,149,90,113,2399834,155877487,158277321,40,112,2,153477653,In > Out
Feb 2020,149,91,16,285875,4274388,4560263,5,16,1,3988513,In > Out
Feb 2020,149,93,1,5404,176316,181720,1,1,1,170912,In > Out
Feb 2020,149,94,1,6110,193623,199733,1,1,1,187513,In > Out
Feb 2020,149,95,305,19702934,170450354,190153288,125,305,2,150747420,In > Out
Feb 2020,149,96,2,21810,494646,516456,1,2,1,472836,In > Out
Feb 2020,149,97,29,2098141,18917644,21015785,19,29,2,16819503,In > Out
Feb 2020,149,98,333,12234052,229225653,241459705,120,333,2,216991601,In > Out
Feb 2020,150,115,6024,1344536959,3754929232,5099466191,346,5178,5,2410392273,In > Out
Feb 2020,150,120,13,1494393,7224726,8719119,10,13,2,5730333,In > Out
Feb 2020,150,125,679,190197484,6464636801,6654834285,70,679,3,6274439317,In > Out
Feb 2020,150,143,489,26158020,201327324,227485344,110,481,2,175169304,In > Out
Feb 2020,150,15,212,20698476,305575332,326273808,29,210,4,284876856,In > Out
Feb 2020,150,156,5,108036,2724485,2832521,4,5,1,2616449,In > Out
Feb 2020,150,159,56,6375371,47389632,53765003,35,56,3,41014261,In > Out
Feb 2020,150,171,598,227753622,582808147,810561769,118,592,3,355054525,In > Out
Feb 2020,150,175,59,2566945,89612705,92179650,34,58,2,87045760,In > Out
Feb 2020,150,181,56,1719510,62814740,64534250,22,56,2,61095230,In > Out
Feb 2020,150,182,8989,7726852994,2534275754,10261128748,1330,3059,5058,5192577240,Out > In
Feb 2020,150,200,44,1667009,49439824,51106833,25,43,2,47772815,In > Out
Feb 2020,150,207,787,201350608,708698569,910049177,261,772,2,507347961,In > Out
Feb 2020,150,214,71,1715145,56499705,58214850,26,71,2,54784560,In > Out
Feb 2020,150,216,3,28081,1277090,1305171,2,3,1,1249009,In > Out
Feb 2020,150,219,1147,292786354,98592322,391378676,98,1132,2,194194032,Out > In
Feb 2020,150,220,140,4743267,240367591,245110858,50,139,2,235624324,In > Out
Feb 2020,150,225,2,221938,538423,760361,1,2,1,316485,In > Out
Feb 2020,150,226,549,77199769,2749682611,2826882380,195,545,3,2672482842,In > Out
Feb 2020,150,233,83,3254289,170942679,174196968,46,83,2,167688390,In > Out
Feb 2020,150,234,3,63273,1455779,1519052,3,3,1,1392506,In > Out
Feb 2020,150,235,48,13039426,59406916,72446342,24,48,2,46367490,In > Out
Feb 2020,150,240,269,18401932,98083396,116485328,92,266,2,79681464,In > Out
Feb 2020,150,243,377,48283996,2348530158,2396814154,94,375,2,2300246162,In > Out
Feb 2020,150,248,262,6405183,121190775,127595958,79,261,2,114785592,In > Out
Feb 2020,150,250,165,5058499,280275218,285333717,17,164,2,275216719,In > Out
Feb 2020,150,254,3,1897512,130772362,132669874,3,3,1,128874850,In > Out
Feb 2020,150,31,47,2033215,83774388,85807603,23,47,2,81741173,In > Out
Feb 2020,150,53,4,393256,3534797,3928053,3,4,2,3141541,In > Out
Feb 2020,150,57,15,1121674597,599662015,1721336612,1,15,15,522012582,Out > In
Feb 2020,150,70,179,14753772,1293023449,1307777221,70,177,2,1278269677,In > Out
Feb 2020,150,71,143,12831477,200815004,213646481,76,142,2,187983527,In > Out
Feb 2020,151,96,4,764834,23210638,23975472,4,4,2,22445804,In > Out
Feb 2020,153,108,430,181128085,1153310996,1334439081,166,426,4,972182911,In > Out
Feb 2020,153,129,7,2277729,24798704,27076433,3,4,2,22520975,In > Out
Feb 2020,153,133,559,50902634,353720009,404622643,199,549,2,302817375,In > Out
Feb 2020,153,141,25,24687286,259887112,284574398,4,9,3,235199826,In > Out
Feb 2020,153,142,14,3433950,14346255,17780205,8,14,2,10912305,In > Out
Feb 2020,153,149,897,50009672,1381819958,1431829630,309,879,3,1331810286,In > Out
Feb 2020,153,217,74,5875303,236089051,241964354,29,74,3,230213748,In > Out
Feb 2020,153,60,477,59833888,221054309,280888197,155,465,2,161220421,In > Out
Feb 2020,153,69,12202,2692579694,6982911904,9675491598,180,8904,3,4290332210,In > Out
Feb 2020,153,78,254,17742917,186905733,204648650,106,251,2,169162816,In > Out
Feb 2020,153,88,25,4981413,24760601,29742014,11,25,3,19779188,In > Out
Feb 2020,154,104,56,1973682,69942378,71916060,23,56,2,67968696,In > Out
Feb 2020,154,113,4,493615,245667002,246160617,3,4,2,245173387,In > Out
Feb 2020,154,119,5,20256,826509,846765,1,5,1,806253,In > Out
Feb 2020,154,123,996,323548443,270914575,594463018,165,967,2,52633868,Out > In
Feb 2020,154,131,54,1989358,61756594,63745952,34,54,2,59767236,In > Out
Feb 2020,154,134,44,2422111,124262860,126684971,16,44,2,121840749,In > Out
Feb 2020,154,135,62,1806576,59092892,60899468,26,62,2,57286316,In > Out
Feb 2020,154,148,45,513084,26156202,26669286,16,44,2,25643118,In > Out
Feb 2020,154,151,407,38415973,757207877,795623850,162,395,2,718791904,In > Out
Feb 2020,154,154,2,312063,224971,537034,1,2,1,87092,Out > In
Feb 2020,154,160,44,1300520,54192363,55492883,20,44,2,52891843,In > Out
Feb 2020,154,162,4890,2054437968,12828063730,14882501698,853,4224,4,10773625762,In > Out
Feb 2020,154,169,2,436636,201903616,202340252,2,2,2,201466980,In > Out
Feb 2020,154,172,52,1785275,91037511,92822786,16,52,2,89252236,In > Out
Feb 2020,154,173,52,1892385,48501745,50394130,22,51,2,46609360,In > Out
Feb 2020,154,174,52,5920842,20826112,26746954,35,52,2,14905270,In > Out
Feb 2020,154,187,46,2315208,69539628,71854836,22,46,2,67224420,In > Out
Feb 2020,154,188,48,3111890,107463881,110575771,23,47,2,104351991,In > Out
Feb 2020,154,192,52,1951329,75330413,77281742,25,52,2,73379084,In > Out
Feb 2020,154,197,34,1156865,18844952,20001817,18,34,2,17688087,In > Out
Feb 2020,154,198,3,395343,22950135,23345478,3,3,1,22554792,In > Out
Feb 2020,154,204,61,7648603,39021644,46670247,36,61,2,31373041,In > Out
Feb 2020,154,207,162,10239955,130521891,140761846,73,162,3,120281936,In > Out
Feb 2020,154,21,1,784280,525279096,526063376,1,1,1,524494816,In > Out
Feb 2020,154,211,1,2931,121758,124689,1,1,1,118827,In > Out
Feb 2020,154,217,317,15999449,199859513,215858962,126,315,2,183860064,In > Out
Feb 2020,154,223,63,29557755,45339084,74896839,22,63,2,15781329,In > Out
Feb 2020,154,23,1,116135,28645104,28761239,1,1,1,28528969,In > Out
Feb 2020,154,43,24,1170296,38348920,39519216,18,23,2,37178624,In > Out
Feb 2020,154,45,432,36049433,470027603,506077036,168,426,2,433978170,In > Out
Feb 2020,154,50,548,50842778,202431076,253273854,105,535,2,151588298,In > Out
Feb 2020,154,53,1,11280,2316228,2327508,1,1,1,2304948,In > Out
Feb 2020,154,56,34,616158,36427728,37043886,12,34,2,35811570,In > Out
Feb 2020,154,57,41,1405053,76410131,77815184,15,41,2,75005078,In > Out
Feb 2020,154,6,126,4961433,119230320,124191753,54,125,2,114268887,In > Out
Feb 2020,154,65,7,350314,16053604,16403918,6,7,1,15703290,In > Out
Feb 2020,154,66,58,2235684,79021630,81257314,28,58,2,76785946,In > Out
Feb 2020,154,67,22,1314309148,1180735699,2495044847,1,21,22,133573449,Out > In
Feb 2020,154,78,1184,157513301,8143112396,8300625697,180,1172,4,7985599095,In > Out
Feb 2020,154,79,24,1456385,58492068,59948453,19,24,2,57035683,In > Out
Feb 2020,154,92,878,250250276,577811831,828062107,150,862,2,327561555,In > Out
Feb 2020,155,106,2,7664,259293,266957,1,2,1,251629,In > Out
Feb 2020,155,126,5,379748,69150974,69530722,4,5,2,68771226,In > Out
Feb 2020,155,132,4,518762,98520928,99039690,1,4,1,98002166,In > Out
Feb 2020,155,135,11,38359154,41696107,80055261,5,11,9,3336953,In > Out
Feb 2020,155,136,3,331274,53191237,53522511,3,3,1,52859963,In > Out
Feb 2020,155,137,6,1049015,88497982,89546997,2,6,2,87448967,In > Out
Feb 2020,155,142,372,171247689,78482514,249730203,44,12,362,92765175,Out > In
Feb 2020,155,143,8,316217,45266159,45582376,4,8,1,44949942,In > Out
Feb 2020,155,145,125,4059760,900880589,904940349,10,124,9,896820829,In > Out
Feb 2020,155,146,9,4800687,742941531,747742218,5,9,4,738140844,In > Out
Feb 2020,155,149,484,243887715,75813212,319700927,56,10,472,168074503,Out > In
Feb 2020,155,150,4,350740,69382274,69733014,2,4,2,69031534,In > Out
Feb 2020,155,151,24,58415991,390247370,448663361,11,20,15,331831379,In > Out
Feb 2020,155,152,10,734745,74581567,75316312,4,10,2,73846822,In > Out
Feb 2020,155,153,3,140072,14355202,14495274,1,3,1,14215130,In > Out
Feb 2020,155,154,6,1316348,60171556,61487904,5,6,2,58855208,In > Out
Feb 2020,155,158,7,1492758,3843386,5336144,2,2,2,2350628,In > Out
Feb 2020,155,167,2680,3793820558,869210569,4663031127,1018,130,2253,2924609989,Out > In
Feb 2020,155,169,44,16111159,43387203,59498362,22,32,9,27276044,In > Out
Feb 2020,155,170,54,62847951,76336721,139184672,34,31,16,13488770,In > Out
Feb 2020,155,198,7,269926,55770929,56040855,2,7,2,55501003,In > Out
Feb 2020,155,199,9,1385722,99829274,101214996,3,9,2,98443552,In > Out
Feb 2020,155,200,18,701175,68471881,69173056,4,18,2,67770706,In > Out
Feb 2020,155,201,5,218067,31065001,31283068,3,5,2,30846934,In > Out
Feb 2020,155,202,6,1967112,127753546,129720658,2,6,2,125786434,In > Out
Feb 2020,155,204,5,1324772,124179327,125504099,1,5,1,122854555,In > Out
Feb 2020,155,205,256,3339050,791450090,794789140,8,255,202,788111040,In > Out
Feb 2020,155,206,7,945102,82328412,83273514,4,7,2,81383310,In > Out
Feb 2020,155,220,43,812924,139293410,140106334,7,43,2,138480486,In > Out
Feb 2020,156,128,11,97943,5817902,5915845,4,11,2,5719959,In > Out
Feb 2020,156,133,398,14761129,205414298,220175427,77,395,2,190653169,In > Out
Feb 2020,156,138,242,8578009,375981554,384559563,47,240,2,367403545,In > Out
Feb 2020,156,149,116,4907040,46655618,51562658,32,114,2,41748578,In > Out
Feb 2020,156,166,74,8301594,180279099,188580693,38,74,2,171977505,In > Out
Feb 2020,156,168,18,440533,18149740,18590273,6,18,2,17709207,In > Out
Feb 2020,156,173,705,65077728,1987916301,2052994029,165,690,2,1922838573,In > Out
Feb 2020,156,175,67,2360839,120236814,122597653,20,67,2,117875975,In > Out
Feb 2020,156,178,2,391793,1128857,1520650,1,2,1,737064,In > Out
Feb 2020,156,180,1082,153320175,3419719491,3573039666,160,1056,2,3266399316,In > Out
Feb 2020,156,187,489,54894364,154756897,209651261,114,486,2,99862533,In > Out
Feb 2020,156,188,173,25705830,135756357,161462187,61,172,2,110050527,In > Out
Feb 2020,156,189,78,3086055,66999007,70085062,26,78,2,63912952,In > Out
Feb 2020,156,195,687,69014926,1049363700,1118378626,277,670,2,980348774,In > Out
Feb 2020,156,206,160,5652283,75674737,81327020,82,158,2,70022454,In > Out
Feb 2020,156,210,409,26252643,984158049,1010410692,90,407,2,957905406,In > Out
Feb 2020,156,215,290,31384689,184208422,215593111,144,289,2,152823733,In > Out
Feb 2020,156,217,2,144397,7452956,7597353,2,2,2,7308559,In > Out
Feb 2020,156,218,324,41219781,109466779,150686560,102,320,2,68246998,In > Out
Feb 2020,156,219,1,1915,106617,108532,1,1,1,104702,In > Out
Feb 2020,156,227,16,10215369,21618587,31833956,12,16,2,11403218,In > Out
Feb 2020,156,230,280,56263482,137438273,193701755,86,280,2,81174791,In > Out
Feb 2020,156,232,758,90806329,643006010,733812339,255,735,3,552199681,In > Out
Feb 2020,156,233,146,3853036,149717963,153570999,54,146,2,145864927,In > Out
Feb 2020,156,235,1917,21590911075,2480667934,24071579009,279,1813,5,19110243141,Out > In
Feb 2020,156,236,44,1216391,22305865,23522256,28,44,2,21089474,In > Out
Feb 2020,156,238,933,158005355,292856565,450861920,157,906,3,134851210,In > Out
Feb 2020,156,245,6,8447748,5030643,13478391,2,6,2,3417105,Out > In
Feb 2020,156,248,456,48428891,198603785,247032676,92,434,15,150174894,In > Out
Feb 2020,157,58,6,874656181,206029085,1080685266,2,6,5,668627096,Out > In
Feb 2020,159,111,3,459183,444063,903246,1,3,3,15120,Out > In
Feb 2020,159,128,2180,277073876,251113187,528187063,132,2061,2,25960689,Out > In
Feb 2020,159,134,4,2056319,976914,3033233,1,4,1,1079405,Out > In
Feb 2020,159,136,17,1537156,99381979,100919135,13,17,2,97844823,In > Out
Feb 2020,159,137,11,5411809,4611140,10022949,3,11,2,800669,Out > In
Feb 2020,159,150,924,115429746,284650320,400080066,130,896,33,169220574,In > Out
Feb 2020,159,158,16,260993,15632081,15893074,7,16,2,15371088,In > Out
Feb 2020,159,161,235,28069476,109229617,137299093,72,235,2,81160141,In > Out
Feb 2020,159,171,805,233394697,361866457,595261154,129,774,2,128471760,In > Out
Feb 2020,159,174,6,4184532,2734015,6918547,4,6,1,1450517,Out > In
Feb 2020,159,192,78,7615046,193076924,200691970,43,77,2,185461878,In > Out
Feb 2020,159,201,162,32822673,275776096,308598769,48,162,3,242953423,In > Out
Feb 2020,159,203,1156,235855998,512295144,748151142,226,1110,2,276439146,In > Out
Feb 2020,159,217,208,33745208,85105430,118850638,85,206,2,51360222,In > Out
Feb 2020,159,222,632,64135969,847436401,911572370,134,616,2,783300432,In > Out
Feb 2020,159,226,465,10982414,352739731,363722145,144,461,2,341757317,In > Out
Feb 2020,159,229,85,2292120,90653406,92945526,21,85,2,88361286,In > Out
Feb 2020,159,245,18,1269355,8340734,9610089,13,18,1,7071379,In > Out
Feb 2020,159,248,928,99348310,765880005,865228315,170,918,3,666531695,In > Out
Feb 2020,159,253,27,1507079,73275631,74782710,15,27,2,71768552,In > Out
Feb 2020,159,30,327,56474757,195409220,251883977,106,323,2,138934463,In > Out
Feb 2020,159,34,2870,905136793,1000253076,1905389869,396,2663,2,95116283,In > Out
Feb 2020,159,38,2,38123,1804525,1842648,2,2,2,1766402,In > Out
Feb 2020,159,41,502,52942620,614507279,667449899,161,477,3,561564659,In > Out
Feb 2020,159,64,14,209344,9785849,9995193,11,14,2,9576505,In > Out
Feb 2020,159,70,62,2390151,129499785,131889936,37,62,2,127109634,In > Out
Feb 2020,16,10,2052,300951723,2753688655,3054640378,416,1891,3,2452736932,In > Out
Feb 2020,16,12,1104,48644147,3434458344,3483102491,127,1058,2,3385814197,In > Out
Feb 2020,16,14,64835,8060617428,102982414343,111043031771,5463,18315,62,94921796915,In > Out
Feb 2020,16,16,15600,1708529693,21668647914,23377177607,1981,10043,58,19960118221,In > Out
Feb 2020,16,19,3061,325659166,6869633330,7195292496,637,2772,2,6543974164,In > Out
Feb 2020,16,2,1141,102600558,2449305023,2551905581,225,1093,3,2346704465,In > Out
Feb 2020,16,20,30828,1882499081860,74557187412,1957056269272,2838,17207,39,1807941894448,Out > In
Feb 2020,16,240,1387,95342713,5507822334,5603165047,309,1343,2,5412479621,In > Out
Feb 2020,16,4,563,35119548,751603611,786723159,121,555,3,716484063,In > Out
Feb 2020,16,7,50366,5947108554,48627133057,54574241611,3484,14190,20,42680024503,In > Out
Feb 2020,160,10,520,246791717,545896354,792688071,120,487,4,299104637,In > Out
Feb 2020,160,105,4498,416081748,1418379960,1834461708,176,4281,3,1002298212,In > Out
Feb 2020,160,106,2341,1261870198,6148589385,7410459583,129,2215,2,4886719187,In > Out
Feb 2020,160,107,4377,145798900,1510324529,1656123429,112,4209,3,1364525629,In > Out
Feb 2020,160,108,817,60309464,3320514409,3380823873,103,806,2,3260204945,In > Out
Feb 2020,160,109,1603,2387690791,66724815828,69112506619,144,1538,5,64337125037,In > Out
Feb 2020,160,11,1034,58989037,525148244,584137281,139,896,3,466159207,In > Out
Feb 2020,160,110,3212,157499751,2019968432,2177468183,201,2976,5,1862468681,In > Out
Feb 2020,160,111,2401,4353760424,165759535924,170113296348,159,2280,4,161405775500,In > Out
Feb 2020,160,112,875,40241346,1127377204,1167618550,128,860,2,1087135858,In > Out
Feb 2020,160,12,1012,63255395,1593592320,1656847715,109,897,3,1530336925,In > Out
Feb 2020,160,121,272926,69465385993,392360883654,461826269647,11492,21744,166,322895497661,In > Out
Feb 2020,160,122,288605,61011790391,372344553264,433356343655,12445,18240,584,311332762873,In > Out
Feb 2020,160,123,303709,86427497153,426294024201,512721521354,12190,22585,540,339866527048,In > Out
Feb 2020,160,124,306553,92977828251,348425712636,441403540887,12071,22353,266,255447884385,In > Out
Feb 2020,160,125,287595,55135672271,446647712880,501783385151,11160,19404,226,391512040609,In > Out
Feb 2020,160,126,304022,52313234817,359602955363,411916190180,11315,20463,229,307289720546,In > Out
Feb 2020,160,127,273517,67518576897,378667314026,446185890923,12258,20578,1257,311148737129,In > Out
Feb 2020,160,128,105172,63576226425,133531246613,197107473038,6198,16589,27,69955020188,In > Out
Feb 2020,160,13,1890,263588487,589714199,853302686,139,1745,3,326125712,In > Out
Feb 2020,160,130,2859,191724595,5567857265,5759581860,589,2624,10,5376132670,In > Out
Feb 2020,160,132,99555,7610102978,166694195859,174304298837,3683,16510,14,159084092881,In > Out
Feb 2020,160,14,246,35758419,208224116,243982535,66,217,3,172465697,In > Out
Feb 2020,160,144,405,3735511338,2286674387,6022185725,101,399,3,1448836951,Out > In
Feb 2020,160,15,207,9435074,98229498,107664572,36,181,3,88794424,In > Out
Feb 2020,160,152,951,2067478482,7511317005,9578795487,166,906,203,5443838523,In > Out
Feb 2020,160,153,821,2021864397,7011230164,9033094561,178,797,202,4989365767,In > Out
Feb 2020,160,154,1013,1369213415,5353883426,6723096841,154,970,158,3984670011,In > Out
Feb 2020,160,155,940,1263438006,5367743906,6631181912,142,913,152,4104305900,In > Out
Feb 2020,160,156,877,2063322226,7152289444,9215611670,178,843,214,5088967218,In > Out
Feb 2020,160,157,1044,1763580568,6656994302,8420574870,173,982,197,4893413734,In > Out
Feb 2020,160,16,644,63094153,964305363,1027399516,81,524,3,901211210,In > Out
Feb 2020,160,196,38691,33674579421,91889310100,125563889521,4946,16118,88,58214730679,In > Out
Feb 2020,160,197,32590,16735991633,126082693901,142818685534,4017,14991,76,109346702268,In > Out
Feb 2020,160,198,39494,35301897527,83463206922,118765104449,4962,17558,49,48161309395,In > Out
Feb 2020,160,199,31930,9359935696,81211157233,90571092929,4685,14824,89,71851221537,In > Out
Feb 2020,160,200,14244,5306434333,35696247810,41002682143,2453,9725,27,30389813477,In > Out
Feb 2020,160,201,11762,3187935475,26933301874,30121237349,2045,8358,23,23745366399,In > Out
Feb 2020,160,202,16206,2914516153,40049976702,42964492855,2531,10521,31,37135460549,In > Out
Feb 2020,160,203,17024,4232389780,37552241528,41784631308,2470,10860,18,33319851748,In > Out
Feb 2020,160,216,12727,10415273306,10874357754,21289631060,43,11518,3,459084448,In > Out
Feb 2020,160,227,536,35165621,448823629,483989250,244,526,2,413658008,In > Out
Feb 2020,160,236,48,373496,33040738,33414234,10,48,3,32667242,In > Out
Feb 2020,160,237,299,10851315,345213385,356064700,69,288,2,334362070,In > Out
Feb 2020,160,238,31838,7422885495,29649200119,37072085614,2753,13996,29,22226314624,In > Out
Feb 2020,160,239,14727,5930122839,194674508090,200604630929,2418,10373,103,188744385251,In > Out
Feb 2020,160,240,12780,6637542256,80493412103,87130954359,2200,9641,48,73855869847,In > Out
Feb 2020,160,241,15605,4823713176,127949945735,132773658911,2611,11065,233,123126232559,In > Out
Feb 2020,160,242,15137,15531677803,77723038053,93254715856,2541,11106,302,62191360250,In > Out
Feb 2020,160,243,13456,13895307159,80775465089,94670772248,2300,9959,157,66880157930,In > Out
Feb 2020,160,244,20217,4370681601,108089283709,112459965310,2876,12467,131,103718602108,In > Out
Feb 2020,160,245,18948,4924476904,138743117816,143667594720,2846,12100,106,133818640912,In > Out
Feb 2020,160,246,12597,5610895676,43946540336,49557436012,2104,9473,73,38335644660,In > Out
Feb 2020,160,247,21817,10548050174,149046906575,159594956749,3274,13098,193,138498856401,In > Out
Feb 2020,160,249,1206,100445825,805876549,906322374,317,1173,3,705430724,In > Out
Feb 2020,160,33,856,88002061,1656759053,1744761114,120,838,5,1568756992,In > Out
Feb 2020,160,34,2003,135993271,8964252225,9100245496,236,1898,3,8828258954,In > Out
Feb 2020,160,35,395,14220256,101622903,115843159,79,392,2,87402647,In > Out
Feb 2020,160,36,2311,1283664226,3909418284,5193082510,173,1076,3,2625754058,In > Out
Feb 2020,160,37,1720,107080551,841899811,948980362,161,1450,4,734819260,In > Out
Feb 2020,160,38,1256,97290905,1810040904,1907331809,187,1204,4,1712749999,In > Out
Feb 2020,160,39,2703,4469886985,1907121406,6377008391,222,986,3,2562765579,Out > In
Feb 2020,160,40,479,1407738754,507243202,1914981956,74,475,39,900495552,Out > In
Feb 2020,160,57,8206,1447487853,12504825143,13952312996,1150,6711,6,11057337290,In > Out
Feb 2020,160,58,10685,6873106796,23162361441,30035468237,1206,8409,7,16289254645,In > Out
Feb 2020,160,59,8128,885655127,12152427481,13038082608,982,6728,8,11266772354,In > Out
Feb 2020,160,6,3166,22607297015,971361252,23578658267,219,2704,3,21635935763,Out > In
Feb 2020,160,60,15476,1232002518,72271170124,73503172642,1152,11985,1008,71039167606,In > Out
Feb 2020,160,61,9446,667182427,11834290797,12501473224,1182,7701,9,11167108370,In > Out
Feb 2020,160,62,22591,5327097513,58068814990,63395912503,1546,13833,9,52741717477,In > Out
Feb 2020,160,63,11497,160560954836,11531799222,172092754058,1411,8918,8,149029155614,Out > In
Feb 2020,160,65,50360,14435468136,116128550708,130564018844,3818,16636,112,101693082572,In > Out
Feb 2020,160,66,48347,8891297756,117369002492,126260300248,4106,17866,60,108477704736,In > Out
Feb 2020,160,67,49719,10097663246,83953852873,94051516119,3345,19021,43,73856189627,In > Out
Feb 2020,160,68,56459,8608137857,150215813281,158823951138,4282,18775,101,141607675424,In > Out
Feb 2020,160,69,64510,10662600914,136865157571,147527758485,3361,19930,24,126202556657,In > Out
Feb 2020,160,70,50141,86831592259,114543562434,201375154693,3428,18056,43,27711970175,In > Out
Feb 2020,160,71,40011,10068707816,277935326284,288004034100,3463,17307,15,267866618468,In > Out
Feb 2020,160,72,70181,17425313872,117549815767,134975129639,4698,23501,54,100124501895,In > Out
Feb 2020,160,73,17652,1075162908,37991997026,39067159934,1224,10262,3,36916834118,In > Out
Feb 2020,160,74,12478,687256651,29683460438,30370717089,838,8362,4,28996203787,In > Out
Feb 2020,160,75,17931,986016309,44810676144,45796692453,1199,10785,2,43824659835,In > Out
Feb 2020,160,76,14360,797652258,35923729272,36721381530,1137,9238,2,35126077014,In > Out
Feb 2020,160,77,11182,655493164,28770727075,29426220239,791,8087,4,28115233911,In > Out
Feb 2020,160,78,41067,2096834233,49730481843,51827316076,859,17310,3,47633647610,In > Out
Feb 2020,160,79,105387,8660079799,178015011440,186675091239,6531,17492,32,169354931641,In > Out
Feb 2020,160,80,101699,7326870066,190400118466,197726988532,5649,17592,10,183073248400,In > Out
Feb 2020,160,81,1007,132042233,919435220,1051477453,243,978,2,787392987,In > Out
Feb 2020,160,82,2683,394923651,2069017808,2463941459,421,2444,2,1674094157,In > Out
Feb 2020,160,83,498,26153737,515331161,541484898,105,487,2,489177424,In > Out
Feb 2020,160,85,758,62147762,740925624,803073386,107,722,2,678777862,In > Out
Feb 2020,160,86,1031,54634570,645573391,700207961,267,990,2,590938821,In > Out
Feb 2020,160,87,768,70812341,757948252,828760593,205,747,2,687135911,In > Out
Feb 2020,160,88,35,1522286,20284843,21807129,14,35,2,18762557,In > Out
Feb 2020,160,9,728,46268179,608215965,654484144,85,659,3,561947786,In > Out
Feb 2020,161,10,234,15392285,375243720,390636005,111,233,2,359851435,In > Out
Feb 2020,161,100,2163,294724517,5273115390,5567839907,393,2053,41,4978390873,In > Out
Feb 2020,161,102,534,1081503333,1789774004,2871277337,100,527,3,708270671,In > Out
Feb 2020,161,103,2446,167919209,3606742300,3774661509,270,2377,6,3438823091,In > Out
Feb 2020,161,105,256,76512887,1211687418,1288200305,110,253,5,1135174531,In > Out
Feb 2020,161,107,1099,187872387,7851284454,8039156841,282,1073,97,7663412067,In > Out
Feb 2020,161,109,395,791732112,1836291735,2628023847,168,395,4,1044559623,In > Out
Feb 2020,161,11,255,50796311,335464185,386260496,94,249,3,284667874,In > Out
Feb 2020,161,110,475,246791603,3122729022,3369520625,191,469,9,2875937419,In > Out
Feb 2020,161,111,857,253794182,10904369309,11158163491,290,846,5,10650575127,In > Out
Feb 2020,161,112,1510,2268261764,3341672925,5609934689,314,1485,5,1073411161,In > Out
Feb 2020,161,113,999,51661476,1983897219,2035558695,212,966,7,1932235743,In > Out
Feb 2020,161,115,193,18473562,378512605,396986167,104,193,5,360039043,In > Out
Feb 2020,161,116,456,76753945,2219162776,2295916721,127,448,3,2142408831,In > Out
Feb 2020,161,117,2350,1236890629,11655995982,12892886611,319,2299,8,10419105353,In > Out
Feb 2020,161,118,650,56222424,2030841413,2087063837,195,634,4,1974618989,In > Out
Feb 2020,161,119,353,58633032,2862908953,2921541985,130,345,4,2804275921,In > Out
Feb 2020,161,12,397,32608119,980353082,1012961201,123,396,3,947744963,In > Out
Feb 2020,161,121,597,473919916,5185194231,5659114147,158,594,8,4711274315,In > Out
Feb 2020,161,124,1076,119336582,2625873885,2745210467,365,1051,8,2506537303,In > Out
Feb 2020,161,127,770,2771504885,2740643933,5512148818,140,749,15,30860952,Out > In
Feb 2020,161,129,737,2025384929,2127927222,4153312151,185,734,8,102542293,In > Out
Feb 2020,161,13,903,232439509,4592157096,4824596605,233,891,6,4359717587,In > Out
Feb 2020,161,130,902,268872168,6812190521,7081062689,177,900,7,6543318353,In > Out
Feb 2020,161,132,1075,216260639,3218840803,3435101442,283,1047,8,3002580164,In > Out
Feb 2020,161,133,237,87686989,5422629866,5510316855,119,236,4,5334942877,In > Out
Feb 2020,161,135,429,77235937,739764661,817000598,171,423,7,662528724,In > Out
Feb 2020,161,138,1368,271997487,12842201966,13114199453,265,1349,17,12570204479,In > Out
Feb 2020,161,139,283,45840480,793255577,839096057,86,282,10,747415097,In > Out
Feb 2020,161,14,631,43745526,623705187,667450713,286,627,5,579959661,In > Out
Feb 2020,161,141,658,113743225,4784537479,4898280704,253,656,3,4670794254,In > Out
Feb 2020,161,142,312,26112780,907696042,933808822,77,309,2,881583262,In > Out
Feb 2020,161,144,613,189431935,5211849547,5401281482,312,608,4,5022417612,In > Out
Feb 2020,161,145,530,39678434,1183036907,1222715341,156,521,6,1143358473,In > Out
Feb 2020,161,147,1921,432457763,13086816272,13519274035,371,1846,17,12654358509,In > Out
Feb 2020,161,148,412,103556288,1992245131,2095801419,213,405,8,1888688843,In > Out
Feb 2020,161,151,419,431909789,3556979349,3988889138,173,413,6,3125069560,In > Out
Feb 2020,161,152,162,62306914,2540296044,2602602958,76,162,4,2477989130,In > Out
Feb 2020,161,153,843,1201359058,2470072122,3671431180,224,820,3,1268713064,In > Out
Feb 2020,161,157,504,224767388,965083013,1189850401,175,497,6,740315625,In > Out
Feb 2020,161,159,146,20579845,469907249,490487094,63,146,2,449327404,In > Out
Feb 2020,161,16,931,106748602,5485858963,5592607565,227,906,13,5379110361,In > Out
Feb 2020,161,160,516,823224298,1634218289,2457442587,182,513,35,810993991,In > Out
Feb 2020,161,161,573,305815920,2631323321,2937139241,277,559,47,2325507401,In > Out
Feb 2020,161,162,347,6175906098,6888639963,13064546061,193,347,10,712733865,In > Out
Feb 2020,161,165,754,382799218,6744467602,7127266820,236,743,7,6361668384,In > Out
Feb 2020,161,166,468,170691789,8451556324,8622248113,203,463,3,8280864535,In > Out
Feb 2020,161,167,748,531099759,7253549138,7784648897,218,737,10,6722449379,In > Out
Feb 2020,161,168,563,106174873,2775315674,2881490547,197,559,4,2669140801,In > Out
Feb 2020,161,169,338,53379299,1756983490,1810362789,144,327,14,1703604191,In > Out
Feb 2020,161,17,1099,235506964,2390797904,2626304868,259,1051,5,2155290940,In > Out
Feb 2020,161,171,230,25796332,778366997,804163329,85,229,4,752570665,In > Out
Feb 2020,161,173,813,179940699,4777806870,4957747569,224,797,8,4597866171,In > Out
Feb 2020,161,174,250,57621952,6239689755,6297311707,136,248,4,6182067803,In > Out
Feb 2020,161,176,1507,332602848,4396252028,4728854876,278,1456,7,4063649180,In > Out
Feb 2020,161,177,938,130549130,2335655167,2466204297,174,902,6,2205106037,In > Out
Feb 2020,161,178,303,96157335,1770395115,1866552450,121,301,2,1674237780,In > Out
Feb 2020,161,18,1146,147801274,6324941768,6472743042,276,1102,8,6177140494,In > Out
Feb 2020,161,180,599,226583428,2188636372,2415219800,160,585,6,1962052944,In > Out
Feb 2020,161,181,333,53703681,1734731523,1788435204,156,333,3,1681027842,In > Out
Feb 2020,161,182,1064,1317198322,11895323654,13212521976,326,993,31,10578125332,In > Out
Feb 2020,161,183,731,188943907,1236098018,1425041925,251,703,12,1047154111,In > Out
Feb 2020,161,184,552,66949360,2185608894,2252558254,209,547,5,2118659534,In > Out
Feb 2020,161,186,709,124223778,3228075436,3352299214,187,699,9,3103851658,In > Out
Feb 2020,161,187,258,45022265,1189064450,1234086715,87,258,4,1144042185,In > Out
Feb 2020,161,188,1212,214191009,5605085229,5819276238,213,1162,9,5390894220,In > Out
Feb 2020,161,189,554,184899672,4649795130,4834694802,157,550,4,4464895458,In > Out
Feb 2020,161,190,454,47620428,1310030535,1357650963,149,451,5,1262410107,In > Out
Feb 2020,161,191,375,56854297,3270977628,3327831925,138,374,4,3214123331,In > Out
Feb 2020,161,192,501,2163763763,1908095473,4071859236,195,495,8,255668290,Out > In
Feb 2020,161,193,348,86456901,1825365955,1911822856,117,343,6,1738909054,In > Out
Feb 2020,161,194,26,426202,13296466,13722668,7,26,2,12870264,In > Out
Feb 2020,161,195,293,113252870,8027715860,8140968730,126,290,6,7914462990,In > Out
Feb 2020,161,196,367,48855596,1310220357,1359075953,132,362,5,1261364761,In > Out
Feb 2020,161,197,350,150097193,460576886,610674079,88,348,3,310479693,In > Out
Feb 2020,161,198,99,38961919,2970832526,3009794445,63,99,4,2931870607,In > Out
Feb 2020,161,20,707,135036658,3319166865,3454203523,204,698,7,3184130207,In > Out
Feb 2020,161,200,287,38251307,1272843302,1311094609,83,286,2,1234591995,In > Out
Feb 2020,161,201,591,94402669,2932267664,3026670333,248,583,5,2837864995,In > Out
Feb 2020,161,202,570,164548707,7059607610,7224156317,203,564,4,6895058903,In > Out
Feb 2020,161,203,976,84633060,1792746987,1877380047,289,966,6,1708113927,In > Out
Feb 2020,161,204,728,1145130885,7383289939,8528420824,149,723,5,6238159054,In > Out
Feb 2020,161,206,570,1452975243,1420192016,2873167259,158,557,7,32783227,Out > In
Feb 2020,161,208,538,87578070,2758933061,2846511131,165,535,6,2671354991,In > Out
Feb 2020,161,209,470,56527278,2002190358,2058717636,171,457,7,1945663080,In > Out
Feb 2020,161,21,463,912234063,1430993140,2343227203,181,457,10,518759077,In > Out
Feb 2020,161,210,289,44119274,1493507785,1537627059,107,284,12,1449388511,In > Out
Feb 2020,161,211,1614,6991800644,15781461879,22773262523,321,1608,3,8789661235,In > Out
Feb 2020,161,212,1198,200467967,6716770788,6917238755,142,1188,9,6516302821,In > Out
Feb 2020,161,213,345,585557263,4165775137,4751332400,155,334,6,3580217874,In > Out
Feb 2020,161,215,522,90960559,2935098304,3026058863,152,507,6,2844137745,In > Out
Feb 2020,161,216,479,54521586,1850519404,1905040990,141,477,5,1795997818,In > Out
Feb 2020,161,217,1056,69911261,3297100861,3367012122,175,1040,8,3227189600,In > Out
Feb 2020,161,220,1122,286385923,6583119464,6869505387,343,1081,7,6296733541,In > Out
Feb 2020,161,221,581,82029176,1007529710,1089558886,214,579,13,925500534,In > Out
Feb 2020,161,24,183,13138073,415190043,428328116,88,183,7,402051970,In > Out
Feb 2020,161,25,689,877243697,4124594836,5001838533,192,675,10,3247351139,In > Out
Feb 2020,161,26,597,90365251,1086598647,1176963898,271,584,3,996233396,In > Out
Feb 2020,161,27,428,40216397,692920243,733136640,127,421,8,652703846,In > Out
Feb 2020,161,28,1573,159329604,2836526044,2995855648,255,1516,14,2677196440,In > Out
Feb 2020,161,30,682,1263312752,15168052910,16431365662,196,671,6,13904740158,In > Out
Feb 2020,161,31,181,84759353,2687339690,2772099043,94,181,3,2602580337,In > Out
Feb 2020,161,32,570,102010720,1085848578,1187859298,111,568,3,983837858,In > Out
Feb 2020,161,33,809,229676587,4448921379,4678597966,238,805,5,4219244792,In > Out
Feb 2020,161,34,1080,326065033,4655868806,4981933839,197,1067,6,4329803773,In > Out
Feb 2020,161,35,1099,144130931,4127043488,4271174419,250,1081,6,3982912557,In > Out
Feb 2020,161,36,624,107615952,3274620923,3382236875,240,618,5,3167004971,In > Out
Feb 2020,161,37,1349,195460640,3061210876,3256671516,206,1307,9,2865750236,In > Out
Feb 2020,161,38,565,35890452,1145125508,1181015960,164,557,9,1109235056,In > Out
Feb 2020,161,39,542,63927095,2119900317,2183827412,124,541,6,2055973222,In > Out
Feb 2020,161,4,371,139714988,757255448,896970436,155,369,4,617540460,In > Out
Feb 2020,161,40,279,43850069,2715629590,2759479659,120,277,3,2671779521,In > Out
Feb 2020,161,42,359,39491362,746444793,785936155,69,358,4,706953431,In > Out
Feb 2020,161,43,575,366208496,2802034194,3168242690,154,559,9,2435825698,In > Out
Feb 2020,161,44,593,184639645,2446894279,2631533924,174,590,4,2262254634,In > Out
Feb 2020,161,46,791,314250898,8191136322,8505387220,259,733,25,7876885424,In > Out
Feb 2020,161,47,207,13986070,769938761,783924831,74,207,4,755952691,In > Out
Feb 2020,161,49,1424,852553270,6931638753,7784192023,244,1376,7,6079085483,In > Out
Feb 2020,161,5,701,107191554,4744618394,4851809948,204,683,12,4637426840,In > Out
Feb 2020,161,50,984,199007080,1867571877,2066578957,178,962,9,1668564797,In > Out
Feb 2020,161,51,817,91750161,2869130886,2960881047,220,805,7,2777380725,In > Out
Feb 2020,161,52,355,33600734,773245583,806846317,124,347,5,739644849,In > Out
Feb 2020,161,53,182,159617380,1327944079,1487561459,83,178,6,1168326699,In > Out
Feb 2020,161,54,692,196958808,2368738265,2565697073,192,676,8,2171779457,In > Out
Feb 2020,161,55,886,105315732,2617998935,2723314667,288,862,5,2512683203,In > Out
Feb 2020,161,56,711,78091279,3810621835,3888713114,119,708,5,3732530556,In > Out
Feb 2020,161,57,974,160168482,8780019773,8940188255,276,904,63,8619851291,In > Out
Feb 2020,161,58,661,57345870,1782619969,1839965839,134,655,2,1725274099,In > Out
Feb 2020,161,6,429,709192344,1140888867,1850081211,133,420,14,431696523,In > Out
Feb 2020,161,60,1092,128942532,2082418605,2211361137,246,1051,8,1953476073,In > Out
Feb 2020,161,62,826,278380664,6142129617,6420510281,201,816,4,5863748953,In > Out
Feb 2020,161,63,159,63235438,1083831348,1147066786,93,158,6,1020595910,In > Out
Feb 2020,161,64,1082,142490958,6121672773,6264163731,260,1063,13,5979181815,In > Out
Feb 2020,161,65,119543,6173019268,314536839542,320709858810,1422,15951,650,308363820274,In > Out
Feb 2020,161,66,496,100264703,2229639382,2329904085,200,489,5,2129374679,In > Out
Feb 2020,161,67,633,99371971,2975523315,3074895286,177,623,6,2876151344,In > Out
Feb 2020,161,68,1483,1099596938,18401801513,19501398451,331,1438,4,17302204575,In > Out
Feb 2020,161,69,275,20002406,368189208,388191614,86,274,4,348186802,In > Out
Feb 2020,161,7,1940,568401491,5600657103,6169058594,503,1847,6,5032255612,In > Out
Feb 2020,161,70,424,74222967,1385176882,1459399849,138,421,5,1310953915,In > Out
Feb 2020,161,72,346,26519174,616527046,643046220,162,343,4,590007872,In > Out
Feb 2020,161,74,449,208705031,1596116696,1804821727,110,439,7,1387411665,In > Out
Feb 2020,161,75,1350,312548141,4115382347,4427930488,354,1298,98,3802834206,In > Out
Feb 2020,161,76,331,128946862,5446630751,5575577613,189,331,4,5317683889,In > Out
Feb 2020,161,77,1086,195225892,9704450196,9899676088,219,1072,6,9509224304,In > Out
Feb 2020,161,78,257,167823087,954583984,1122407071,119,257,6,786760897,In > Out
Feb 2020,161,8,484,127326598,1876012009,2003338607,150,479,5,1748685411,In > Out
Feb 2020,161,80,648,457467117,6546074906,7003542023,241,636,8,6088607789,In > Out
Feb 2020,161,82,402,64892484,2449958080,2514850564,161,398,5,2385065596,In > Out
Feb 2020,161,83,1167,335351106,10236495804,10571846910,396,1152,4,9901144698,In > Out
Feb 2020,161,84,392,185566439,1441269273,1626835712,128,386,5,1255702834,In > Out
Feb 2020,161,86,941,230679294,6858369488,7089048782,259,920,7,6627690194,In > Out
Feb 2020,161,87,515,100890241,4899754961,5000645202,129,508,4,4798864720,In > Out
Feb 2020,161,88,918,493184324,1498887562,1992071886,186,910,5,1005703238,In > Out
Feb 2020,161,90,827,179254339,1433058535,1612312874,186,809,15,1253804196,In > Out
Feb 2020,161,91,621,48385432,1662358739,1710744171,193,604,11,1613973307,In > Out
Feb 2020,161,94,972,1088590396,4013622734,5102213130,259,950,11,2925032338,In > Out
Feb 2020,161,95,726,65140664,2075948019,2141088683,179,726,5,2010807355,In > Out
Feb 2020,161,96,334,125146928,7672294932,7797441860,132,331,5,7547148004,In > Out
Feb 2020,161,97,340,202311687,2348443969,2550755656,98,338,6,2146132282,In > Out
Feb 2020,161,99,1849,619465103,4180018478,4799483581,324,1739,42,3560553375,In > Out
Feb 2020,163,4,3,53717,800725,854442,1,3,1,747008,In > Out
Feb 2020,164,114,19,2025504,10836004,12861508,10,19,2,8810500,In > Out
Feb 2020,164,124,89,16016988,40210968,56227956,48,84,2,24193980,In > Out
Feb 2020,164,127,112,2602695,60348108,62950803,32,112,2,57745413,In > Out
Feb 2020,164,141,30,928783,8855656,9784439,14,30,2,7926873,In > Out
Feb 2020,164,144,14,6515591,846238,7361829,3,14,2,5669353,Out > In
Feb 2020,164,147,38,411000,7303802,7714802,15,38,2,6892802,In > Out
Feb 2020,164,158,148,3742608,173007131,176749739,80,148,2,169264523,In > Out
Feb 2020,164,165,200,11560297,185392401,196952698,82,199,2,173832104,In > Out
Feb 2020,164,180,7,91097,2420299,2511396,6,7,2,2329202,In > Out
Feb 2020,164,196,535,27951926,383660367,411612293,145,526,2,355708441,In > Out
Feb 2020,164,60,221,1956094,370022807,371978901,22,220,2,368066713,In > Out
Feb 2020,164,69,72,6910594,57030704,63941298,42,72,2,50120110,In > Out
Feb 2020,164,75,642,54593686,435869652,490463338,248,631,2,381275966,In > Out
Feb 2020,164,77,87,4431821,41172490,45604311,40,87,2,36740669,In > Out
Feb 2020,164,82,14,1860411,37895340,39755751,1,14,1,36034929,In > Out
Feb 2020,164,83,13,8086211,3333271,11419482,12,6,5,4752940,Out > In
Feb 2020,165,104,17,685331,9961652,10646983,12,17,2,9276321,In > Out
Feb 2020,165,105,112,16519692,129419172,145938864,59,111,2,112899480,In > Out
Feb 2020,165,127,97,17317521,919369875,936687396,20,97,2,902052354,In > Out
Feb 2020,165,131,207,6323636,499825040,506148676,25,207,2,493501404,In > Out
Feb 2020,165,143,103,9492694,31536788,41029482,18,103,2,22044094,In > Out
Feb 2020,165,150,2602,521021841,795249471,1316271312,254,2440,2,274227630,In > Out
Feb 2020,165,152,377,20270929,492596489,512867418,167,372,5,472325560,In > Out
Feb 2020,165,153,430,137249079,2514442199,2651691278,97,427,2,2377193120,In > Out
Feb 2020,165,157,183,12154151,193189816,205343967,99,181,2,181035665,In > Out
Feb 2020,165,158,380,29772357,195205469,224977826,58,380,2,165433112,In > Out
Feb 2020,165,165,5819,640853499,6667462516,7308316015,986,4876,3,6026609017,In > Out
Feb 2020,165,172,121,5116486,81182931,86299417,38,121,2,76066445,In > Out
Feb 2020,165,184,126,6810218,193330882,200141100,51,126,2,186520664,In > Out
Feb 2020,165,187,203,10656619,165363684,176020303,76,202,2,154707065,In > Out
Feb 2020,165,193,57,2282665,109512153,111794818,17,57,2,107229488,In > Out
Feb 2020,165,198,687,97832393,172231368,270063761,82,669,2,74398975,In > Out
Feb 2020,165,199,850,100108316,1431979785,1532088101,269,835,4,1331871469,In > Out
Feb 2020,165,202,2476,451090308,5244034820,5695125128,554,2346,6,4792944512,In > Out
Feb 2020,165,233,919,230331960970,9586884292,239918845262,307,496,42,220745076678,Out > In
Feb 2020,165,251,70,12744111,8959425,21703536,10,9,3,3784686,Out > In
Feb 2020,165,38,276,39626575,132045602,171672177,117,276,2,92419027,In > Out
Feb 2020,165,42,3,45376,1190037,1235413,2,3,1,1144661,In > Out
Feb 2020,165,43,805,86687433,2225799406,2312486839,185,790,4,2139111973,In > Out
Feb 2020,165,6,22,1690691,37949577,39640268,3,22,1,36258886,In > Out
Feb 2020,165,61,709,96644346,1370491090,1467135436,135,691,3,1273846744,In > Out
Feb 2020,165,70,3819,768388603,6817758891,7586147494,730,3423,7,6049370288,In > Out
Feb 2020,165,72,7,293656,951914,1245570,6,7,1,658258,In > Out
Feb 2020,165,90,13,932300,6300566,7232866,9,13,2,5368266,In > Out
Feb 2020,165,92,609,58119297,1379944505,1438063802,234,599,1,1321825208,In > Out
Feb 2020,165,93,55,6086318,46566358,52652676,29,55,2,40480040,In > Out
Feb 2020,165,94,52,13349871,11162985,24512856,14,52,2,2186886,Out > In
Feb 2020,165,98,96,4066143,57916000,61982143,24,96,2,53849857,In > Out
Feb 2020,166,12,69,2741711,134429272,137170983,16,69,2,131687561,In > Out
Feb 2020,166,133,44,1057567,50253655,51311222,17,44,2,49196088,In > Out
Feb 2020,166,135,440,21408205,256083077,277491282,204,432,2,234674872,In > Out
Feb 2020,166,136,29,781915,34763824,35545739,7,29,2,33981909,In > Out
Feb 2020,166,138,565,53012369,604674931,657687300,130,565,4,551662562,In > Out
Feb 2020,166,144,100,1878079,112188734,114066813,21,100,2,110310655,In > Out
Feb 2020,166,15,366,17751054,247913388,265664442,141,366,2,230162334,In > Out
Feb 2020,166,152,688,94207041,255190698,349397739,172,676,2,160983657,In > Out
Feb 2020,166,153,98,54438921,542612194,597051115,59,98,2,488173273,In > Out
Feb 2020,166,154,2,41881,1984328,2026209,2,2,2,1942447,In > Out
Feb 2020,166,156,135,9362546,251215132,260577678,58,135,2,241852586,In > Out
Feb 2020,166,163,575,40068897,231719014,271787911,129,570,2,191650117,In > Out
Feb 2020,166,165,2,141930,369051,510981,2,2,2,227121,In > Out
Feb 2020,166,166,570,59209034,499653079,558862113,206,562,2,440444045,In > Out
Feb 2020,166,168,1,9705564,581064212,590769776,1,1,1,571358648,In > Out
Feb 2020,166,171,93,2143076,60356899,62499975,10,93,1,58213823,In > Out
Feb 2020,166,174,44,1272188,66590449,67862637,12,44,2,65318261,In > Out
Feb 2020,166,192,265,39175724,176471593,215647317,129,262,2,137295869,In > Out
Feb 2020,166,193,32,1650398,25526548,27176946,13,32,2,23876150,In > Out
Feb 2020,166,197,495,58832213,430503654,489335867,157,493,2,371671441,In > Out
Feb 2020,166,198,20,5670711,10526653,16197364,11,20,2,4855942,In > Out
Feb 2020,166,206,457,809398181,345912354,1155310535,203,451,2,463485827,Out > In
Feb 2020,166,207,684,51599207,462225079,513824286,263,678,2,410625872,In > Out
Feb 2020,166,35,59,2305851,54466970,56772821,23,59,2,52161119,In > Out
Feb 2020,167,121,63,1628145,84620073,86248218,18,63,2,82991928,In > Out
Feb 2020,167,124,780,74829116,942103226,1016932342,182,739,5,867274110,In > Out
Feb 2020,167,126,861,364144911,386392251,750537162,161,839,2,22247340,In > Out
Feb 2020,167,127,14,1183743,45534733,46718476,7,14,2,44350990,In > Out
Feb 2020,167,143,825,38200684,1043165221,1081365905,144,814,17,1004964537,In > Out
Feb 2020,167,144,4,57782,4575539,4633321,3,4,2,4517757,In > Out
Feb 2020,167,146,383,35209965,352742750,387952715,74,381,2,317532785,In > Out
Feb 2020,167,148,407,30966665,422115104,453081769,123,405,2,391148439,In > Out
Feb 2020,167,153,532,62527536,460046326,522573862,210,526,4,397518790,In > Out
Feb 2020,167,156,27,4716691,252187397,256904088,13,27,2,247470706,In > Out
Feb 2020,167,160,416,233923563,594374096,828297659,117,410,2,360450533,In > Out
Feb 2020,167,169,31,1413439,32482989,33896428,18,31,2,31069550,In > Out
Feb 2020,167,177,18,496895,4153415,4650310,6,18,2,3656520,In > Out
Feb 2020,167,186,24,2210479,16381091,18591570,13,24,3,14170612,In > Out
Feb 2020,167,232,808,49115452,782710859,831826311,211,785,2,733595407,In > Out
Feb 2020,167,235,76,737917,67863304,68601221,20,76,2,67125387,In > Out
Feb 2020,167,35,22,722239,33373357,34095596,11,22,2,32651118,In > Out
Feb 2020,167,37,1165,191310240,419586959,610897199,184,1123,2,228276719,In > Out
Feb 2020,167,40,422,26535739,459442293,485978032,176,420,2,432906554,In > Out
Feb 2020,167,50,36,7870392,234410056,242280448,19,36,2,226539664,In > Out
Feb 2020,168,101,8,262597,11040044,11302641,3,8,1,10777447,In > Out
Feb 2020,168,112,36,843541,6453321,7296862,2,36,2,5609780,In > Out
Feb 2020,168,114,129,5333447,87712615,93046062,60,128,2,82379168,In > Out
Feb 2020,168,116,141,21780484,628241368,650021852,67,141,2,606460884,In > Out
Feb 2020,168,13,1081,133803206,1785605497,1919408703,317,1058,4,1651802291,In > Out
Feb 2020,168,130,1555,647455564,2149976337,2797431901,352,1488,2,1502520773,In > Out
Feb 2020,168,132,40,701218,36116356,36817574,15,40,2,35415138,In > Out
Feb 2020,168,136,1341,325426190,234549899,559976089,143,1301,2,90876291,Out > In
Feb 2020,168,138,1365,202842005,389064796,591906801,204,1320,2,186222791,In > Out
Feb 2020,168,141,671,10280843135,1562726671,11843569806,90,659,4,8718116464,Out > In
Feb 2020,168,143,25,2968004,106999097,109967101,17,25,2,104031093,In > Out
Feb 2020,168,153,319,24944704747,1520071477,26464776224,27,319,4,23424633270,Out > In
Feb 2020,168,154,52,1065625,33499605,34565230,30,51,2,32433980,In > Out
Feb 2020,168,155,5982,6679910893,370698056,7050608949,1242,514,4950,6309212837,Out > In
Feb 2020,168,161,43,4600480,71519370,76119850,24,43,2,66918890,In > Out
Feb 2020,168,162,101,17760168,257316348,275076516,25,101,3,239556180,In > Out
Feb 2020,168,164,31,1103521,13965706,15069227,14,31,2,12862185,In > Out
Feb 2020,168,170,187,597565957,86906081,684472038,98,186,2,510659876,Out > In
Feb 2020,168,171,685,115153545,204686303,319839848,125,672,2,89532758,In > Out
Feb 2020,168,173,57,7833742,269836153,277669895,12,57,2,262002411,In > Out
Feb 2020,168,176,13,668830,3128661,3797491,7,13,2,2459831,In > Out
Feb 2020,168,180,70,3610925,47910944,51521869,36,70,2,44300019,In > Out
Feb 2020,168,186,22,30625203,1113944,31739147,3,2,22,29511259,Out > In
Feb 2020,168,187,451,23313642,1155798335,1179111977,124,447,2,1132484693,In > Out
Feb 2020,168,188,431,28179084,388773088,416952172,198,428,2,360594004,In > Out
Feb 2020,168,195,50,854457,31838446,32692903,20,50,2,30983989,In > Out
Feb 2020,168,198,164,3377413,94701586,98078999,86,164,2,91324173,In > Out
Feb 2020,168,200,260,13545137,139164009,152709146,138,255,3,125618872,In > Out
Feb 2020,168,201,859,658840658,1736511590,2395352248,62,859,2,1077670932,In > Out
Feb 2020,168,202,48,2461629,50745284,53206913,28,48,2,48283655,In > Out
Feb 2020,168,209,257,18000499,102312331,120312830,39,257,2,84311832,In > Out
Feb 2020,168,21,37,2657105,92660002,95317107,18,37,2,90002897,In > Out
Feb 2020,168,213,5,1190153,165408171,166598324,3,5,2,164218018,In > Out
Feb 2020,168,222,42,303696,47417848,47721544,15,42,2,47114152,In > Out
Feb 2020,168,23,216,9458396,262510311,271968707,104,215,3,253051915,In > Out
Feb 2020,168,26,7,248379,1526310,1774689,6,7,2,1277931,In > Out
Feb 2020,168,32,980,76204697,1223711646,1299916343,264,956,2,1147506949,In > Out
Feb 2020,168,41,58,3413460,59594522,63007982,22,58,2,56181062,In > Out
Feb 2020,168,48,2,5770,216833,222603,2,2,1,211063,In > Out
Feb 2020,168,50,164,11719974,89103594,100823568,67,164,2,77383620,In > Out
Feb 2020,168,53,5041,212210261,1024583086,1236793347,213,4377,3,812372825,In > Out
Feb 2020,168,57,9,1560640,2500202,4060842,8,5,5,939562,In > Out
Feb 2020,168,58,25,1207545,7460020,8667565,21,25,1,6252475,In > Out
Feb 2020,168,60,3,32634,640574,673208,3,3,1,607940,In > Out
Feb 2020,168,7,34,943831,19993902,20937733,23,34,2,19050071,In > Out
Feb 2020,168,79,392,27136986,314546717,341683703,179,391,2,287409731,In > Out
Feb 2020,168,80,64,33362212,57099437,90461649,40,64,2,23737225,In > Out
Feb 2020,168,82,367,14546122,621695528,636241650,30,367,2,607149406,In > Out
Feb 2020,168,85,85,2163733,56605652,58769385,47,85,2,54441919,In > Out
Feb 2020,168,9,126,8351420,204585554,212936974,66,125,2,196234134,In > Out
Feb 2020,168,96,267,21767535,266067411,287834946,127,265,2,244299876,In > Out
Feb 2020,168,98,541,35865491,239387974,275253465,104,540,2,203522483,In > Out
Feb 2020,169,154,3,451505,544321,995826,3,3,1,92816,In > Out
Feb 2020,169,156,571,39594697,2646914375,2686509072,122,564,3,2607319678,In > Out
Feb 2020,169,157,183,11425433,1250725005,1262150438,79,183,2,1239299572,In > Out
Feb 2020,169,162,1,42222,2872156,2914378,1,1,1,2829934,In > Out
Feb 2020,169,163,75,1328947,79012090,80341037,15,75,2,77683143,In > Out
Feb 2020,169,164,378,25402615,169479761,194882376,83,374,2,144077146,In > Out
Feb 2020,169,173,1,107261,15118,122379,1,1,1,92143,Out > In
Feb 2020,169,185,69,4279307,37001599,41280906,53,69,2,32722292,In > Out
Feb 2020,169,186,519,55467363,520491116,575958479,131,508,2,465023753,In > Out
Feb 2020,169,187,112,6859687,82981257,89840944,60,111,2,76121570,In > Out
Feb 2020,169,188,31,3595312,92710524,96305836,10,31,2,89115212,In > Out
Feb 2020,169,193,111,3579775,227277051,230856826,18,111,2,223697276,In > Out
Feb 2020,169,194,5825,119224353902,3622031964,122846385866,185,4873,2,115602321938,Out > In
Feb 2020,169,196,187,7621203,720996640,728617843,18,186,2,713375437,In > Out
Feb 2020,169,6,23549,98583557499,105299536611,203883094110,1553,14052,4,6715979112,In > Out
Feb 2020,169,8,81,13963273964,682864549,14646138513,27,6,40,13280409415,Out > In
Feb 2020,169,85,4,569166,17847863,18417029,3,4,2,17278697,In > Out
Feb 2020,169,87,2,146609,19143890,19290499,2,2,2,18997281,In > Out
Feb 2020,170,116,682,72823072,481911935,554735007,171,585,2,409088863,In > Out
Feb 2020,170,129,2246,648174972,14106825187,14755000159,548,2063,8,13458650215,In > Out
Feb 2020,170,13,66,1697518,181252425,182949943,31,66,2,179554907,In > Out
Feb 2020,170,149,8,156773,4325335,4482108,6,8,2,4168562,In > Out
Feb 2020,170,154,174,5163691,170161162,175324853,46,173,2,164997471,In > Out
Feb 2020,170,155,16,568795,59789573,60358368,7,15,2,59220778,In > Out
Feb 2020,170,157,85,4573659,178361212,182934871,40,84,2,173787553,In > Out
Feb 2020,170,164,261,27229042,207614493,234843535,144,261,3,180385451,In > Out
Feb 2020,170,166,13,923221,5511784,6435005,10,13,2,4588563,In > Out
Feb 2020,170,174,442,106899599,261177911,368077510,194,438,2,154278312,In > Out
Feb 2020,170,181,393,100216174,148562790,248778964,93,386,2,48346616,In > Out
Feb 2020,170,19,12,550604,1964745,2515349,4,12,1,1414141,In > Out
Feb 2020,170,194,1388,130747868,2870738796,3001486664,306,1344,7,2739990928,In > Out
Feb 2020,170,197,1,26796,2514609,2541405,1,1,1,2487813,In > Out
Feb 2020,170,205,149,18440482,227991769,246432251,39,140,2,209551287,In > Out
Feb 2020,170,207,445,236649395,528985751,765635146,194,438,3,292336356,In > Out
Feb 2020,170,208,1462,396298294,374471976,770770270,123,1404,2,21826318,Out > In
Feb 2020,170,209,20,353900,10081944,10435844,15,20,2,9728044,In > Out
Feb 2020,170,220,52,4174410,164806431,168980841,21,51,2,160632021,In > Out
Feb 2020,170,221,31,13913115,948641561,962554676,25,31,2,934728446,In > Out
Feb 2020,170,227,5,215252,522320,737572,5,5,1,307068,In > Out
Feb 2020,170,230,56,4363589,466583658,470947247,21,55,2,462220069,In > Out
Feb 2020,170,233,262,406846371,443350368,850196739,111,257,2,36503997,In > Out
Feb 2020,170,234,8,53055,4371140,4424195,4,8,1,4318085,In > Out
Feb 2020,170,236,262,25994133,141521770,167515903,108,261,2,115527637,In > Out
Feb 2020,170,237,247,14919674,239619024,254538698,124,246,2,224699350,In > Out
Feb 2020,170,241,2701,111765904,1787016333,1898782237,324,2495,4,1675250429,In > Out
Feb 2020,170,244,250,23324385,332717274,356041659,105,243,2,309392889,In > Out
Feb 2020,170,247,503,33471438,338831883,372303321,218,496,2,305360445,In > Out
Feb 2020,170,30,47,1404603,75675738,77080341,15,47,2,74271135,In > Out
Feb 2020,170,34,6,248406,15490075,15738481,5,6,1,15241669,In > Out
Feb 2020,170,37,14,560908,2577199,3138107,8,14,2,2016291,In > Out
Feb 2020,170,42,621,48799085,1278109831,1326908916,197,610,4,1229310746,In > Out
Feb 2020,170,45,439,266848182,523149621,789997803,225,333,3,256301439,In > Out
Feb 2020,170,49,16,427380,7064182,7491562,13,16,2,6636802,In > Out
Feb 2020,170,57,25,1767690,7623568,9391258,15,25,1,5855878,In > Out
Feb 2020,170,59,1259,30715437,220052964,250768401,2,1240,1,189337527,In > Out
Feb 2020,170,63,55,4819479,28381740,33201219,38,55,2,23562261,In > Out
Feb 2020,170,65,4,206694,4334335,4541029,4,4,2,4127641,In > Out
Feb 2020,170,68,182,13615326,79406698,93022024,87,182,2,65791372,In > Out
Feb 2020,170,73,421,55191051,3588273667,3643464718,159,405,2,3533082616,In > Out
Feb 2020,170,81,55,2676404,307624967,310301371,25,55,2,304948563,In > Out
Feb 2020,171,10,1000,248506328,6346730697,6595237025,242,971,36,6098224369,In > Out
Feb 2020,171,100,186,55288350,633874046,689162396,98,186,4,578585696,In > Out
Feb 2020,171,101,719,281859625,3510121617,3791981242,190,692,8,3228261992,In > Out
Feb 2020,171,102,475,121844611,1489472684,1611317295,147,472,6,1367628073,In > Out
Feb 2020,171,103,523,37953294,1108488837,1146442131,98,514,10,1070535543,In > Out
Feb 2020,171,104,928,65646793,3157497349,3223144142,254,910,9,3091850556,In > Out
Feb 2020,171,105,779,81107672,1665791440,1746899112,242,770,6,1584683768,In > Out
Feb 2020,171,107,514,81250983,1999082045,2080333028,191,504,8,1917831062,In > Out
Feb 2020,171,108,921,141556336,4691045524,4832601860,343,912,5,4549489188,In > Out
Feb 2020,171,109,3267,396347672,11744462876,12140810548,472,3019,76,11348115204,In > Out
Feb 2020,171,112,542,99500328,2026056939,2125557267,243,531,7,1926556611,In > Out
Feb 2020,171,114,774,127507135,2912690074,3040197209,162,763,4,2785182939,In > Out
Feb 2020,171,115,666,292604109,1958064896,2250669005,161,661,7,1665460787,In > Out
Feb 2020,171,116,547,99866660,5779222864,5879089524,213,530,4,5679356204,In > Out
Feb 2020,171,118,223,178799645,8428255811,8607055456,87,223,4,8249456166,In > Out
Feb 2020,171,119,573,78854191,2835764486,2914618677,220,563,3,2756910295,In > Out
Feb 2020,171,120,738,259857654,4304013859,4563871513,270,722,20,4044156205,In > Out
Feb 2020,171,122,209,21877944,492930080,514808024,76,204,10,471052136,In > Out
Feb 2020,171,123,671,49133941,1181240042,1230373983,163,651,3,1132106101,In > Out
Feb 2020,171,125,148,28344648,542840789,571185437,81,147,5,514496141,In > Out
Feb 2020,171,127,1091,802744925,3903209715,4705954640,246,1061,6,3100464790,In > Out
Feb 2020,171,128,980,1375799999,4612340260,5988140259,334,952,34,3236540261,In > Out
Feb 2020,171,129,1763,317008449,4395965850,4712974299,238,1643,12,4078957401,In > Out
Feb 2020,171,13,761,179941097,1867869753,2047810850,230,752,12,1687928656,In > Out
Feb 2020,171,130,901,396732784,3433583772,3830316556,241,883,10,3036850988,In > Out
Feb 2020,171,131,507,127076151,7101394298,7228470449,199,500,4,6974318147,In > Out
Feb 2020,171,132,322,38609647,604459784,643069431,101,319,5,565850137,In > Out
Feb 2020,171,133,165,613012548,10095470372,10708482920,90,165,10,9482457824,In > Out
Feb 2020,171,134,1577,301227896,10009983692,10311211588,367,1508,15,9708755796,In > Out
Feb 2020,171,135,219,296210916,1034002247,1330213163,90,219,6,737791331,In > Out
Feb 2020,171,136,1003,665145530,3190626253,3855771783,173,979,9,2525480723,In > Out
Feb 2020,171,137,261,41457763,751084386,792542149,97,261,3,709626623,In > Out
Feb 2020,171,138,2910,191125086,16052077508,16243202594,231,2815,6,15860952422,In > Out
Feb 2020,171,139,491,63255994,2150757960,2214013954,164,481,4,2087501966,In > Out
Feb 2020,171,140,465,107392231,2839689313,2947081544,149,461,5,2732297082,In > Out
Feb 2020,171,141,1515,1872087134,4544317485,6416404619,320,1446,12,2672230351,In > Out
Feb 2020,171,142,394,192555523,504755989,697311512,164,392,5,312200466,In > Out
Feb 2020,171,143,385,26266039,1408324612,1434590651,164,385,6,1382058573,In > Out
Feb 2020,171,144,328,69034300,1415536295,1484570595,113,328,4,1346501995,In > Out
Feb 2020,171,145,262,97415124,2608872008,2706287132,105,262,7,2511456884,In > Out
Feb 2020,171,146,464,47529752,2357435304,2404965056,164,463,5,2309905552,In > Out
Feb 2020,171,147,131,27273007,1500917640,1528190647,58,131,4,1473644633,In > Out
Feb 2020,171,148,510,84941985,2536601130,2621543115,255,506,6,2451659145,In > Out
Feb 2020,171,149,533,322750955,5815663435,6138414390,245,528,5,5492912480,In > Out
Feb 2020,171,15,328,41214968,1526419184,1567634152,137,324,5,1485204216,In > Out
Feb 2020,171,150,474,290449973,519667206,810117179,169,471,5,229217233,In > Out
Feb 2020,171,151,725,92352539,2527774591,2620127130,262,674,13,2435422052,In > Out
Feb 2020,171,152,303,309212435,1128491649,1437704084,133,300,7,819279214,In > Out
Feb 2020,171,153,264,39247477,1525915347,1565162824,125,264,7,1486667870,In > Out
Feb 2020,171,154,302,2136793711,2693944515,4830738226,135,298,3,557150804,In > Out
Feb 2020,171,156,109,14675730,198615469,213291199,59,109,4,183939739,In > Out
Feb 2020,171,157,735,152203316,5189588453,5341791769,211,732,5,5037385137,In > Out
Feb 2020,171,158,708,576078833,1292748043,1868826876,173,704,6,716669210,In > Out
Feb 2020,171,159,302,17154511,398227312,415381823,108,297,5,381072801,In > Out
Feb 2020,171,16,509,90812129,3017424802,3108236931,158,503,10,2926612673,In > Out
Feb 2020,171,161,901,382419867,3328660127,3711079994,259,882,5,2946240260,In > Out
Feb 2020,171,163,365,222269226,3184980096,3407249322,132,363,4,2962710870,In > Out
Feb 2020,171,164,943,429106843,3915899694,4345006537,226,922,5,3486792851,In > Out
Feb 2020,171,165,775,100360688,5762066156,5862426844,162,767,6,5661705468,In > Out
Feb 2020,171,166,507,203547308,1248852395,1452399703,210,503,9,1045305087,In > Out
Feb 2020,171,167,1501,384343340,6789573108,7173916448,315,1482,7,6405229768,In > Out
Feb 2020,171,168,170,19130806,457631657,476762463,96,169,5,438500851,In > Out
Feb 2020,171,17,589,1217423386,7691441660,8908865046,284,540,33,6474018274,In > Out
Feb 2020,171,170,366,100326908,1614965270,1715292178,98,319,7,1514638362,In > Out
Feb 2020,171,171,534,78134109,3986359595,4064493704,199,530,4,3908225486,In > Out
Feb 2020,171,172,2774,126761894,3745598208,3872360102,305,2675,4,3618836314,In > Out
Feb 2020,171,173,623,100572899,3870409204,3970982103,221,615,7,3769836305,In > Out
Feb 2020,171,174,717,141915991,4330771531,4472687522,248,711,6,4188855540,In > Out
Feb 2020,171,175,791,102207245,3519755942,3621963187,171,786,6,3417548697,In > Out
Feb 2020,171,177,535,166277330,1001892267,1168169597,184,530,5,835614937,In > Out
Feb 2020,171,179,1162,227420697,8334234190,8561654887,202,1138,7,8106813493,In > Out
Feb 2020,171,181,224,37276538,618206893,655483431,99,223,4,580930355,In > Out
Feb 2020,171,184,728,81345154,1441011229,1522356383,227,713,7,1359666075,In > Out
Feb 2020,171,185,1166,382708156,11875282311,12257990467,247,1137,11,11492574155,In > Out
Feb 2020,171,186,592,119047793,6583619073,6702666866,197,583,4,6464571280,In > Out
Feb 2020,171,187,251,43860182,1721936952,1765797134,127,205,50,1678076770,In > Out
Feb 2020,171,188,309,19354061,567849953,587204014,111,307,5,548495892,In > Out
Feb 2020,171,19,433,67409711,3159277216,3226686927,109,432,6,3091867505,In > Out
Feb 2020,171,190,457,460849230,1115190651,1576039881,167,447,20,654341421,In > Out
Feb 2020,171,194,947,1159966261,7373067294,8533033555,295,818,62,6213101033,In > Out
Feb 2020,171,196,363,78305751,1606355507,1684661258,163,355,3,1528049756,In > Out
Feb 2020,171,202,1046,166083946,4125695606,4291779552,201,1012,4,3959611660,In > Out
Feb 2020,171,203,1103,125757505,5282277644,5408035149,330,1072,9,5156520139,In > Out
Feb 2020,171,204,79,5328724,90396120,95724844,27,79,2,85067396,In > Out
Feb 2020,171,205,672,219171621,1187638339,1406809960,238,667,7,968466718,In > Out
Feb 2020,171,206,930,388617734,2035828403,2424446137,181,922,8,1647210669,In > Out
Feb 2020,171,207,490,89889331,2281217704,2371107035,186,478,6,2191328373,In > Out
Feb 2020,171,208,180,30414864,620130780,650545644,66,180,4,589715916,In > Out
Feb 2020,171,209,2059,138772444,4220130273,4358902717,193,1991,3,4081357829,In > Out
Feb 2020,171,210,862,190755367,3563915033,3754670400,195,857,6,3373159666,In > Out
Feb 2020,171,211,424,40162365,2031389563,2071551928,148,420,4,1991227198,In > Out
Feb 2020,171,212,929,278360687,11307559522,11585920209,318,910,5,11029198835,In > Out
Feb 2020,171,213,686,130845249,6098108624,6228953873,278,676,3,5967263375,In > Out
Feb 2020,171,215,753,788838520,17115547256,17904385776,249,722,20,16326708736,In > Out
Feb 2020,171,216,230,25070417,462914989,487985406,95,229,5,437844572,In > Out
Feb 2020,171,22,772,339379722,1595475531,1934855253,219,749,11,1256095809,In > Out
Feb 2020,171,221,396,41981609,2975133542,3017115151,187,394,7,2933151933,In > Out
Feb 2020,171,222,914,212505185,4741968414,4954473599,260,889,5,4529463229,In > Out
Feb 2020,171,223,503,930496990,1419016536,2349513526,211,496,8,488519546,In > Out
Feb 2020,171,23,1513,160626253,5150291358,5310917611,343,1485,11,4989665105,In > Out
Feb 2020,171,27,706,222283231,7468404730,7690687961,233,695,4,7246121499,In > Out
Feb 2020,171,30,451,237890594,907681147,1145571741,214,449,8,669790553,In > Out
Feb 2020,171,31,2093,722582637,8013216549,8735799186,336,1992,11,7290633912,In > Out
Feb 2020,171,33,360,60662791,2042031866,2102694657,154,360,5,1981369075,In > Out
Feb 2020,171,35,882,83871106,2350411512,2434282618,225,870,5,2266540406,In > Out
Feb 2020,171,36,149,23050441,581733969,604784410,50,149,2,558683528,In > Out
Feb 2020,171,37,551,117912172,3503783280,3621695452,175,543,5,3385871108,In > Out
Feb 2020,171,40,820,1445291335,5205184595,6650475930,216,784,6,3759893260,In > Out
Feb 2020,171,41,2218,158821040,5651363982,5810185022,321,2156,11,5492542942,In > Out
Feb 2020,171,42,845,239954536,1116052235,1356006771,170,838,7,876097699,In > Out
Feb 2020,171,44,465,43316720,1394481068,1437797788,156,463,4,1351164348,In > Out
Feb 2020,171,45,692,48610359,1739542736,1788153095,187,689,5,1690932377,In > Out
Feb 2020,171,46,1380,905629232,4802691278,5708320510,330,1322,4,3897062046,In > Out
Feb 2020,171,47,676,709470948,1174027601,1883498549,215,654,8,464556653,In > Out
Feb 2020,171,48,1581,341263775,3560792378,3902056153,445,1518,23,3219528603,In > Out
Feb 2020,171,49,334,54553308,1108336122,1162889430,143,328,5,1053782814,In > Out
Feb 2020,171,5,822,400933936,21490450648,21891384584,220,809,6,21089516712,In > Out
Feb 2020,171,50,654,38282024,541286084,579568108,202,642,6,503004060,In > Out
Feb 2020,171,54,627,1730445443,21696044431,23426489874,202,615,4,19965598988,In > Out
Feb 2020,171,57,547,829240072,4733229899,5562469971,187,541,10,3903989827,In > Out
Feb 2020,171,58,352,38626879,2129180981,2167807860,123,351,4,2090554102,In > Out
Feb 2020,171,59,943,152734628,1822923121,1975657749,236,903,13,1670188493,In > Out
Feb 2020,171,6,490,297357128,866532340,1163889468,123,484,4,569175212,In > Out
Feb 2020,171,60,743,104812103,3731544300,3836356403,175,729,9,3626732197,In > Out
Feb 2020,171,63,738,421038453,6180589924,6601628377,221,726,6,5759551471,In > Out
Feb 2020,171,64,1016,222063351,3798364442,4020427793,273,988,4,3576301091,In > Out
Feb 2020,171,65,657,1675307446,9296834452,10972141898,267,650,8,7621527006,In > Out
Feb 2020,171,66,313,291365682,8467874371,8759240053,116,311,3,8176508689,In > Out
Feb 2020,171,67,692,611640177,4878060839,5489701016,245,680,8,4266420662,In > Out
Feb 2020,171,71,586,199422508,10475882349,10675304857,200,579,2,10276459841,In > Out
Feb 2020,171,72,554,152467787,3225139722,3377607509,169,545,4,3072671935,In > Out
Feb 2020,171,74,1028,473816674,3034051457,3507868131,336,1010,10,2560234783,In > Out
Feb 2020,171,75,828,149274563,6484678196,6633952759,210,816,5,6335403633,In > Out
Feb 2020,171,76,105,75489835,5679239169,5754729004,57,103,3,5603749334,In > Out
Feb 2020,171,77,1048,316586699,10246761400,10563348099,305,1025,4,9930174701,In > Out
Feb 2020,171,78,1295,711269698,9758309104,10469578802,230,1236,5,9047039406,In > Out
Feb 2020,171,79,1503,619371813,11805523926,12424895739,470,1485,4,11186152113,In > Out
Feb 2020,171,81,879,509719443,2388852828,2898572271,367,859,3,1879133385,In > Out
Feb 2020,171,82,1121,195070017,11314475063,11509545080,222,1093,5,11119405046,In > Out
Feb 2020,171,84,508,127544074,4624575583,4752119657,113,507,4,4497031509,In > Out
Feb 2020,171,85,764,134950940,1717483365,1852434305,190,752,5,1582532425,In > Out
Feb 2020,171,86,1511,164005127,2415780445,2579785572,306,1467,6,2251775318,In > Out
Feb 2020,171,87,392,191895887,1191767501,1383663388,163,392,4,999871614,In > Out
Feb 2020,171,88,1707,452780823,5213047809,5665828632,371,1629,12,4760266986,In > Out
Feb 2020,171,91,620,132456787,2218698249,2351155036,295,618,17,2086241462,In > Out
Feb 2020,171,92,696,759688206,4652715791,5412403997,244,690,16,3893027585,In > Out
Feb 2020,171,93,289,25168630,1625238988,1650407618,85,284,5,1600070358,In > Out
Feb 2020,171,95,518,38236045,1031965452,1070201497,197,511,7,993729407,In > Out
Feb 2020,171,96,598,163711451,7320131169,7483842620,225,596,4,7156419718,In > Out
Feb 2020,171,98,958,95481861,1871816645,1967298506,255,947,5,1776334784,In > Out
Feb 2020,171,99,770,154928222,14527328480,14682256702,299,766,3,14372400258,In > Out
Feb 2020,172,26,47,13663272,415187453,428850725,9,47,2,401524181,In > Out
Feb 2020,173,168,103,8011404,108368802,116380206,69,102,2,100357398,In > Out
Feb 2020,173,182,54,7290124,354848873,362138997,25,52,2,347558749,In > Out
Feb 2020,173,183,814,51321080,373799361,425120441,224,802,2,322478281,In > Out
Feb 2020,173,193,805,79135984,2124289988,2203425972,192,787,2,2045154004,In > Out
Feb 2020,173,201,168,21931724,101858091,123789815,57,167,2,79926367,In > Out
Feb 2020,173,203,306,86519301,471063007,557582308,140,305,4,384543706,In > Out
Feb 2020,173,220,204,18206491,184574856,202781347,113,191,3,166368365,In > Out
Feb 2020,173,70,462,85567801,3240460565,3326028366,49,462,3,3154892764,In > Out
Feb 2020,174,109,420,42621303,490532612,533153915,161,411,2,447911309,In > Out
Feb 2020,174,118,109,7403809,213425385,220829194,45,108,2,206021576,In > Out
Feb 2020,174,172,137,23136312,473717952,496854264,68,137,2,450581640,In > Out
Feb 2020,174,184,114,21124005,110354070,131478075,7,19,3,89230065,In > Out
Feb 2020,175,192,321,240222829,231495540,471718369,63,315,4,8727289,Out > In
Feb 2020,175,246,264,114283464,3255051264,3369334728,74,263,39,3140767800,In > Out
Feb 2020,175,32,19,934031,14287601,15221632,12,19,2,13353570,In > Out
Feb 2020,176,126,4,111463,650570,762033,2,4,1,539107,In > Out
Feb 2020,176,176,9,508843,34246853,34755696,5,9,2,33738010,In > Out
Feb 2020,176,217,100,14899729,168105075,183004804,47,98,2,153205346,In > Out
Feb 2020,176,51,535,26083631,283302764,309386395,165,532,2,257219133,In > Out
Feb 2020,176,74,247,10937037,264706829,275643866,83,246,2,253769792,In > Out
Feb 2020,176,94,376,23742678,416838739,440581417,147,373,3,393096061,In > Out
Feb 2020,177,113,64,2187688,77532347,79720035,21,63,2,75344659,In > Out
Feb 2020,177,174,46,165892338,130581525,296473863,2,46,3,35310813,Out > In
Feb 2020,178,120,236,9553917,126136291,135690208,63,236,2,116582374,In > Out
Feb 2020,178,121,418,186484020,347467629,533951649,133,414,2,160983609,In > Out
Feb 2020,178,123,1405,523169554,4211103301,4734272855,220,1346,3,3687933747,In > Out
Feb 2020,178,134,11,915128,3710252,4625380,7,11,2,2795124,In > Out
Feb 2020,178,151,355,69886687,159484931,229371618,105,347,2,89598244,In > Out
Feb 2020,178,198,768,51644959,1006767076,1058412035,255,754,3,955122117,In > Out
Feb 2020,178,209,82,1818887,70889239,72708126,25,82,2,69070352,In > Out
Feb 2020,178,219,2,35674,1775909,1811583,2,2,1,1740235,In > Out
Feb 2020,178,28,350,89574383,369959844,459534227,166,324,4,280385461,In > Out
Feb 2020,178,29,130,16390867,301861365,318252232,23,129,2,285470498,In > Out
Feb 2020,178,31,21,657202,7070745,7727947,6,21,1,6413543,In > Out
Feb 2020,178,4,755,237636849,2753291544,2990928393,153,741,2,2515654695,In > Out
Feb 2020,178,41,177,3645680,193510611,197156291,19,177,2,189864931,In > Out
Feb 2020,178,47,1,248502,18952,267454,1,1,1,229550,Out > In
Feb 2020,178,50,199,13214442,38200939,51415381,27,199,1,24986497,In > Out
Feb 2020,178,52,135,2683987,149589917,152273904,18,135,2,146905930,In > Out
Feb 2020,178,55,141,15880844,166859739,182740583,62,141,2,150978895,In > Out
Feb 2020,178,66,80,4137364,171807567,175944931,29,78,2,167670203,In > Out
Feb 2020,178,76,74,1800727,68398770,70199497,26,67,2,66598043,In > Out
Feb 2020,178,78,394,46828707,237974522,284803229,162,390,2,191145815,In > Out
Feb 2020,178,97,362,608383658,57972336106,58580719764,49,351,2,57363952448,In > Out
Feb 2020,179,108,183,6396394,199431245,205827639,92,183,2,193034851,In > Out
Feb 2020,179,111,832,102885620,1730520600,1833406220,251,807,3,1627634980,In > Out
Feb 2020,179,127,42,2085652,136824917,138910569,11,42,2,134739265,In > Out
Feb 2020,179,160,2559,3615651499,658796911,4274448410,1144,89,2079,2956854588,Out > In
Feb 2020,179,162,337,109397705,9738942087,9848339792,124,333,5,9629544382,In > Out
Feb 2020,179,172,693,194689206,7724106765,7918795971,137,689,4,7529417559,In > Out
Feb 2020,179,184,3,1231086,37303844,38534930,2,3,1,36072758,In > Out
Feb 2020,179,192,1768,135370723,709814596,845185319,331,1675,2,574443873,In > Out
Feb 2020,179,194,181,7281608,108167076,115448684,108,179,2,100885468,In > Out
Feb 2020,179,199,309,17027988,561892037,578920025,146,307,4,544864049,In > Out
Feb 2020,179,211,852,126365694,472821491,599187185,165,828,2,346455797,In > Out
Feb 2020,179,212,4,132646,4126955,4259601,2,4,1,3994309,In > Out
Feb 2020,179,43,286,29409220,617948815,647358035,107,284,2,588539595,In > Out
Feb 2020,179,44,9,651777323,421862701,1073640024,1,9,9,229914622,Out > In
Feb 2020,179,52,1257,159098531,2873535822,3032634353,175,1209,2,2714437291,In > Out
Feb 2020,179,56,52,2495401,50906476,53401877,38,52,2,48411075,In > Out
Feb 2020,179,68,8,132745,14283347,14416092,5,8,2,14150602,In > Out
Feb 2020,179,73,172,45956560,173151509,219108069,81,168,2,127194949,In > Out
Feb 2020,179,87,149,11808772,526505465,538314237,55,149,2,514696693,In > Out
Feb 2020,180,113,55,5049478,191390354,196439832,25,53,2,186340876,In > Out
Feb 2020,180,119,73,1464315,73389567,74853882,27,73,2,71925252,In > Out
Feb 2020,180,140,580,67507966,672849048,740357014,130,571,2,605341082,In > Out
Feb 2020,180,144,354,84648648,214982060,299630708,90,352,2,130333412,In > Out
Feb 2020,180,155,287,44946683,956568622,1001515305,80,284,2,911621939,In > Out
Feb 2020,180,159,467,113004287,414963080,527967367,124,462,2,301958793,In > Out
Feb 2020,180,161,79,4157333,145349365,149506698,24,78,2,141192032,In > Out
Feb 2020,180,165,162,5439021,105216843,110655864,62,162,2,99777822,In > Out
Feb 2020,180,169,55,2629403,166935767,169565170,18,55,2,164306364,In > Out
Feb 2020,180,174,8,14910934,508958535,523869469,8,8,1,494047601,In > Out
Feb 2020,180,175,304,80671823,196650445,277322268,111,300,2,115978622,In > Out
Feb 2020,180,183,97,5059163,211893067,216952230,7,97,2,206833904,In > Out
Feb 2020,180,184,349,39714501,121766568,161481069,115,345,3,82052067,In > Out
Feb 2020,180,187,303,19681102,244763201,264444303,103,299,2,225082099,In > Out
Feb 2020,180,188,406,26502895,286524380,313027275,133,402,2,260021485,In > Out
Feb 2020,180,189,573,25183645,304342663,329526308,93,568,3,279159018,In > Out
Feb 2020,180,199,48,1666123,26902099,28568222,26,48,2,25235976,In > Out
Feb 2020,180,204,43,1971492,32129605,34101097,28,43,2,30158113,In > Out
Feb 2020,180,205,329,39507967,284318663,323826630,137,325,3,244810696,In > Out
Feb 2020,180,217,65,4450698,137582899,142033597,24,64,2,133132201,In > Out
Feb 2020,180,23,576,14621554,1348919925,1363541479,45,574,2,1334298371,In > Out
Feb 2020,180,25,724,148694957,555093293,703788250,233,709,2,406398336,In > Out
Feb 2020,180,28,100,5731868,186226190,191958058,24,100,2,180494322,In > Out
Feb 2020,180,32,216,29459784,153710106,183169890,82,213,2,124250322,In > Out
Feb 2020,180,44,142,17445140,131109051,148554191,69,142,2,113663911,In > Out
Feb 2020,180,45,81,4372758,44393248,48766006,48,81,2,40020490,In > Out
Feb 2020,180,62,1781,188489194,547966430,736455624,198,1693,3,359477236,In > Out
Feb 2020,180,68,5,146996,2444696,2591692,4,5,2,2297700,In > Out
Feb 2020,180,72,42,2176386,61032391,63208777,18,42,2,58856005,In > Out
Feb 2020,180,77,326,33449876,228317966,261767842,96,323,2,194868090,In > Out
Feb 2020,180,82,473,39086615,180701779,219788394,120,466,2,141615164,In > Out
Feb 2020,180,84,511,45141004,194839609,239980613,127,504,2,149698605,In > Out
Feb 2020,180,85,454,60731631,467464562,528196193,171,449,2,406732931,In > Out
Feb 2020,180,97,120,5025546,66318573,71344119,62,120,2,61293027,In > Out
Feb 2020,181,108,195,23503797,39022046,62525843,83,195,2,15518249,In > Out
Feb 2020,181,109,385,23331146,177429399,200760545,74,381,2,154098253,In > Out
Feb 2020,181,111,11,1528494,56342408,57870902,8,11,1,54813914,In > Out
Feb 2020,181,112,67,2746974,209726895,212473869,18,67,2,206979921,In > Out
Feb 2020,181,113,1,224878,17792,242670,1,1,1,207086,Out > In
Feb 2020,181,115,89,8760292,557593290,566353582,55,89,2,548832998,In > Out
Feb 2020,181,116,1696,398486319,4004127567,4402613886,173,1645,5,3605641248,In > Out
Feb 2020,181,119,326,57171412,466580518,523751930,145,322,2,409409106,In > Out
Feb 2020,181,122,2721,968726451,6973794525,7942520976,441,2569,16,6005068074,In > Out
Feb 2020,181,126,3,18837,442785,461622,1,3,1,423948,In > Out
Feb 2020,181,127,3595,4981079302,7166066645,12147145947,217,3323,4,2184987343,In > Out
Feb 2020,181,128,50,3559224,67261816,70821040,32,50,2,63702592,In > Out
Feb 2020,181,130,272,19877064,94119183,113996247,83,270,2,74242119,In > Out
Feb 2020,181,133,256,471181164,682823819,1154004983,140,252,4,211642655,In > Out
Feb 2020,181,134,167,7514409,226204505,233718914,56,167,2,218690096,In > Out
Feb 2020,181,141,545,106070207,619784795,725855002,147,524,2,513714588,In > Out
Feb 2020,181,144,244,70354463,364468135,434822598,82,243,2,294113672,In > Out
Feb 2020,181,145,111,3586043,148090469,151676512,26,110,2,144504426,In > Out
Feb 2020,181,146,387,51778006,1528783542,1580561548,97,382,2,1477005536,In > Out
Feb 2020,181,148,74,6470236,237018426,243488662,30,74,2,230548190,In > Out
Feb 2020,181,149,16,805122,28151865,28956987,14,16,2,27346743,In > Out
Feb 2020,181,150,52,1006578,25577773,26584351,19,52,2,24571195,In > Out
Feb 2020,181,151,15,95437,10675432,10770869,11,15,2,10579995,In > Out
Feb 2020,181,155,241,28787138,101501944,130289082,27,238,2,72714806,In > Out
Feb 2020,181,156,14,5238988,2188572,7427560,9,14,2,3050416,Out > In
Feb 2020,181,158,50,3862753,37160726,41023479,16,50,2,33297973,In > Out
Feb 2020,181,160,1450,293369734,2847225384,3140595118,280,1403,2,2553855650,In > Out
Feb 2020,181,162,1444,214022284,3713020486,3927042770,313,1379,9,3498998202,In > Out
Feb 2020,181,164,548,230536803,1012921220,1243458023,220,542,4,782384417,In > Out
Feb 2020,181,167,832,63768540,541112374,604880914,266,808,3,477343834,In > Out
Feb 2020,181,168,7,341927,1925880,2267807,6,6,3,1583953,In > Out
Feb 2020,181,169,81,2906184,83160776,86066960,60,81,2,80254592,In > Out
Feb 2020,181,170,1,5630,184152,189782,1,1,1,178522,In > Out
Feb 2020,181,173,13,3855778,293272609,297128387,8,13,2,289416831,In > Out
Feb 2020,181,174,195,20311331,212745209,233056540,91,190,1,192433878,In > Out
Feb 2020,181,175,1617,16560789054,4951161138,21511950192,375,1571,5,11609627916,Out > In
Feb 2020,181,177,1355,71652118,592885872,664537990,283,1307,2,521233754,In > Out
Feb 2020,181,182,8,803520,770472,1573992,2,2,2,33048,Out > In
Feb 2020,181,191,3,53404,3711229,3764633,2,3,2,3657825,In > Out
Feb 2020,181,193,330,11412967,276101601,287514568,111,330,3,264688634,In > Out
Feb 2020,181,194,1056,27889119,876716985,904606104,104,1029,2,848827866,In > Out
Feb 2020,181,196,62,10379134,179480300,189859434,39,62,2,169101166,In > Out
Feb 2020,181,20,390,17673409,621011959,638685368,163,390,2,603338550,In > Out
Feb 2020,181,200,607,40359987,168527822,208887809,92,597,2,128167835,In > Out
Feb 2020,181,204,15,5083921,687336120,692420041,11,15,2,682252199,In > Out
Feb 2020,181,205,5608,7175245489,1045875111,8221120600,1310,202,4821,6129370378,Out > In
Feb 2020,181,210,366,23015709,759569585,782585294,92,364,2,736553876,In > Out
Feb 2020,181,211,35,1622122,20775182,22397304,14,35,2,19153060,In > Out
Feb 2020,181,212,6,25773,837579,863352,4,6,1,811806,In > Out
Feb 2020,181,220,95,3307955,283547473,286855428,21,95,2,280239518,In > Out
Feb 2020,181,224,7,119981,21562024,21682005,4,7,1,21442043,In > Out
Feb 2020,181,226,972,152647853,1028825923,1181473776,120,958,2,876178070,In > Out
Feb 2020,181,229,1192,59910342,891673373,951583715,363,1157,2,831763031,In > Out
Feb 2020,181,230,4,385192,2105970,2491162,3,4,2,1720778,In > Out
Feb 2020,181,236,34,2221251,35617237,37838488,17,34,2,33395986,In > Out
Feb 2020,181,241,22,732689,48684543,49417232,14,22,2,47951854,In > Out
Feb 2020,181,244,15,869737,1534909,2404646,4,7,3,665172,In > Out
Feb 2020,181,245,219,61530396,578147829,639678225,105,219,2,516617433,In > Out
Feb 2020,181,246,6589,6282422280,586420185,6868842465,1133,1485,4627,5696002095,Out > In
Feb 2020,181,247,39,29976927,20695825,50672752,22,39,1,9281102,Out > In
Feb 2020,181,248,215,19921415,73636952,93558367,93,214,7,53715537,In > Out
Feb 2020,181,249,99,3137660,89127450,92265110,64,97,2,85989790,In > Out
Feb 2020,181,250,463,7230595,189654238,196884833,151,453,2,182423643,In > Out
Feb 2020,181,251,798,6498416,231680376,238178792,9,798,2,225181960,In > Out
Feb 2020,181,36,8,37216206,1272186371,1309402577,4,8,2,1234970165,In > Out
Feb 2020,181,37,10,34535,1323864,1358399,8,10,2,1289329,In > Out
Feb 2020,181,38,7,31704,976748,1008452,6,7,1,945044,In > Out
Feb 2020,181,4,1,411631,2815777,3227408,1,1,1,2404146,In > Out
Feb 2020,181,46,16,1391549,6219543,7611092,8,16,2,4827994,In > Out
Feb 2020,181,5,4,13441,482836,496277,4,4,2,469395,In > Out
Feb 2020,181,53,7,575256,1996618,2571874,6,7,2,1421362,In > Out
Feb 2020,181,54,45,797454,67411448,68208902,20,45,2,66613994,In > Out
Feb 2020,181,59,266,60041146,131685414,191726560,64,262,2,71644268,In > Out
Feb 2020,181,6,12,42017,1709699,1751716,9,12,2,1667682,In > Out
Feb 2020,181,61,268,15997194,434709201,450706395,72,268,2,418712007,In > Out
Feb 2020,181,63,16,130341,4863780,4994121,7,16,2,4733439,In > Out
Feb 2020,181,64,6,104952,1026606,1131558,5,6,2,921654,In > Out
Feb 2020,181,65,597,68763504,182158136,250921640,178,588,2,113394632,In > Out
Feb 2020,181,7,189,10558598,135807467,146366065,97,187,1,125248869,In > Out
Feb 2020,181,72,22,796437,12955049,13751486,18,22,2,12158612,In > Out
Feb 2020,181,74,22,5050511,378331380,383381891,14,20,2,373280869,In > Out
Feb 2020,181,75,67,6668249,140451977,147120226,30,67,2,133783728,In > Out
Feb 2020,181,77,71,4391967,74960504,79352471,28,71,2,70568537,In > Out
Feb 2020,181,78,7,26949,1289215,1316164,2,7,1,1262266,In > Out
Feb 2020,181,79,28,4328316,19872959,24201275,15,26,2,15544643,In > Out
Feb 2020,181,8,656,126692271,1105928513,1232620784,91,654,2,979236242,In > Out
Feb 2020,181,81,152,5472850,153634146,159106996,48,152,2,148161296,In > Out
Feb 2020,181,82,800,97121386,266313933,363435319,183,771,2,169192547,In > Out
Feb 2020,181,9,3383,723515943,1436302761,2159818704,214,3187,3,712786818,In > Out
Feb 2020,181,91,9,310447,11348298,11658745,9,9,2,11037851,In > Out
Feb 2020,181,92,51,4027396,76372728,80400124,25,51,2,72345332,In > Out
Feb 2020,181,93,1288,202508953,2579235193,2781744146,463,1243,4,2376726240,In > Out
Feb 2020,181,98,42,3759438,55665066,59424504,21,42,2,51905628,In > Out
Feb 2020,183,11,194,4899040,249385661,254284701,23,193,2,244486621,In > Out
Feb 2020,183,119,3,31408,1322068,1353476,3,3,1,1290660,In > Out
Feb 2020,183,19,11,101444,4347011,4448455,7,11,2,4245567,In > Out
Feb 2020,183,6,77,3185190,105822321,109007511,42,77,2,102637131,In > Out
Feb 2020,183,86,186,186395947,930038437,1116434384,2,3,2,743642490,In > Out
Feb 2020,183,88,41,8659990,17818190,26478180,24,39,2,9158200,In > Out
Feb 2020,183,89,28,20420952,193708560,214129512,1,1,1,173287608,In > Out
Feb 2020,183,94,677,122255417,107451205,229706622,85,663,3,14804212,Out > In
Feb 2020,184,134,5611,716861857,17509935424,18226797281,1013,4934,10,16793073567,In > Out
Feb 2020,184,136,5132,861808388,8887869858,9749678246,783,4353,9,8026061470,In > Out
Feb 2020,184,181,503,53049900,448541108,501591008,120,500,3,395491208,In > Out
Feb 2020,184,203,3998,432674999,35110366119,35543041118,301,3872,8,34677691120,In > Out
Feb 2020,184,216,30,806625,2515930,3322555,2,26,2,1709305,In > Out
Feb 2020,184,218,37,13959942,449113023,463072965,16,37,3,435153081,In > Out
Feb 2020,184,219,832,271200724,6265154946,6536355670,167,813,6,5993954222,In > Out
Feb 2020,184,220,19458,3255716288,44332742873,47588459161,3251,14098,31,41077026585,In > Out
Feb 2020,184,246,4665,546938221,12673604786,13220543007,878,4350,9,12126666565,In > Out
Feb 2020,185,28,1,1260,165060,166320,1,1,1,163800,In > Out
Feb 2020,19,122,12,72206,2024698,2096904,1,12,1,1952492,In > Out
Feb 2020,19,143,1,37357,974152,1011509,1,1,1,936795,In > Out
Feb 2020,190,100,7,577897,22570549,23148446,3,7,2,21992652,In > Out
Feb 2020,190,101,7,1217851,79360129,80577980,3,7,2,78142278,In > Out
Feb 2020,190,119,248,6146759,509537029,515683788,16,246,2,503390270,In > Out
Feb 2020,190,120,13,306571,24158610,24465181,7,13,2,23852039,In > Out
Feb 2020,190,123,11,398400,28890899,29289299,6,11,1,28492499,In > Out
Feb 2020,190,125,56,1706252,74777819,76484071,10,56,1,73071567,In > Out
Feb 2020,190,135,6,598219,107391470,107989689,3,6,1,106793251,In > Out
Feb 2020,190,140,5,122850,584120,706970,1,5,1,461270,In > Out
Feb 2020,190,156,36,910302,39313781,40224083,8,36,1,38403479,In > Out
Feb 2020,190,160,13,563333,39264898,39828231,6,13,1,38701565,In > Out
Feb 2020,190,164,16,427656,28690349,29118005,9,16,2,28262693,In > Out
Feb 2020,190,165,16,402117,28453768,28855885,8,16,2,28051651,In > Out
Feb 2020,190,176,3,56484,399965,456449,1,3,1,343481,In > Out
Feb 2020,190,180,13,403414,30499112,30902526,9,13,2,30095698,In > Out
Feb 2020,190,184,5,457122,65249786,65706908,2,5,1,64792664,In > Out
Feb 2020,190,188,11,32942,1766290,1799232,2,11,1,1733348,In > Out
Feb 2020,190,208,8,792682,111902559,112695241,5,8,2,111109877,In > Out
Feb 2020,190,209,630,3388652,255056378,258445030,17,612,2,251667726,In > Out
Feb 2020,190,216,8,574819,110199456,110774275,6,8,2,109624637,In > Out
Feb 2020,190,217,303,2388358,221114228,223502586,13,300,2,218725870,In > Out
Feb 2020,190,219,754,4113551,287022012,291135563,34,736,2,282908461,In > Out
Feb 2020,190,223,17,944690,180070561,181015251,8,17,2,179125871,In > Out
Feb 2020,190,39,7,480714,85104115,85584829,2,7,2,84623401,In > Out
Feb 2020,190,40,17,32986,2415086,2448072,2,17,1,2382100,In > Out
Feb 2020,190,43,93,1302778,69554341,70857119,6,92,2,68251563,In > Out
Feb 2020,190,44,99,1361922,63089073,64450995,8,99,2,61727151,In > Out
Feb 2020,190,48,214,5005813,119809924,124815737,5,5,214,114804111,In > Out
Feb 2020,190,53,7,1552565,82790639,84343204,5,7,2,81238074,In > Out
Feb 2020,190,54,5,131079,51304144,51435223,2,5,2,51173065,In > Out
Feb 2020,190,57,9,1075910,120242870,121318780,4,9,2,119166960,In > Out
Feb 2020,190,58,19,1195194,174487162,175682356,6,19,2,173291968,In > Out
Feb 2020,191,10,452,13432074,293390102,306822176,124,446,3,279958028,In > Out
Feb 2020,191,12,887,98661449,2233329471,2331990920,166,869,4,2134668022,In > Out
Feb 2020,191,13,697,50254072,432533785,482787857,48,680,2,382279713,In > Out
Feb 2020,191,15,865,114114556,1807105894,1921220450,86,844,2,1692991338,In > Out
Feb 2020,191,44,558,24767837,756970552,781738389,105,548,2,732202715,In > Out
Feb 2020,191,48,9,97879,4045051,4142930,2,9,2,3947172,In > Out
Feb 2020,191,50,813,60537790,993707089,1054244879,88,796,2,933169299,In > Out
Feb 2020,191,51,1534,218662311,1151772678,1370434989,235,1459,3,933110367,In > Out
Feb 2020,191,59,11,2780466,7770742,10551208,11,11,1,4990276,In > Out
Feb 2020,192,40,78,5256911,93825216,99082127,7,78,4,88568305,In > Out
Feb 2020,192,44,1,25520,3763302,3788822,1,1,1,3737782,In > Out
Feb 2020,192,45,27,1192148,56661561,57853709,11,27,2,55469413,In > Out
Feb 2020,195,10,529,80514989,338508437,419023426,170,525,5,257993448,In > Out
Feb 2020,195,100,481,430021595,979659145,1409680740,146,479,5,549637550,In > Out
Feb 2020,195,104,1220,394956357,10632681955,11027638312,306,1168,22,10237725598,In > Out
Feb 2020,195,105,337,77241196,1005655105,1082896301,163,332,4,928413909,In > Out
Feb 2020,195,106,205,17401347,386540857,403942204,86,205,6,369139510,In > Out
Feb 2020,195,107,250,189860752,283081216,472941968,134,250,3,93220464,In > Out
Feb 2020,195,109,517,295317987,3256807520,3552125507,135,514,8,2961489533,In > Out
Feb 2020,195,11,587,70378213,1253209181,1323587394,228,564,21,1182830968,In > Out
Feb 2020,195,110,417,56972288,1166708091,1223680379,128,415,5,1109735803,In > Out
Feb 2020,195,113,312,32295865,400921193,433217058,146,312,5,368625328,In > Out
Feb 2020,195,114,161,96882878,3651292091,3748174969,63,161,3,3554409213,In > Out
Feb 2020,195,115,1000,99275310,1767482159,1866757469,189,973,4,1668206849,In > Out
Feb 2020,195,116,283,66878841,604287166,671166007,124,280,7,537408325,In > Out
Feb 2020,195,117,841,92711688,1591844543,1684556231,255,827,5,1499132855,In > Out
Feb 2020,195,118,274,31788353,363562117,395350470,96,273,3,331773764,In > Out
Feb 2020,195,12,1366,312970213,5041829470,5354799683,303,1332,4,4728859257,In > Out
Feb 2020,195,120,1066,622272024,24702628749,25324900773,343,1043,6,24080356725,In > Out
Feb 2020,195,123,378,48114724,470075584,518190308,99,372,8,421960860,In > Out
Feb 2020,195,125,536,217732738,16589697753,16807430491,149,529,1,16371965015,In > Out
Feb 2020,195,128,677,77200929,3320611482,3397812411,181,665,5,3243410553,In > Out
Feb 2020,195,129,489,296750034,9236464493,9533214527,170,481,8,8939714459,In > Out
Feb 2020,195,13,1981,453468683,16353138581,16806607264,231,1847,8,15899669898,In > Out
Feb 2020,195,130,854,43337105,1307925952,1351263057,138,826,6,1264588847,In > Out
Feb 2020,195,131,942,129502745,7235460821,7364963566,288,910,4,7105958076,In > Out
Feb 2020,195,132,739,223181756,14375677465,14598859221,187,730,3,14152495709,In > Out
Feb 2020,195,133,39,10800236,213267955,224068191,28,39,5,202467719,In > Out
Feb 2020,195,134,568,210733814,1300009871,1510743685,150,565,9,1089276057,In > Out
Feb 2020,195,135,216,10598597,170134774,180733371,83,216,3,159536177,In > Out
Feb 2020,195,136,411,49095031,1222499003,1271594034,154,408,3,1173403972,In > Out
Feb 2020,195,137,614,90263499,2104180327,2194443826,159,612,6,2013916828,In > Out
Feb 2020,195,138,932,115436199,3687905214,3803341413,253,908,5,3572469015,In > Out
Feb 2020,195,139,621,50368225,1445000261,1495368486,139,621,5,1394632036,In > Out
Feb 2020,195,14,161,6780194,217286878,224067072,78,161,3,210506684,In > Out
Feb 2020,195,140,416,254746438,7793425130,8048171568,126,413,6,7538678692,In > Out
Feb 2020,195,141,998,136822864,2414742555,2551565419,266,974,14,2277919691,In > Out
Feb 2020,195,142,288,95479959,621811011,717290970,96,287,16,526331052,In > Out
Feb 2020,195,143,788,48662916,942158669,990821585,210,785,7,893495753,In > Out
Feb 2020,195,144,1270,554200186,11198747681,11752947867,193,1240,6,10644547495,In > Out
Feb 2020,195,145,241,1110074152,1572398891,2682473043,72,241,4,462324739,In > Out
Feb 2020,195,146,187,41620272,456642931,498263203,73,187,4,415022659,In > Out
Feb 2020,195,147,620,62384721,1065470760,1127855481,149,606,4,1003086039,In > Out
Feb 2020,195,148,246,371267887,998808744,1370076631,64,245,3,627540857,In > Out
Feb 2020,195,149,448,179235350,10115968127,10295203477,155,441,11,9936732777,In > Out
Feb 2020,195,15,1172,406915673,6468306814,6875222487,225,1155,16,6061391141,In > Out
Feb 2020,195,150,454,113081623,6183364889,6296446512,101,453,5,6070283266,In > Out
Feb 2020,195,151,790,139323362,6687582056,6826905418,185,786,4,6548258694,In > Out
Feb 2020,195,152,447,119653718,1491079244,1610732962,160,437,6,1371425526,In > Out
Feb 2020,195,153,253,15150599,529731938,544882537,114,253,6,514581339,In > Out
Feb 2020,195,154,1413,98339739,5495441700,5593781439,341,1384,4,5397101961,In > Out
Feb 2020,195,155,454,38205346,1570112358,1608317704,191,448,3,1531907012,In > Out
Feb 2020,195,156,394,33129278,1069433701,1102562979,185,393,4,1036304423,In > Out
Feb 2020,195,157,420,38448642,1022693440,1061142082,193,392,12,984244798,In > Out
Feb 2020,195,158,223,160731568,4361853709,4522585277,90,221,6,4201122141,In > Out
Feb 2020,195,159,514,99761010,3319909205,3419670215,111,504,4,3220148195,In > Out
Feb 2020,195,16,423,881157441,867734123,1748891564,149,421,7,13423318,Out > In
Feb 2020,195,160,228,55347536,567049282,622396818,83,224,2,511701746,In > Out
Feb 2020,195,161,408,68528490,1740760692,1809289182,108,407,3,1672232202,In > Out
Feb 2020,195,163,129,16302211,423270111,439572322,70,129,3,406967900,In > Out
Feb 2020,195,164,337,95067935,4231508846,4326576781,163,335,8,4136440911,In > Out
Feb 2020,195,165,648,69768881,1426933011,1496701892,187,638,2,1357164130,In > Out
Feb 2020,195,166,948,75213617,1522364854,1597578471,248,438,126,1447151237,In > Out
Feb 2020,195,167,640,217957420,4081320337,4299277757,238,626,7,3863362917,In > Out
Feb 2020,195,168,258,496363537,3174312564,3670676101,102,256,7,2677949027,In > Out
Feb 2020,195,169,306,35893226,1051537225,1087430451,84,304,4,1015643999,In > Out
Feb 2020,195,17,287,48120879,870654432,918775311,62,287,4,822533553,In > Out
Feb 2020,195,170,1663,611922609,7134080006,7746002615,198,1588,7,6522157397,In > Out
Feb 2020,195,171,40,1194956,14033043,15227999,25,39,1,12838087,In > Out
Feb 2020,195,172,424,356640029,1810865543,2167505572,209,419,5,1454225514,In > Out
Feb 2020,195,173,271,144206759,710702555,854909314,78,267,6,566495796,In > Out
Feb 2020,195,174,105,13922737,336461493,350384230,60,105,4,322538756,In > Out
Feb 2020,195,175,641,165679678,4799633209,4965312887,197,617,21,4633953531,In > Out
Feb 2020,195,176,387,133026724,683964211,816990935,96,386,1,550937487,In > Out
Feb 2020,195,177,337,35350411,675865956,711216367,92,333,5,640515545,In > Out
Feb 2020,195,178,426,646769497,9940309860,10587079357,155,418,4,9293540363,In > Out
Feb 2020,195,179,959,788722189,3683986361,4472708550,222,941,9,2895264172,In > Out
Feb 2020,195,18,458,324832590,1333313079,1658145669,153,454,4,1008480489,In > Out
Feb 2020,195,180,297,156129188,2520123810,2676252998,123,295,4,2363994622,In > Out
Feb 2020,195,181,174,22317388,565275547,587592935,85,173,3,542958159,In > Out
Feb 2020,195,182,1184,416018585,6108026271,6524044856,345,1159,5,5692007686,In > Out
Feb 2020,195,183,387,35268122,707247744,742515866,124,385,3,671979622,In > Out
Feb 2020,195,184,822,97635422,3589388216,3687023638,252,804,5,3491752794,In > Out
Feb 2020,195,185,524,156767327,1823042634,1979809961,167,524,5,1666275307,In > Out
Feb 2020,195,186,956,128195563,2961399898,3089595461,170,950,5,2833204335,In > Out
Feb 2020,195,187,1491,507379538,5989138623,6496518161,253,1458,10,5481759085,In > Out
Feb 2020,195,188,2447,1217388058,18311806261,19529194319,565,2322,4,17094418203,In > Out
Feb 2020,195,189,117,14514474,569932142,584446616,41,117,3,555417668,In > Out
Feb 2020,195,19,490,19735642,798856300,818591942,88,489,3,779120658,In > Out
Feb 2020,195,190,1241,516476517,15936683545,16453160062,313,1222,9,15420207028,In > Out
Feb 2020,195,191,183,26471873,589695966,616167839,91,183,2,563224093,In > Out
Feb 2020,195,192,265,40612625,3142455361,3183067986,131,264,2,3101842736,In > Out
Feb 2020,195,193,739,494436768,4899346913,5393783681,238,728,15,4404910145,In > Out
Feb 2020,195,194,98,69446299,229382893,298829192,53,98,2,159936594,In > Out
Feb 2020,195,195,426,118235121,12328115922,12446351043,173,418,2,12209880801,In > Out
Feb 2020,195,196,1667,126821765,2680097390,2806919155,172,1625,4,2553275625,In > Out
Feb 2020,195,197,1795,1328839454,20432325637,21761165091,390,1671,10,19103486183,In > Out
Feb 2020,195,198,361,535836805,1297293304,1833130109,126,358,7,761456499,In > Out
Feb 2020,195,199,101,7016124,177640796,184656920,38,101,4,170624672,In > Out
Feb 2020,195,20,1252,121709635,2274909392,2396619027,223,1235,5,2153199757,In > Out
Feb 2020,195,200,402,74439291,3718224490,3792663781,137,393,3,3643785199,In > Out
Feb 2020,195,201,478,460861636,7755776700,8216638336,191,461,5,7294915064,In > Out
Feb 2020,195,202,1427,379923836,4533018227,4912942063,326,1393,7,4153094391,In > Out
Feb 2020,195,203,725,282345626,13620162690,13902508316,213,712,5,13337817064,In > Out
Feb 2020,195,204,407,55764564,1653260307,1709024871,178,401,7,1597495743,In > Out
Feb 2020,195,205,759,3519102798,1379010118,4898112916,168,749,8,2140092680,Out > In
Feb 2020,195,206,1066,228402676,6216766712,6445169388,326,1035,5,5988364036,In > Out
Feb 2020,195,207,2453,291478229,13615503475,13906981704,265,2316,4,13324025246,In > Out
Feb 2020,195,208,135,22256786,1086013094,1108269880,63,135,5,1063756308,In > Out
Feb 2020,195,209,88,5697509,127007560,132705069,35,88,4,121310051,In > Out
Feb 2020,195,21,322,37258598,952620529,989879127,122,321,4,915361931,In > Out
Feb 2020,195,210,1323,295051947,8104838593,8399890540,388,1285,8,7809786646,In > Out
Feb 2020,195,211,125,11776738,293819303,305596041,26,125,4,282042565,In > Out
Feb 2020,195,212,217,56226931,797867198,854094129,83,217,2,741640267,In > Out
Feb 2020,195,213,399,62289236,2489933366,2552222602,91,398,4,2427644130,In > Out
Feb 2020,195,214,1477,594804480,7915785071,8510589551,326,1432,6,7320980591,In > Out
Feb 2020,195,215,675,156020473,2405420026,2561440499,166,672,6,2249399553,In > Out
Feb 2020,195,216,643,79503045,2130053490,2209556535,218,633,6,2050550445,In > Out
Feb 2020,195,217,680,84158600,4622251013,4706409613,193,650,4,4538092413,In > Out
Feb 2020,195,218,1061,491797248,3914106237,4405903485,181,1020,24,3422308989,In > Out
Feb 2020,195,219,876,95770220,6039954308,6135724528,213,853,7,5944184088,In > Out
Feb 2020,195,22,694,174864261,4828413271,5003277532,213,686,4,4653549010,In > Out
Feb 2020,195,220,646,90147287,2608568615,2698715902,229,640,5,2518421328,In > Out
Feb 2020,195,221,405,16487016,391110701,407597717,138,399,3,374623685,In > Out
Feb 2020,195,222,365,2066280455,2491835547,4558116002,130,363,8,425555092,In > Out
Feb 2020,195,223,298,37522313,2099210925,2136733238,83,297,4,2061688612,In > Out
Feb 2020,195,23,708,53998793,869914394,923913187,137,701,7,815915601,In > Out
Feb 2020,195,24,704,215090119,4973452131,5188542250,116,699,6,4758362012,In > Out
Feb 2020,195,25,1521,2152533140,3009160622,5161693762,391,1478,6,856627482,In > Out
Feb 2020,195,26,416,88875739,1491390731,1580266470,134,416,5,1402514992,In > Out
Feb 2020,195,27,249,77620048,3241957199,3319577247,83,245,3,3164337151,In > Out
Feb 2020,195,28,183,100030568,2934034182,3034064750,99,176,3,2834003614,In > Out
Feb 2020,195,29,1120,209695919,2992873869,3202569788,228,1095,8,2783177950,In > Out
Feb 2020,195,30,569,69146684,2443914225,2513060909,184,567,5,2374767541,In > Out
Feb 2020,195,31,304,20299354,260735716,281035070,161,303,4,240436362,In > Out
Feb 2020,195,32,400,234950539,854955216,1089905755,122,396,7,620004677,In > Out
Feb 2020,195,33,285,67800683,539622758,607423441,123,282,3,471822075,In > Out
Feb 2020,195,34,83,11063685,232663460,243727145,54,82,4,221599775,In > Out
Feb 2020,195,35,157,34547317,291362422,325909739,56,157,3,256815105,In > Out
Feb 2020,195,36,363,59662418,2504496848,2564159266,135,363,4,2444834430,In > Out
Feb 2020,195,37,216,25874140,368818975,394693115,63,216,6,342944835,In > Out
Feb 2020,195,38,188,8826313,146561369,155387682,62,186,6,137735056,In > Out
Feb 2020,195,39,590,133081648,2459942168,2593023816,145,576,9,2326860520,In > Out
Feb 2020,195,4,694,71103729,1958937210,2030040939,210,690,3,1887833481,In > Out
Feb 2020,195,40,316,609772922,1717406763,2327179685,76,315,5,1107633841,In > Out
Feb 2020,195,41,2973,176696246,4484766316,4661462562,468,2801,11,4308070070,In > Out
Feb 2020,195,42,558,51927587,1250479909,1302407496,148,549,6,1198552322,In > Out
Feb 2020,195,43,3509,920834001,22640376639,23561210640,407,3260,8,21719542638,In > Out
Feb 2020,195,44,841,311003807,3204513246,3515517053,241,818,2,2893509439,In > Out
Feb 2020,195,45,303,165677085,3033400767,3199077852,120,300,3,2867723682,In > Out
Feb 2020,195,46,264,79390966,344173836,423564802,114,261,9,264782870,In > Out
Feb 2020,195,47,456,467986725,1540089910,2008076635,176,448,12,1072103185,In > Out
Feb 2020,195,48,205,24093059,1441108024,1465201083,85,204,3,1417014965,In > Out
Feb 2020,195,49,459,149872120,3499022175,3648894295,190,449,6,3349150055,In > Out
Feb 2020,195,5,415,36715315,865375826,902091141,177,413,4,828660511,In > Out
Feb 2020,195,50,407,47683414,1397960686,1445644100,155,406,4,1350277272,In > Out
Feb 2020,195,51,434,34998216,1389111913,1424110129,156,429,3,1354113697,In > Out
Feb 2020,195,52,311,28749200,1134033416,1162782616,151,307,9,1105284216,In > Out
Feb 2020,195,53,292,107436818,1260690861,1368127679,94,289,5,1153254043,In > Out
Feb 2020,195,54,169,22318942,1096244567,1118563509,68,168,5,1073925625,In > Out
Feb 2020,195,55,216,34341974,1545503429,1579845403,91,216,4,1511161455,In > Out
Feb 2020,195,56,552,419333734,3845049904,4264383638,170,552,7,3425716170,In > Out
Feb 2020,195,57,461,90538889,4270166245,4360705134,119,455,6,4179627356,In > Out
Feb 2020,195,58,611,97997619,1193962112,1291959731,156,602,4,1095964493,In > Out
Feb 2020,195,59,267,60450387,1832712459,1893162846,119,265,3,1772262072,In > Out
Feb 2020,195,6,306,47109419,788865012,835974431,86,306,4,741755593,In > Out
Feb 2020,195,60,606,52844762,978687270,1031532032,162,603,7,925842508,In > Out
Feb 2020,195,61,152,22734688,342853018,365587706,78,152,3,320118330,In > Out
Feb 2020,195,62,238,28397040,653465880,681862920,51,238,6,625068840,In > Out
Feb 2020,195,63,196,136097512,347272697,483370209,97,195,7,211175185,In > Out
Feb 2020,195,64,821,60046416,2741115087,2801161503,221,813,6,2681068671,In > Out
Feb 2020,195,65,507,161850583,1654174747,1816025330,170,499,6,1492324164,In > Out
Feb 2020,195,66,390,327241653,3591352722,3918594375,142,387,5,3264111069,In > Out
Feb 2020,195,67,473,30217564,1071721868,1101939432,212,468,5,1041504304,In > Out
Feb 2020,195,68,180,66970418,3848660046,3915630464,85,180,3,3781689628,In > Out
Feb 2020,195,69,303,69177550,4562407540,4631585090,119,303,4,4493229990,In > Out
Feb 2020,195,7,46,71411746,330802108,402213854,27,46,5,259390362,In > Out
Feb 2020,195,70,1160,109947295,2389897099,2499844394,253,1138,6,2279949804,In > Out
Feb 2020,195,71,148,9674009,171824068,181498077,83,148,3,162150059,In > Out
Feb 2020,195,72,235,21956164,305043838,327000002,127,231,17,283087674,In > Out
Feb 2020,195,73,115,19283365,164805662,184089027,53,115,3,145522297,In > Out
Feb 2020,195,74,129,36656749,1783591267,1820248016,61,129,4,1746934518,In > Out
Feb 2020,195,75,714,150588919,8751939483,8902528402,253,696,4,8601350564,In > Out
Feb 2020,195,76,226,209592155,8187812501,8397404656,101,225,7,7978220346,In > Out
Feb 2020,195,77,323,20410841,569196489,589607330,140,323,3,548785648,In > Out
Feb 2020,195,78,172,449795505,846749968,1296545473,76,168,7,396954463,In > Out
Feb 2020,195,79,499,70740873,1435797467,1506538340,124,498,7,1365056594,In > Out
Feb 2020,195,8,929,77020335,1440042039,1517062374,121,925,4,1363021704,In > Out
Feb 2020,195,81,317,53885699,3222936280,3276821979,151,311,2,3169050581,In > Out
Feb 2020,195,82,344,209610562,669321383,878931945,89,344,4,459710821,In > Out
Feb 2020,195,83,1156,2089372663,4602706937,6692079600,327,1133,9,2513334274,In > Out
Feb 2020,195,84,79,12876320,201683022,214559342,30,79,2,188806702,In > Out
Feb 2020,195,85,270,25135734,517685937,542821671,129,270,4,492550203,In > Out
Feb 2020,195,87,706,199669342,8153523996,8353193338,265,695,7,7953854654,In > Out
Feb 2020,195,88,1020,923311183,7314366300,8237677483,323,948,49,6391055117,In > Out
Feb 2020,195,89,224,137973736,652166643,790140379,92,217,11,514192907,In > Out
Feb 2020,195,9,556,158277774,3060689609,3218967383,142,554,14,2902411835,In > Out
Feb 2020,195,90,561,186148967,1637942679,1824091646,244,544,16,1451793712,In > Out
Feb 2020,195,91,678,137290858,2964093721,3101384579,294,670,7,2826802863,In > Out
Feb 2020,195,92,376,123343250,7050659093,7174002343,136,312,5,6927315843,In > Out
Feb 2020,195,93,601,226511215,10816533992,11043045207,149,595,5,10590022777,In > Out
Feb 2020,195,94,618,52120421,1140476817,1192597238,164,611,5,1088356396,In > Out
Feb 2020,195,95,156,24105014,705549639,729654653,69,156,3,681444625,In > Out
Feb 2020,195,96,976,79053866,2391656217,2470710083,330,948,9,2312602351,In > Out
Feb 2020,195,97,578,50007877,1292907658,1342915535,150,560,4,1242899781,In > Out
Feb 2020,195,99,222,146109855,4846532302,4992642157,83,220,9,4700422447,In > Out
Feb 2020,196,119,340,18380423,603126632,621507055,68,340,2,584746209,In > Out
Feb 2020,196,137,484,17742533,976924112,994666645,72,451,2,959181579,In > Out
Feb 2020,196,16,115,3250087,106954314,110204401,48,115,2,103704227,In > Out
Feb 2020,196,163,748,30891024,1870231431,1901122455,83,736,2,1839340407,In > Out
Feb 2020,196,178,414,17083585,765659956,782743541,113,414,2,748576371,In > Out
Feb 2020,196,187,242,16911931,215602788,232514719,72,241,2,198690857,In > Out
Feb 2020,196,189,245,28180961,1286323490,1314504451,81,243,2,1258142529,In > Out
Feb 2020,196,190,36,1738133,94168926,95907059,16,36,2,92430793,In > Out
Feb 2020,196,191,27,341830,27651960,27993790,11,27,2,27310130,In > Out
Feb 2020,196,192,35,930913,45739965,46670878,13,35,2,44809052,In > Out
Feb 2020,196,22,228,5612880,376721631,382334511,80,227,2,371108751,In > Out
Feb 2020,196,24,296,223917651,1470272157,1694189808,116,291,8,1246354506,In > Out
Feb 2020,196,33,272,28420939,1302118792,1330539731,63,271,2,1273697853,In > Out
Feb 2020,196,34,186,9000443,257196531,266196974,62,185,2,248196088,In > Out
Feb 2020,196,36,61,4995632,220249385,225245017,34,61,2,215253753,In > Out
Feb 2020,196,37,7,399091,4123933,4523024,5,7,2,3724842,In > Out
Feb 2020,196,39,223,21678373,765435717,787114090,97,223,2,743757344,In > Out
Feb 2020,196,40,388,55840650,1315835709,1371676359,107,375,2,1259995059,In > Out
Feb 2020,196,42,218,20193442,882316635,902510077,77,218,2,862123193,In > Out
Feb 2020,196,44,168,8269158,300345718,308614876,80,168,2,292076560,In > Out
Feb 2020,196,46,245,9317022,311206212,320523234,72,245,2,301889190,In > Out
Feb 2020,196,47,212,12956163,477057243,490013406,91,212,2,464101080,In > Out
Feb 2020,196,62,203,12419779,563857676,576277455,53,203,2,551437897,In > Out
Feb 2020,197,10,400,21475139,639951935,661427074,121,397,7,618476796,In > Out
Feb 2020,197,100,84,13634237,74112444,87746681,43,84,2,60478207,In > Out
Feb 2020,197,101,165,54969843,118858501,173828344,80,163,5,63888658,In > Out
Feb 2020,197,102,150,1509119440,2086613044,3595732484,74,150,6,577493604,In > Out
Feb 2020,197,103,333,62218535,1856320329,1918538864,109,333,7,1794101794,In > Out
Feb 2020,197,104,504,542852590,9134048950,9676901540,113,501,4,8591196360,In > Out
Feb 2020,197,105,329,73055090,3189462260,3262517350,122,326,5,3116407170,In > Out
Feb 2020,197,107,56,2346031,17399102,19745133,27,56,2,15053071,In > Out
Feb 2020,197,108,303,92680398,956506052,1049186450,87,301,5,863825654,In > Out
Feb 2020,197,11,131,70583368,5310220342,5380803710,79,130,3,5239636974,In > Out
Feb 2020,197,110,162,16533441,750551678,767085119,83,160,10,734018237,In > Out
Feb 2020,197,111,138,159631920,218811282,378443202,75,138,3,59179362,In > Out
Feb 2020,197,112,135,67268830,1987345326,2054614156,52,135,4,1920076496,In > Out
Feb 2020,197,113,290,72380845,891726331,964107176,64,289,5,819345486,In > Out
Feb 2020,197,115,260,35786148,937193498,972979646,83,233,6,901407350,In > Out
Feb 2020,197,116,210,37549978,874239336,911789314,100,210,3,836689358,In > Out
Feb 2020,197,117,275,75386616,895262360,970648976,97,273,4,819875744,In > Out
Feb 2020,197,118,141,18747906,264728224,283476130,60,141,3,245980318,In > Out
Feb 2020,197,12,114,35765935,101266169,137032104,53,113,7,65500234,In > Out
Feb 2020,197,120,128,12218933,815635176,827854109,73,127,5,803416243,In > Out
Feb 2020,197,121,120,23636222,1523128729,1546764951,58,120,3,1499492507,In > Out
Feb 2020,197,122,187,118812374,2416663637,2535476011,67,186,4,2297851263,In > Out
Feb 2020,197,123,254,18851949,502029913,520881862,70,253,5,483177964,In > Out
Feb 2020,197,124,116,24168646,711175773,735344419,62,115,8,687007127,In > Out
Feb 2020,197,125,61,8508872,95357433,103866305,37,61,2,86848561,In > Out
Feb 2020,197,126,202,40012685,533998005,574010690,85,199,6,493985320,In > Out
Feb 2020,197,127,236,31291732,602397822,633689554,94,234,6,571106090,In > Out
Feb 2020,197,128,236,17370028,424821622,442191650,87,236,5,407451594,In > Out
Feb 2020,197,129,403,124870399,7913809496,8038679895,56,403,2,7788939097,In > Out
Feb 2020,197,130,118,15136002,352857732,367993734,65,118,4,337721730,In > Out
Feb 2020,197,131,80,20761015,590927769,611688784,47,80,4,570166754,In > Out
Feb 2020,197,132,120,32640206,2990992088,3023632294,64,120,3,2958351882,In > Out
Feb 2020,197,133,90,10549307,712434905,722984212,42,90,3,701885598,In > Out
Feb 2020,197,134,59,33585765,26486172,60071937,29,59,4,7099593,Out > In
Feb 2020,197,135,216,43899219,1165708349,1209607568,101,213,2,1121809130,In > Out
Feb 2020,197,136,162,115973881,407324718,523298599,62,162,4,291350837,In > Out
Feb 2020,197,137,55,3329166,88600270,91929436,28,55,3,85271104,In > Out
Feb 2020,197,138,265,154275708,3252183981,3406459689,119,259,7,3097908273,In > Out
Feb 2020,197,139,290,52956281,1803916022,1856872303,80,285,5,1750959741,In > Out
Feb 2020,197,14,109,10842576,371331212,382173788,50,106,3,360488636,In > Out
Feb 2020,197,140,87,20570815,937689844,958260659,44,87,4,917119029,In > Out
Feb 2020,197,141,225,49590730,1942473598,1992064328,60,224,3,1892882868,In > Out
Feb 2020,197,142,326,1244736677,2339587895,3584324572,68,320,5,1094851218,In > Out
Feb 2020,197,143,283,33412765,1118317650,1151730415,109,281,4,1084904885,In > Out
Feb 2020,197,144,176,121714740,10465507065,10587221805,60,175,4,10343792325,In > Out
Feb 2020,197,145,151,8052104,214470910,222523014,70,151,3,206418806,In > Out
Feb 2020,197,146,281,76221627,593238261,669459888,74,279,5,517016634,In > Out
Feb 2020,197,148,113,34626857,2278359806,2312986663,58,113,3,2243732949,In > Out
Feb 2020,197,149,248,23860556,504126737,527987293,82,247,3,480266181,In > Out
Feb 2020,197,15,120,24754217,1810046682,1834800899,72,120,4,1785292465,In > Out
Feb 2020,197,150,292,45437090,607801558,653238648,93,287,5,562364468,In > Out
Feb 2020,197,151,74,70463588,6835702877,6906166465,34,73,3,6765239289,In > Out
Feb 2020,197,152,225,410633281,11151601883,11562235164,89,224,4,10740968602,In > Out
Feb 2020,197,153,409,179947437,639444724,819392161,114,407,4,459497287,In > Out
Feb 2020,197,154,80,80280544,119051683,199332227,56,80,8,38771139,In > Out
Feb 2020,197,155,76,9447417,437511164,446958581,34,75,3,428063747,In > Out
Feb 2020,197,156,203,16618182,178967372,195585554,95,203,4,162349190,In > Out
Feb 2020,197,157,125,19270153,865398746,884668899,55,124,7,846128593,In > Out
Feb 2020,197,158,91,151198432,217993281,369191713,60,90,7,66794849,In > Out
Feb 2020,197,159,172,58974071,2905659625,2964633696,78,170,6,2846685554,In > Out
Feb 2020,197,16,65,15063498,354166988,369230486,37,64,6,339103490,In > Out
Feb 2020,197,160,220,188338306,375727508,564065814,100,220,5,187389202,In > Out
Feb 2020,197,161,200,268517195,973604350,1242121545,92,200,2,705087155,In > Out
Feb 2020,197,162,114,17929195,318446726,336375921,60,114,6,300517531,In > Out
Feb 2020,197,163,85,13414380,742167678,755582058,57,84,4,728753298,In > Out
Feb 2020,197,164,171,332344149,2265230751,2597574900,78,171,5,1932886602,In > Out
Feb 2020,197,165,228,22292796,587331494,609624290,70,227,4,565038698,In > Out
Feb 2020,197,166,75,22414656,131035915,153450571,47,75,2,108621259,In > Out
Feb 2020,197,167,82,54259183,354825201,409084384,55,82,2,300566018,In > Out
Feb 2020,197,168,280,34317562,846791915,881109477,86,279,5,812474353,In > Out
Feb 2020,197,169,69,9494226,48759980,58254206,50,69,6,39265754,In > Out
Feb 2020,197,17,205,35959073,268265575,304224648,78,204,7,232306502,In > Out
Feb 2020,197,170,115,21345859,754053636,775399495,51,115,5,732707777,In > Out
Feb 2020,197,171,291,72070657,1528872218,1600942875,116,285,10,1456801561,In > Out
Feb 2020,197,172,283,40272012,2185099688,2225371700,63,280,6,2144827676,In > Out
Feb 2020,197,173,219,16980680,300478483,317459163,74,218,4,283497803,In > Out
Feb 2020,197,174,150,44286786,3137928124,3182214910,66,150,3,3093641338,In > Out
Feb 2020,197,177,205,129440603,1989622310,2119062913,45,202,7,1860181707,In > Out
Feb 2020,197,178,183,39081383,408656301,447737684,94,182,6,369574918,In > Out
Feb 2020,197,179,114,8688682,204713397,213402079,62,114,4,196024715,In > Out
Feb 2020,197,18,89,185609187,109844645,295453832,51,89,3,75764542,Out > In
Feb 2020,197,180,137,55209981,2643022699,2698232680,65,137,5,2587812718,In > Out
Feb 2020,197,181,316,454982327,747303753,1202286080,67,314,8,292321426,In > Out
Feb 2020,197,182,97,490414592,258979688,749394280,51,97,9,231434904,Out > In
Feb 2020,197,183,173,72023978,1294811920,1366835898,75,173,5,1222787942,In > Out
Feb 2020,197,184,287,14752800,1015750427,1030503227,89,280,8,1000997627,In > Out
Feb 2020,197,185,327,1846562851,1095893936,2942456787,134,322,13,750668915,Out > In
Feb 2020,197,186,131,37806620,1705467177,1743273797,63,130,2,1667660557,In > Out
Feb 2020,197,187,298,203745751,6332798021,6536543772,124,296,8,6129052270,In > Out
Feb 2020,197,188,86,75862115,96270608,172132723,58,85,8,20408493,In > Out
Feb 2020,197,19,89,9905766,125574601,135480367,45,89,3,115668835,In > Out
Feb 2020,197,190,209,103871057,1285530868,1389401925,94,208,4,1181659811,In > Out
Feb 2020,197,191,137,12380670,425065671,437446341,53,137,6,412685001,In > Out
Feb 2020,197,192,261,98530913,584336819,682867732,54,257,3,485805906,In > Out
Feb 2020,197,193,404,94716238,4255512960,4350229198,107,397,4,4160796722,In > Out
Feb 2020,197,194,159,600483681,479090224,1079573905,68,148,19,121393457,Out > In
Feb 2020,197,195,836,90784331,3853231069,3944015400,111,816,15,3762446738,In > Out
Feb 2020,197,196,247,130661512,225540761,356202273,91,247,5,94879249,In > Out
Feb 2020,197,197,172,42329298,366500006,408829304,92,171,3,324170708,In > Out
Feb 2020,197,198,143,16257252,484646417,500903669,71,143,7,468389165,In > Out
Feb 2020,197,199,134,11118295,194027929,205146224,67,134,6,182909634,In > Out
Feb 2020,197,20,151,8849571,126589048,135438619,66,151,4,117739477,In > Out
Feb 2020,197,200,141,8159970,241116552,249276522,54,141,2,232956582,In > Out
Feb 2020,197,201,177,16964970,214193319,231158289,58,177,6,197228349,In > Out
Feb 2020,197,202,128,267791450,324474355,592265805,78,127,6,56682905,In > Out
Feb 2020,197,203,109,10513870,430575928,441089798,51,109,3,420062058,In > Out
Feb 2020,197,204,69,4236371,167882542,172118913,37,69,3,163646171,In > Out
Feb 2020,197,205,194,73702240,2408150189,2481852429,77,193,5,2334447949,In > Out
Feb 2020,197,206,169,42021736,943152688,985174424,88,169,5,901130952,In > Out
Feb 2020,197,207,219,32159438,833626505,865785943,75,218,9,801467067,In > Out
Feb 2020,197,208,159,13879430,514545516,528424946,62,159,4,500666086,In > Out
Feb 2020,197,209,172,23001661,472224235,495225896,60,170,3,449222574,In > Out
Feb 2020,197,21,196,13432145,326971381,340403526,65,195,2,313539236,In > Out
Feb 2020,197,210,232,322190199,4996846337,5319036536,114,228,4,4674656138,In > Out
Feb 2020,197,211,260,97123063,3841877368,3939000431,111,259,5,3744754305,In > Out
Feb 2020,197,212,179,150755079,554772608,705527687,77,177,3,404017529,In > Out
Feb 2020,197,213,172,14689599,131046258,145735857,46,172,4,116356659,In > Out
Feb 2020,197,214,387,1272940591,4581477298,5854417889,123,385,4,3308536707,In > Out
Feb 2020,197,215,98,21769069,601499761,623268830,49,98,3,579730692,In > Out
Feb 2020,197,216,120,46008380,156441983,202450363,62,120,5,110433603,In > Out
Feb 2020,197,217,183,132170897,162157875,294328772,68,182,4,29986978,In > Out
Feb 2020,197,218,378,286253631,2991394162,3277647793,75,374,2,2705140531,In > Out
Feb 2020,197,219,307,144809522,2726398266,2871207788,115,303,4,2581588744,In > Out
Feb 2020,197,22,263,43840337,1096537252,1140377589,77,263,4,1052696915,In > Out
Feb 2020,197,220,182,10733519,343873592,354607111,51,182,4,333140073,In > Out
Feb 2020,197,221,119,27568367,716787605,744355972,53,115,9,689219238,In > Out
Feb 2020,197,222,210,40735192,451327567,492062759,79,210,6,410592375,In > Out
Feb 2020,197,223,366,44617019,815899673,860516692,77,363,3,771282654,In > Out
Feb 2020,197,24,359,30646835,1042110062,1072756897,85,358,6,1011463227,In > Out
Feb 2020,197,25,83,31199505,1054656966,1085856471,52,83,5,1023457461,In > Out
Feb 2020,197,26,321,86196351,1236762993,1322959344,78,319,6,1150566642,In > Out
Feb 2020,197,27,989,321179852,2069041791,2390221643,120,968,3,1747861939,In > Out
Feb 2020,197,30,109,159971752,9967357004,10127328756,67,109,4,9807385252,In > Out
Feb 2020,197,31,193,18345990,535106642,553452632,85,193,6,516760652,In > Out
Feb 2020,197,32,254,65456393,1627573921,1693030314,80,254,8,1562117528,In > Out
Feb 2020,197,33,94,5913630,102475202,108388832,43,94,3,96561572,In > Out
Feb 2020,197,35,417,137374861,4404245382,4541620243,120,411,5,4266870521,In > Out
Feb 2020,197,37,111,19134446,428495685,447630131,58,110,4,409361239,In > Out
Feb 2020,197,38,135,1461508353,2076056399,3537564752,42,135,5,614548046,In > Out
Feb 2020,197,39,213,178643179,456588470,635231649,89,211,8,277945291,In > Out
Feb 2020,197,4,195,78742896,448045199,526788095,81,195,5,369302303,In > Out
Feb 2020,197,40,74,16443527,78221050,94664577,47,74,5,61777523,In > Out
Feb 2020,197,41,172,76052704,577370634,653423338,72,172,6,501317930,In > Out
Feb 2020,197,42,204,209413818,808398361,1017812179,76,201,4,598984543,In > Out
Feb 2020,197,43,131,17792424,185587939,203380363,70,131,5,167795515,In > Out
Feb 2020,197,44,165,194636675,1138608726,1333245401,64,165,3,943972051,In > Out
Feb 2020,197,45,212,27759277,2368340513,2396099790,58,209,3,2340581236,In > Out
Feb 2020,197,46,92,50436364,39340602,89776966,51,92,3,11095762,Out > In
Feb 2020,197,48,188,88542500,670531123,759073623,63,187,8,581988623,In > Out
Feb 2020,197,49,160,13896382,376441466,390337848,59,160,3,362545084,In > Out
Feb 2020,197,5,91,1050150929,1220582359,2270733288,53,91,7,170431430,In > Out
Feb 2020,197,51,80,9406320,207475130,216881450,43,80,5,198068810,In > Out
Feb 2020,197,53,362,51484535,1198661703,1250146238,113,359,3,1147177168,In > Out
Feb 2020,197,54,160,33479135,172928642,206407777,54,159,4,139449507,In > Out
Feb 2020,197,55,109,5458637,296650213,302108850,61,109,4,291191576,In > Out
Feb 2020,197,56,123,23410997,503903781,527314778,69,123,3,480492784,In > Out
Feb 2020,197,57,297,40315886,457262822,497578708,83,294,5,416946936,In > Out
Feb 2020,197,58,199,53353358,1283777866,1337131224,89,195,9,1230424508,In > Out
Feb 2020,197,59,139,36806868,738023933,774830801,61,139,4,701217065,In > Out
Feb 2020,197,6,225,458598969,1703600805,2162199774,82,225,3,1245001836,In > Out
Feb 2020,197,60,150,60584525,253041080,313625605,75,148,5,192456555,In > Out
Feb 2020,197,61,102,1292605973,1188508910,2481114883,56,100,7,104097063,Out > In
Feb 2020,197,62,346,112112549,549483813,661596362,69,342,5,437371264,In > Out
Feb 2020,197,63,28,2137222,43435098,45572320,17,28,2,41297876,In > Out
Feb 2020,197,64,148,250507490,104923961,355431451,79,146,5,145583529,Out > In
Feb 2020,197,65,75,9578801,200001555,209580356,36,75,2,190422754,In > Out
Feb 2020,197,66,88,127886133,241652261,369538394,34,88,4,113766128,In > Out
Feb 2020,197,68,142,31794716,283378654,315173370,57,141,3,251583938,In > Out
Feb 2020,197,69,29,10083107,157944052,168027159,20,29,4,147860945,In > Out
Feb 2020,197,71,178,23066005,899255352,922321357,68,178,3,876189347,In > Out
Feb 2020,197,72,138,21336275,1006262633,1027598908,50,134,5,984926358,In > Out
Feb 2020,197,73,104,9616203,61258850,70875053,60,104,4,51642647,In > Out
Feb 2020,197,74,195,27125504,188157334,215282838,69,192,4,161031830,In > Out
Feb 2020,197,75,114,80632992,207948176,288581168,50,114,6,127315184,In > Out
Feb 2020,197,76,139,395739184,475176078,870915262,71,139,3,79436894,In > Out
Feb 2020,197,77,286,365396471,715515591,1080912062,92,286,4,350119120,In > Out
Feb 2020,197,78,249,187477131,3927470023,4114947154,105,215,10,3739992892,In > Out
Feb 2020,197,79,80,28905360,74815400,103720760,50,80,4,45910040,In > Out
Feb 2020,197,80,161,29224907,376749945,405974852,56,161,4,347525038,In > Out
Feb 2020,197,81,164,19735791,465010852,484746643,73,163,4,445275061,In > Out
Feb 2020,197,82,105,8267638,187424587,195692225,62,105,3,179156949,In > Out
Feb 2020,197,83,163,20330975,200891688,221222663,49,163,4,180560713,In > Out
Feb 2020,197,85,137,21586330,867315389,888901719,72,137,3,845729059,In > Out
Feb 2020,197,86,198,60189434,1193166413,1253355847,75,197,3,1132976979,In > Out
Feb 2020,197,87,238,18230812,219213455,237444267,83,235,5,200982643,In > Out
Feb 2020,197,88,66,13056064,57855940,70912004,33,66,2,44799876,In > Out
Feb 2020,197,89,111,56131991,93305000,149436991,46,111,3,37173009,In > Out
Feb 2020,197,9,278,77392080,295215239,372607319,80,276,5,217823159,In > Out
Feb 2020,197,90,260,16850191,412260266,429110457,70,260,5,395410075,In > Out
Feb 2020,197,91,189,106346066,2393783356,2500129422,78,189,5,2287437290,In > Out
Feb 2020,197,92,91,80054838,6288631640,6368686478,28,91,3,6208576802,In > Out
Feb 2020,197,93,197,194941047,2566474652,2761415699,67,197,2,2371533605,In > Out
Feb 2020,197,94,98,4895838,141276929,146172767,47,98,3,136381091,In > Out
Feb 2020,197,95,429,299836903,1910969194,2210806097,103,419,15,1611132291,In > Out
Feb 2020,197,96,213,18220334,416867234,435087568,72,211,3,398646900,In > Out
Feb 2020,197,98,129,39112329,1729413386,1768525715,66,129,4,1690301057,In > Out
Feb 2020,197,99,149,69362025,637465501,706827526,82,149,5,568103476,In > Out
Feb 2020,198,22,21571,3885156033,78549855543,82435011576,2551,11902,84,74664699510,In > Out
Feb 2020,199,77,6,214243,510777,725020,1,6,1,296534,In > Out
Feb 2020,2,1,2,155420,101840,257260,1,1,1,53580,Out > In
Feb 2020,2,100,4,851341,64752,916093,4,4,1,786589,Out > In
Feb 2020,2,13,55,1350220,65611490,66961710,13,55,1,64261270,In > Out
Feb 2020,2,14,7,453746,95865719,96319465,3,7,2,95411973,In > Out
Feb 2020,2,15,3,46780,2668884,2715664,1,1,3,2622104,In > Out
Feb 2020,2,16,83,4618022,213328113,217946135,16,83,2,208710091,In > Out
Feb 2020,2,21,320,32415750,131245653,163661403,40,304,19,98829903,In > Out
Feb 2020,2,244,2,27593,1444718,1472311,1,2,1,1417125,In > Out
Feb 2020,2,253,3,261188,58794358,59055546,1,3,1,58533170,In > Out
Feb 2020,2,4,4,400672,342380,743052,1,1,1,58292,Out > In
Feb 2020,2,7,24,8960063,584941426,593901489,2,24,1,575981363,In > Out
Feb 2020,2,91,402,2055581812,315237228633,317292810445,22,395,3,313181646821,In > Out
Feb 2020,200,17,6,180980,1476702,1657682,5,6,3,1295722,In > Out
Feb 2020,200,199,39,1274092,44016164,45290256,10,39,2,42742072,In > Out
Feb 2020,200,20,15,697810,35638645,36336455,8,15,2,34940835,In > Out
Feb 2020,200,206,228,27398057,32843703,60241760,14,228,2,5445646,In > Out
Feb 2020,200,21,17,528203,25848166,26376369,11,17,2,25319963,In > Out
Feb 2020,200,210,128,14535146,56248615,70783761,1,128,1,41713469,In > Out
Feb 2020,200,211,1045,7838272,208724282,216562554,10,1021,1,200886010,In > Out
Feb 2020,200,212,37,2363527,60744992,63108519,16,37,2,58381465,In > Out
Feb 2020,200,22,8,293046,26277999,26571045,4,8,2,25984953,In > Out
Feb 2020,200,24,14,636197,36945688,37581885,9,14,2,36309491,In > Out
Feb 2020,200,25,9,586100,48422410,49008510,4,9,1,47836310,In > Out
Feb 2020,200,26,94,1102384,31439029,32541413,9,94,2,30336645,In > Out
Feb 2020,200,27,11,851123,35387738,36238861,6,11,1,34536615,In > Out
Feb 2020,200,28,17,1073781,62192903,63266684,9,17,2,61119122,In > Out
Feb 2020,200,29,13,329805,20691144,21020949,10,13,2,20361339,In > Out
Feb 2020,200,30,17,1881004,81392524,83273528,10,17,2,79511520,In > Out
Feb 2020,200,33,12,356040,31270048,31626088,7,12,1,30914008,In > Out
Feb 2020,200,34,45,3076903,66037523,69114426,24,45,2,62960620,In > Out
Feb 2020,200,35,24,1638147,84060231,85698378,12,24,2,82422084,In > Out
Feb 2020,200,36,11,683689,37610705,38294394,7,11,2,36927016,In > Out
Feb 2020,200,38,10,169783,22320207,22489990,8,10,2,22150424,In > Out
Feb 2020,200,39,11,540678,36395171,36935849,8,11,2,35854493,In > Out
Feb 2020,200,40,7,752892,47417785,48170677,5,7,1,46664893,In > Out
Feb 2020,200,43,6,1358673,272696,1631369,6,6,2,1085977,Out > In
Feb 2020,200,44,4,485955,374652,860607,3,4,2,111303,Out > In
Feb 2020,200,46,20,1319501,44694704,46014205,12,20,2,43375203,In > Out
Feb 2020,200,47,8,567957,35182638,35750595,6,8,2,34614681,In > Out
Feb 2020,200,48,9,373210,26051770,26424980,5,9,2,25678560,In > Out
Feb 2020,200,53,14,1606467,77776036,79382503,9,14,2,76169569,In > Out
Feb 2020,200,55,10,382803,20041334,20424137,4,10,1,19658531,In > Out
Feb 2020,200,60,5,696219,361649,1057868,4,5,2,334570,Out > In
Feb 2020,200,61,4,584921,157853,742774,3,4,2,427068,Out > In
Feb 2020,200,66,3,1356134,57024,1413158,2,3,1,1299110,Out > In
Feb 2020,200,89,5,847179,1529751,2376930,5,5,2,682572,In > Out
Feb 2020,200,96,5,1310307,22348148,23658455,5,5,2,21037841,In > Out
Feb 2020,203,148,132,12254315,95258741,107513056,65,132,2,83004426,In > Out
Feb 2020,203,156,245,19983619,125284187,145267806,89,245,2,105300568,In > Out
Feb 2020,203,221,324,37769884,245720784,283490668,126,322,2,207950900,In > Out
Feb 2020,203,241,76,3928438,88949351,92877789,44,76,2,85020913,In > Out
Feb 2020,203,65,925,112771967,598112186,710884153,177,896,2,485340219,In > Out
Feb 2020,203,74,6,134163178,225760918,359924096,1,6,1,91597740,In > Out
Feb 2020,203,82,27,677762,22833069,23510831,17,27,4,22155307,In > Out
Feb 2020,203,91,566,62179489,333333376,395512865,209,562,2,271153887,In > Out
Feb 2020,204,103,21,802150,11964921,12767071,9,21,1,11162771,In > Out
Feb 2020,204,105,691,841827245,7578741913,8420569158,285,464,64,6736914668,In > Out
Feb 2020,204,114,735,49141208,1152950918,1202092126,225,718,4,1103809710,In > Out
Feb 2020,204,128,135,15338221,190104187,205442408,30,135,4,174765966,In > Out
Feb 2020,204,142,70,5636723,64183070,69819793,12,70,2,58546347,In > Out
Feb 2020,204,159,71,16973967,97564074,114538041,44,71,2,80590107,In > Out
Feb 2020,204,160,1,4878,140726,145604,1,1,1,135848,In > Out
Feb 2020,204,164,202,15645957,339010179,354656136,73,201,2,323364222,In > Out
Feb 2020,204,173,1557,354045231,16563167820,16917213051,310,1482,7,16209122589,In > Out
Feb 2020,204,181,60,5609000,33144362,38753362,30,60,2,27535362,In > Out
Feb 2020,204,186,3,128782,3264585,3393367,3,3,1,3135803,In > Out
Feb 2020,204,188,59,3741874,186132071,189873945,15,59,2,182390197,In > Out
Feb 2020,204,192,95,17859336,100001477,117860813,28,95,2,82142141,In > Out
Feb 2020,204,205,1509,265843580,10607475444,10873319024,310,1430,25,10341631864,In > Out
Feb 2020,204,216,2168,375889611,3284804720,3660694331,244,2080,6,2908915109,In > Out
Feb 2020,204,28,36,939840,23800665,24740505,18,36,2,22860825,In > Out
Feb 2020,204,30,110,14298297,279191513,293489810,59,110,3,264893216,In > Out
Feb 2020,204,50,56,7861110,210510216,218371326,37,56,4,202649106,In > Out
Feb 2020,204,67,187,122313567,423310361,545623928,98,186,2,300996794,In > Out
Feb 2020,204,71,75,12983089,427986687,440969776,36,75,4,415003598,In > Out
Feb 2020,204,81,314,125176002,1469281550,1594457552,93,307,2,1344105548,In > Out
Feb 2020,204,83,308,274910721,12923097006,13198007727,81,308,2,12648186285,In > Out
Feb 2020,204,86,25,16041944,738435854,754477798,13,25,1,722393910,In > Out
Feb 2020,204,87,145,145286503,362919777,508206280,32,145,1,217633274,In > Out
Feb 2020,204,94,101,21005482,551897539,572903021,47,101,3,530892057,In > Out
Feb 2020,204,98,6,1526381,8557416,10083797,4,6,1,7031035,In > Out
Feb 2020,206,113,329,11405934,431425802,442831736,124,329,2,420019868,In > Out
Feb 2020,206,115,64,11822288,141222764,153045052,12,64,2,129400476,In > Out
Feb 2020,206,119,165,4567116,135283618,139850734,43,165,3,130716502,In > Out
Feb 2020,206,120,39,6657281,498450262,505107543,22,39,2,491792981,In > Out
Feb 2020,206,121,19,156716,5685052,5841768,8,19,1,5528336,In > Out
Feb 2020,206,123,742,85827222,2525880882,2611708104,284,731,4,2440053660,In > Out
Feb 2020,206,124,24,1655915,393460828,395116743,16,24,2,391804913,In > Out
Feb 2020,206,131,207,11752849,1583019337,1594772186,104,207,2,1571266488,In > Out
Feb 2020,206,132,90,4338426,182040746,186379172,44,90,2,177702320,In > Out
Feb 2020,206,133,232,22999447,230587721,253587168,96,232,2,207588274,In > Out
Feb 2020,206,134,353,13051273,306748850,319800123,113,353,2,293697577,In > Out
Feb 2020,206,135,164,6902290,209368669,216270959,43,164,2,202466379,In > Out
Feb 2020,206,136,44,1422190,44577148,45999338,28,44,2,43154958,In > Out
Feb 2020,206,137,116,24060795,75859728,99920523,52,116,2,51798933,In > Out
Feb 2020,206,138,68,2550997,71138371,73689368,25,68,2,68587374,In > Out
Feb 2020,206,139,139,5756393,212268019,218024412,72,139,2,206511626,In > Out
Feb 2020,206,140,107,4849806,443830359,448680165,38,107,2,438980553,In > Out
Feb 2020,206,141,157,352016706,169317377,521334083,85,157,2,182699329,Out > In
Feb 2020,206,142,137,3939744,89277928,93217672,23,137,2,85338184,In > Out
Feb 2020,206,143,213,8948988,246946252,255895240,66,213,2,237997264,In > Out
Feb 2020,206,144,86,5493977,69529346,75023323,42,86,2,64035369,In > Out
Feb 2020,206,145,194,11067605,147425883,158493488,86,194,2,136358278,In > Out
Feb 2020,206,146,257,21449111,371213066,392662177,69,256,2,349763955,In > Out
Feb 2020,206,147,238,15622659,974957135,990579794,85,238,2,959334476,In > Out
Feb 2020,206,148,172,5519070,172028258,177547328,40,172,2,166509188,In > Out
Feb 2020,206,149,54,1557700,56160867,57718567,29,53,2,54603167,In > Out
Feb 2020,206,150,377,14540764,389332452,403873216,44,377,2,374791688,In > Out
Feb 2020,206,151,163,7415002,292333593,299748595,91,162,2,284918591,In > Out
Feb 2020,206,152,77,2207813,48209351,50417164,33,77,1,46001538,In > Out
Feb 2020,206,153,68,3614136,99068841,102682977,41,68,2,95454705,In > Out
Feb 2020,206,154,12,574055,4718780,5292835,9,12,2,4144725,In > Out
Feb 2020,206,161,21,766280,24740061,25506341,11,21,2,23973781,In > Out
Feb 2020,206,162,6,181883,7219899,7401782,3,6,1,7038016,In > Out
Feb 2020,206,163,16,1293820,107000215,108294035,7,16,2,105706395,In > Out
Feb 2020,206,164,33,1092303,45742457,46834760,22,33,2,44650154,In > Out
Feb 2020,206,165,35,1243319,35392543,36635862,18,35,2,34149224,In > Out
Feb 2020,206,166,27,471956,14013721,14485677,15,27,2,13541765,In > Out
Feb 2020,206,167,35,894560,39536650,40431210,13,35,2,38642090,In > Out
Feb 2020,206,168,26,676300,26912303,27588603,13,26,2,26236003,In > Out
Feb 2020,206,169,14,486582,24523995,25010577,8,14,2,24037413,In > Out
Feb 2020,206,170,9,324443,13329201,13653644,4,9,1,13004758,In > Out
Feb 2020,206,171,29,820960,25295590,26116550,17,29,2,24474630,In > Out
Feb 2020,206,191,845,106424581,951726154,1058150735,206,826,3,845301573,In > Out
Feb 2020,206,200,655,33094999,594107220,627202219,267,641,5,561012221,In > Out
Feb 2020,206,201,209,6667059,150548299,157215358,131,209,2,143881240,In > Out
Feb 2020,206,208,6,98800,874953,973753,3,6,1,776153,In > Out
Feb 2020,206,209,163,68329972,1541228850,1609558822,85,163,2,1472898878,In > Out
Feb 2020,206,228,227,59403525,2858379534,2917783059,120,226,2,2798976009,In > Out
Feb 2020,206,232,8,811881,129500056,130311937,5,8,2,128688175,In > Out
Feb 2020,206,243,64,3730971,144986492,148717463,35,64,5,141255521,In > Out
Feb 2020,206,245,48,1682317,51390265,53072582,17,43,2,49707948,In > Out
Feb 2020,206,248,152,7049246,335737275,342786521,46,151,2,328688029,In > Out
Feb 2020,206,33,104,12615477,621830504,634445981,22,94,7,609215027,In > Out
Feb 2020,206,43,27,1208366,37305008,38513374,19,27,2,36096642,In > Out
Feb 2020,206,7,208,13034883597,544945202536,557980086133,28,198,6,531910318939,In > Out
Feb 2020,206,71,37,1443394,71925658,73369052,17,37,1,70482264,In > Out
Feb 2020,207,111,205,4887285,182720355,187607640,28,205,2,177833070,In > Out
Feb 2020,207,127,174,49620789,5524753,55145542,57,1,149,44096036,Out > In
Feb 2020,207,142,265,285749312,695316090,981065402,133,265,3,409566778,In > Out
Feb 2020,207,151,15,795814,14361356,15157170,6,15,2,13565542,In > Out
Feb 2020,207,163,178,6048594,76498690,82547284,81,175,2,70450096,In > Out
Feb 2020,207,213,179,9490652,115194597,124685249,89,179,2,105703945,In > Out
Feb 2020,207,40,1,10932,110041,120973,1,1,1,99109,In > Out
Feb 2020,207,57,85,1415703,49411835,50827538,10,85,2,47996132,In > Out
Feb 2020,208,104,19,167007,9033632,9200639,6,19,1,8866625,In > Out
Feb 2020,208,105,84,362817,12286095,12648912,5,84,2,11923278,In > Out
Feb 2020,208,109,19,138840,6551728,6690568,4,19,1,6412888,In > Out
Feb 2020,208,111,6,240383,31516509,31756892,2,6,1,31276126,In > Out
Feb 2020,208,112,4,566595,50300120,50866715,3,4,2,49733525,In > Out
Feb 2020,208,119,17,54109,3364504,3418613,5,17,1,3310395,In > Out
Feb 2020,208,125,12,1234593,88681803,89916396,4,12,2,87447210,In > Out
Feb 2020,208,126,9,564166,76306086,76870252,2,9,1,75741920,In > Out
Feb 2020,208,127,13,1770137,65397288,67167425,4,13,2,63627151,In > Out
Feb 2020,208,128,137,5644623,135307934,140952557,17,134,2,129663311,In > Out
Feb 2020,208,17,17,156663,6119693,6276356,4,17,1,5963030,In > Out
Feb 2020,208,18,560,223665867,59607853,283273720,8,555,2,164058014,Out > In
Feb 2020,208,195,5,1086065,108714825,109800890,1,5,1,107628760,In > Out
Feb 2020,208,27,14,89596,5008101,5097697,5,14,1,4918505,In > Out
Feb 2020,208,29,21,75318,4858345,4933663,4,21,1,4783027,In > Out
Feb 2020,208,30,19,644775,7997846,8642621,8,19,2,7353071,In > Out
Feb 2020,208,32,25,859956,3969937,4829893,14,25,2,3109981,In > Out
Feb 2020,208,39,3,100344,6265683,6366027,3,3,2,6165339,In > Out
Feb 2020,208,40,17,61032,3613125,3674157,5,17,1,3552093,In > Out
Feb 2020,208,41,33,1411231,4225545,5636776,16,33,2,2814314,In > Out
Feb 2020,208,44,4,1176885,69007395,70184280,2,4,1,67830510,In > Out
Feb 2020,208,45,7,572921,61680092,62253013,3,7,2,61107171,In > Out
Feb 2020,208,46,4,530298,43265802,43796100,3,4,2,42735504,In > Out
Feb 2020,208,47,16,212651,5240092,5452743,7,16,2,5027441,In > Out
Feb 2020,208,48,21,54901,3567547,3622448,3,21,1,3512646,In > Out
Feb 2020,208,49,12,46122,2625257,2671379,4,12,1,2579135,In > Out
Feb 2020,208,50,29,83489,4785741,4869230,4,29,2,4702252,In > Out
Feb 2020,208,52,3,128324,6868909,6997233,2,3,2,6740585,In > Out
Feb 2020,208,55,16,52373,4120834,4173207,4,16,1,4068461,In > Out
Feb 2020,208,58,17,760330,2277818,3038148,10,17,2,1517488,In > Out
Feb 2020,208,59,27,166137,10242517,10408654,5,27,1,10076380,In > Out
Feb 2020,208,60,22,100084,6621050,6721134,2,22,1,6520966,In > Out
Feb 2020,208,61,10,38262,3602643,3640905,3,10,1,3564381,In > Out
Feb 2020,208,62,26,106159,6421303,6527462,4,26,1,6315144,In > Out
Feb 2020,208,64,41,4277124,4915535,9192659,22,41,2,638411,In > Out
Feb 2020,208,65,5,413368,49143634,49557002,2,5,1,48730266,In > Out
Feb 2020,208,69,15,65822,3963589,4029411,5,15,1,3897767,In > Out
Feb 2020,208,71,15,39774,2479727,2519501,3,15,1,2439953,In > Out
Feb 2020,208,78,12,62447,3974068,4036515,3,12,1,3911621,In > Out
Feb 2020,208,81,2,383400,19235547,19618947,2,2,2,18852147,In > Out
Feb 2020,208,82,15,55434,3641028,3696462,4,15,1,3585594,In > Out
Feb 2020,208,83,11,441670,36271500,36713170,6,11,2,35829830,In > Out
Feb 2020,208,86,6,436784,38287130,38723914,4,6,2,37850346,In > Out
Feb 2020,208,87,19,2193694,88107764,90301458,7,19,2,85914070,In > Out
Feb 2020,208,88,19,1313946,63098108,64412054,5,19,2,61784162,In > Out
Feb 2020,208,89,26,2631078,120599853,123230931,6,26,2,117968775,In > Out
Feb 2020,208,90,139,13759017261,133534541,13892551802,28,139,1,13625482720,Out > In
Feb 2020,208,91,20,3988540270,101515290,4090055560,9,20,2,3887024980,Out > In
Feb 2020,208,92,20,4717308,51761729,56479037,4,20,1,47044421,In > Out
Feb 2020,208,93,33,9099064,73154422,82253486,3,33,2,64055358,In > Out
Feb 2020,209,100,24,67305380,7227932964,7295238344,10,24,2,7160627584,In > Out
Feb 2020,209,101,296,8625182,1267102206,1275727388,9,293,1,1258477024,In > Out
Feb 2020,209,18,111,15379319,138911134,154290453,57,111,2,123531815,In > Out
Feb 2020,209,203,1,7120,134614,141734,1,1,1,127494,In > Out
Feb 2020,209,204,16,2698879,225200398,227899277,10,16,2,222501519,In > Out
Feb 2020,209,205,16,1450452,93390635,94841087,6,16,1,91940183,In > Out
Feb 2020,209,214,17,1275575,93635660,94911235,10,17,2,92360085,In > Out
Feb 2020,209,65,2,182216,16118552,16300768,2,2,1,15936336,In > Out
Feb 2020,21,160,8,168901,10281493,10450394,5,8,2,10112592,In > Out
Feb 2020,21,173,10,496084,12015165,12511249,4,10,2,11519081,In > Out
Feb 2020,21,185,5,51162,1258453,1309615,4,5,1,1207291,In > Out
Feb 2020,21,190,3,28661,1028185,1056846,3,3,1,999524,In > Out
Feb 2020,21,194,11,1024787,54288061,55312848,8,11,2,53263274,In > Out
Feb 2020,21,212,1,79984,23905,103889,1,1,1,56079,Out > In
Feb 2020,21,214,51,2327295,29029833,31357128,33,51,2,26702538,In > Out
Feb 2020,21,215,8,260151,5011610,5271761,4,8,2,4751459,In > Out
Feb 2020,21,216,5,972505,48405763,49378268,5,5,2,47433258,In > Out
Feb 2020,21,234,14,180483,11240028,11420511,8,14,1,11059545,In > Out
Feb 2020,212,31,42,3652685937,501587066,4154273003,37,1,42,3151098871,Out > In
Feb 2020,213,1,73961,24820502695,238464062209,263284564904,6651,21618,205,213643559514,In > Out
Feb 2020,213,10,84671,20034428707,251759898561,271794327268,7180,21719,330,231725469854,In > Out
Feb 2020,213,100,89315,29301925336,275072073392,304373998728,8065,22960,203,245770148056,In > Out
Feb 2020,213,101,102735,41850760750,357357718816,399208479566,8694,24906,420,315506958066,In > Out
Feb 2020,213,102,97772,59822901591,255665404013,315488305604,7771,23442,463,195842502422,In > Out
Feb 2020,213,103,91099,23165343244,285065542993,308230886237,7400,22982,209,261900199749,In > Out
Feb 2020,213,104,105369,41769510731,460372764990,502142275721,8896,24196,963,418603254259,In > Out
Feb 2020,213,105,99005,32547265831,386465041780,419012307611,7805,23179,266,353917775949,In > Out
Feb 2020,213,106,87231,24497546201,228462421734,252959967935,7932,22504,307,203964875533,In > Out
Feb 2020,213,107,98830,36417354150,368033185168,404450539318,8883,22862,1008,331615831018,In > Out
Feb 2020,213,108,109304,41141767314,400244519408,441386286722,8824,22430,891,359102752094,In > Out
Feb 2020,213,109,87467,93458168241,294281121062,387739289303,7803,23172,268,200822952821,In > Out
Feb 2020,213,11,104360,30787154813,435516891278,466304046091,8606,22978,234,404729736465,In > Out
Feb 2020,213,110,93836,69925823375,308419126559,378344949934,7497,23590,195,238493303184,In > Out
Feb 2020,213,111,91028,24769508199,336087083786,360856591985,7752,23037,338,311317575587,In > Out
Feb 2020,213,112,93464,68213423221,309143595563,377357018784,8022,24002,328,240930172342,In > Out
Feb 2020,213,113,90646,25914199573,307937274641,333851474214,7646,23838,247,282023075068,In > Out
Feb 2020,213,114,100324,38905635446,348261238463,387166873909,7884,24885,415,309355603017,In > Out
Feb 2020,213,115,107277,42021255119,337067018817,379088273936,7874,22589,551,295045763698,In > Out
Feb 2020,213,116,91428,58330087227,363759429470,422089516697,7567,23247,361,305429342243,In > Out
Feb 2020,213,117,104415,38701692958,442890132340,481591825298,8135,24116,506,404188439382,In > Out
Feb 2020,213,118,95240,35334055429,348081135315,383415190744,8038,23275,236,312747079886,In > Out
Feb 2020,213,119,98886,34870606692,342621128834,377491735526,8215,23537,265,307750522142,In > Out
Feb 2020,213,12,87234,33124647181,296325528753,329450175934,7952,22196,357,263200881572,In > Out
Feb 2020,213,120,91815,27047846557,314269055262,341316901819,7811,22912,169,287221208705,In > Out
Feb 2020,213,121,92869,27062180032,329172457571,356234637603,7650,22345,335,302110277539,In > Out
Feb 2020,213,122,87710,22449859394,306258689385,328708548779,7791,23255,341,283808829991,In > Out
Feb 2020,213,123,103164,39086992876,328853699305,367940692181,8034,23308,254,289766706429,In > Out
Feb 2020,213,124,101018,32429727166,316263339722,348693066888,7679,22929,207,283833612556,In > Out
Feb 2020,213,125,106228,55831180969,390327181216,446158362185,8555,23023,593,334496000247,In > Out
Feb 2020,213,126,101864,39541272720,323370067713,362911340433,7945,23434,224,283828794993,In > Out
Feb 2020,213,127,106511,38500508894,339519547312,378020056206,8564,26023,318,301019038418,In > Out
Feb 2020,213,128,99586,38919275773,325370504220,364289779993,8796,22942,630,286451228447,In > Out
Feb 2020,213,129,104745,47410871730,380140419879,427551291609,8159,23501,353,332729548149,In > Out
Feb 2020,213,13,91006,20906851337,328776435680,349683287017,7814,21761,362,307869584343,In > Out
Feb 2020,213,130,94254,33038912006,288005166577,321044078583,8071,23406,381,254966254571,In > Out
Feb 2020,213,131,96679,20302874865,286607438307,306910313172,7767,23604,344,266304563442,In > Out
Feb 2020,213,132,115773,46141655247,389848448209,435990103456,10065,23773,1877,343706792962,In > Out
Feb 2020,213,133,91004,27409780433,296480122530,323889902963,7882,22986,404,269070342097,In > Out
Feb 2020,213,134,89954,27341935836,307228375559,334570311395,7761,22846,222,279886439723,In > Out
Feb 2020,213,135,93482,31543737043,317901237451,349444974494,7482,22873,211,286357500408,In > Out
Feb 2020,213,136,96679,28914927971,334742783389,363657711360,7536,22598,252,305827855418,In > Out
Feb 2020,213,137,87182,25581223255,266543747247,292124970502,7935,22816,848,240962523992,In > Out
Feb 2020,213,138,94281,31100735522,558347398951,589448134473,7723,22393,444,527246663429,In > Out
Feb 2020,213,139,90426,27687865636,296094206201,323782071837,7976,23737,579,268406340565,In > Out
Feb 2020,213,14,89415,33543713547,449049371255,482593084802,7635,22067,357,415505657708,In > Out
Feb 2020,213,140,92564,34293779003,428358373277,462652152280,7687,23606,283,394064594274,In > Out
Feb 2020,213,141,102306,39748689733,373619259404,413367949137,7799,24249,292,333870569671,In > Out
Feb 2020,213,142,87872,24518818534,379314816395,403833634929,7870,23834,342,354795997861,In > Out
Feb 2020,213,143,95153,30177911542,306833720840,337011632382,8181,22688,373,276655809298,In > Out
Feb 2020,213,144,96765,30673022928,307004777927,337677800855,7799,23471,212,276331754999,In > Out
Feb 2020,213,145,96417,26307876584,321214793674,347522670258,7362,23413,199,294906917090,In > Out
Feb 2020,213,146,91748,22534192417,272273181702,294807374119,7760,23067,188,249738989285,In > Out
Feb 2020,213,147,91701,38971121350,280902350674,319873472024,8188,22836,472,241931229324,In > Out
Feb 2020,213,148,94468,43318539065,305362423179,348680962244,7945,22811,287,262043884114,In > Out
Feb 2020,213,149,86560,22000813031,273080038090,295080851121,7373,22588,208,251079225059,In > Out
Feb 2020,213,15,83431,37870531829,276470088688,314340620517,7442,21537,402,238599556859,In > Out
Feb 2020,213,150,96357,31063237408,275768781048,306832018456,7814,22993,361,244705543640,In > Out
Feb 2020,213,151,84109,25899056791,301285662473,327184719264,7086,22610,188,275386605682,In > Out
Feb 2020,213,152,97002,29391145596,360035082597,389426228193,8159,22804,548,330643937001,In > Out
Feb 2020,213,153,95368,32345234517,373201932253,405547166770,7807,23002,461,340856697736,In > Out
Feb 2020,213,154,103622,28423469875,319196597919,347620067794,9182,23794,1307,290773128044,In > Out
Feb 2020,213,155,85973,57296356500,286017880576,343314237076,7523,22991,362,228721524076,In > Out
Feb 2020,213,156,92946,57835081300,331267659293,389102740593,7641,22775,230,273432577993,In > Out
Feb 2020,213,157,97941,32137380722,282897792757,315035173479,8702,23184,944,250760412035,In > Out
Feb 2020,213,158,102639,29030418519,330529305336,359559723855,8010,23276,305,301498886817,In > Out
Feb 2020,213,159,95569,26568623177,293883810267,320452433444,7449,23038,208,267315187090,In > Out
Feb 2020,213,16,83723,25902095273,250687687532,276589782805,7471,23202,321,224785592259,In > Out
Feb 2020,213,160,98273,44464312168,316998989404,361463301572,8234,23129,398,272534677236,In > Out
Feb 2020,213,161,88783,34331115545,274903878503,309234994048,7618,22225,253,240572762958,In > Out
Feb 2020,213,162,92036,35865462958,295869002776,331734465734,8919,22920,1788,260003539818,In > Out
Feb 2020,213,163,87711,38151245786,420580810535,458732056321,8004,22989,513,382429564749,In > Out
Feb 2020,213,164,81045,24054855066,222958210721,247013065787,7293,22245,194,198903355655,In > Out
Feb 2020,213,165,95156,30989698699,319309203984,350298902683,7978,23642,514,288319505285,In > Out
Feb 2020,213,166,91604,31574675585,293257369792,324832045377,7938,22333,361,261682694207,In > Out
Feb 2020,213,167,90717,22910887898,290737117129,313648005027,7132,23037,185,267826229231,In > Out
Feb 2020,213,168,96270,34981815874,305494748038,340476563912,8221,23869,361,270512932164,In > Out
Feb 2020,213,169,101892,28844917985,359932839294,388777757279,7849,23763,192,331087921309,In > Out
Feb 2020,213,17,92737,27930579561,268597806140,296528385701,7647,22403,611,240667226579,In > Out
Feb 2020,213,170,86851,31866806657,267511168931,299377975588,7534,23724,327,235644362274,In > Out
Feb 2020,213,171,92331,29192948226,266182907033,295375855259,7526,22874,257,236989958807,In > Out
Feb 2020,213,172,92030,26234266848,283797286389,310031553237,7446,22808,256,257563019541,In > Out
Feb 2020,213,173,90447,31071196255,251462453698,282533649953,7636,23549,257,220391257443,In > Out
Feb 2020,213,174,91102,29842185920,417211890681,447054076601,7934,23057,657,387369704761,In > Out
Feb 2020,213,175,82129,29083587647,260363986831,289447574478,7761,22295,525,231280399184,In > Out
Feb 2020,213,176,98412,28281230058,273248278835,301529508893,7576,23614,216,244967048777,In > Out
Feb 2020,213,177,74419,23535441085,213072537384,236607978469,6594,22260,157,189537096299,In > Out
Feb 2020,213,178,91517,28607902868,328656348017,357264250885,7559,23594,229,300048445149,In > Out
Feb 2020,213,179,83674,31021140222,289889538534,320910678756,7611,22282,344,258868398312,In > Out
Feb 2020,213,18,87087,27524634643,351225539246,378750173889,7477,22130,309,323700904603,In > Out
Feb 2020,213,180,73964,23187543520,244143128340,267330671860,6824,22361,164,220955584820,In > Out
Feb 2020,213,181,86399,20158488676,281316768678,301475257354,7502,22385,362,261158280002,In > Out
Feb 2020,213,182,81572,24518647696,219598681332,244117329028,7125,22031,176,195080033636,In > Out
Feb 2020,213,183,85124,24774335539,254216892775,278991228314,7011,22068,327,229442557236,In > Out
Feb 2020,213,184,80569,24672700080,214543081544,239215781624,7308,21970,472,189870381464,In > Out
Feb 2020,213,185,87781,29512111743,256210547769,285722659512,7540,22455,601,226698436026,In > Out
Feb 2020,213,186,79595,33427764208,253737780635,287165544843,7717,21774,553,220310016427,In > Out
Feb 2020,213,187,87873,31384623843,242106241377,273490865220,7200,22604,355,210721617534,In > Out
Feb 2020,213,188,90046,24974332469,313619653750,338593986219,7389,22810,464,288645321281,In > Out
Feb 2020,213,189,84679,21705085271,221443107237,243148192508,7348,22779,211,199738021966,In > Out
Feb 2020,213,19,84420,26734595551,317797687959,344532283510,7459,22912,246,291063092408,In > Out
Feb 2020,213,190,85084,32204575415,260471250491,292675825906,7301,22790,475,228266675076,In > Out
Feb 2020,213,191,78677,18188631213,248276868321,266465499534,7178,21377,177,230088237108,In > Out
Feb 2020,213,192,75271,23719440074,321969644824,345689084898,7141,22925,216,298250204750,In > Out
Feb 2020,213,193,69062,21217086213,172930319949,194147406162,6631,22484,134,151713233736,In > Out
Feb 2020,213,194,68661,23745994830,196878964443,220624959273,6461,20904,181,173132969613,In > Out
Feb 2020,213,195,70822,29863363025,198360036197,228223399222,6543,21752,409,168496673172,In > Out
Feb 2020,213,196,90179,23890579394,254505169342,278395748736,7916,21942,1883,230614589948,In > Out
Feb 2020,213,197,56587,16857181555,172072437456,188929619011,6010,20074,173,155215255901,In > Out
Feb 2020,213,198,73095,26679470856,195804811399,222484282255,6594,21110,292,169125340543,In > Out
Feb 2020,213,199,63314,16526523845,162812291898,179338815743,6111,21077,157,146285768053,In > Out
Feb 2020,213,2,90620,32061120983,245469390764,277530511747,7665,22387,159,213408269781,In > Out
Feb 2020,213,20,101477,30376617694,311225389372,341602007066,8418,23587,368,280848771678,In > Out
Feb 2020,213,200,74898,18575467603,222828422987,241403890590,7837,21254,1059,204252955384,In > Out
Feb 2020,213,201,60138,21225066304,171482644299,192707710603,6079,20633,121,150257577995,In > Out
Feb 2020,213,202,82595,23319909666,285816307780,309136217446,7134,22233,232,262496398114,In > Out
Feb 2020,213,203,71407,18944192391,197065071902,216009264293,6950,21426,380,178120879511,In > Out
Feb 2020,213,204,62866,22665574458,251611521485,274277095943,6478,20863,160,228945947027,In > Out
Feb 2020,213,205,72100,18431627080,204934341162,223365968242,6762,20785,329,186502714082,In > Out
Feb 2020,213,206,68316,24516466344,159411167462,183927633806,6802,21286,373,134894701118,In > Out
Feb 2020,213,207,67686,23277432606,232378121505,255655554111,6307,20700,279,209100688899,In > Out
Feb 2020,213,208,64570,18329974332,371856395578,390186369910,6499,20781,201,353526421246,In > Out
Feb 2020,213,209,68549,15970096350,261741898317,277711994667,6153,21459,109,245771801967,In > Out
Feb 2020,213,21,86241,38499690447,321694122605,360193813052,7329,22411,230,283194432158,In > Out
Feb 2020,213,210,69232,24660596489,274841031456,299501627945,6564,21344,272,250180434967,In > Out
Feb 2020,213,211,65647,20284294184,185296353980,205580648164,6500,21363,311,165012059796,In > Out
Feb 2020,213,212,73899,24237580198,236805466550,261043046748,6670,21806,167,212567886352,In > Out
Feb 2020,213,213,68075,19093444418,207987645148,227081089566,6955,21227,218,188894200730,In > Out
Feb 2020,213,214,65097,13574925156,163697653485,177272578641,6482,20621,305,150122728329,In > Out
Feb 2020,213,215,60873,19191891275,165284528669,184476419944,6292,19644,248,146092637394,In > Out
Feb 2020,213,216,81654,27894585892,243464133353,271358719245,6514,21369,319,215569547461,In > Out
Feb 2020,213,217,65538,30568867174,161403995823,191972862997,6302,21649,168,130835128649,In > Out
Feb 2020,213,218,66786,18815760713,197589045659,216404806372,6569,21645,255,178773284946,In > Out
Feb 2020,213,219,69200,16346332627,197138354335,213484686962,6546,21574,130,180792021708,In > Out
Feb 2020,213,22,93214,22405686664,319038289014,341443975678,7704,22138,405,296632602350,In > Out
Feb 2020,213,220,69948,18245798447,193627011402,211872809849,6460,21695,198,175381212955,In > Out
Feb 2020,213,221,77509,22372022075,200310501646,222682523721,6832,22507,183,177938479571,In > Out
Feb 2020,213,222,73874,36284311440,230381326070,266665637510,6927,21519,228,194097014630,In > Out
Feb 2020,213,223,67243,15513290477,207008286026,222521576503,6523,21674,306,191494995549,In > Out
Feb 2020,213,224,69965,23042161736,365243565946,388285727682,6025,21299,160,342201404210,In > Out
Feb 2020,213,225,73912,23432651047,244816776452,268249427499,6802,22071,282,221384125405,In > Out
Feb 2020,213,226,69989,17996806103,190154621856,208151427959,6504,21139,310,172157815753,In > Out
Feb 2020,213,227,63164,16652050690,214407221315,231059272005,6357,20435,363,197755170625,In > Out
Feb 2020,213,228,70417,18929947227,241169204754,260099151981,7529,20874,761,222239257527,In > Out
Feb 2020,213,229,67267,21258243302,169965914155,191224157457,6326,21855,158,148707670853,In > Out
Feb 2020,213,23,84876,24707305027,264305366256,289012671283,7365,22375,269,239598061229,In > Out
Feb 2020,213,230,60165,33490341128,212355950268,245846291396,6060,21072,248,178865609140,In > Out
Feb 2020,213,231,65094,18608641498,188982246444,207590887942,6049,22096,121,170373604946,In > Out
Feb 2020,213,232,71496,18714124454,170048296913,188762421367,6828,21252,176,151334172459,In > Out
Feb 2020,213,233,73451,22258993116,275283845890,297542839006,6772,21656,273,253024852774,In > Out
Feb 2020,213,234,60699,23000570889,234008887720,257009458609,6128,19846,194,211008316831,In > Out
Feb 2020,213,235,65655,16395454732,265466946196,281862400928,6304,21940,348,249071491464,In > Out
Feb 2020,213,236,68375,22457555775,263416517008,285874072783,6445,21297,193,240958961233,In > Out
Feb 2020,213,237,64276,26310743540,190822457647,217133201187,6165,19992,153,164511714107,In > Out
Feb 2020,213,238,65353,21227682668,189796178538,211023861206,6167,21661,220,168568495870,In > Out
Feb 2020,213,239,80283,27490752342,305655027740,333145780082,7222,21948,261,278164275398,In > Out
Feb 2020,213,24,91106,32527244495,251037466268,283564710763,7419,23895,244,218510221773,In > Out
Feb 2020,213,240,80426,29254107643,273249937825,302504045468,6912,22050,169,243995830182,In > Out
Feb 2020,213,241,71845,27961767735,305891816812,333853584547,6687,22060,323,277930049077,In > Out
Feb 2020,213,242,81145,20370895477,227531473842,247902369319,6968,22959,136,207160578365,In > Out
Feb 2020,213,243,84032,32896736992,431955542311,464852279303,7803,24177,359,399058805319,In > Out
Feb 2020,213,244,66251,19896289410,204720478285,224616767695,6187,21283,218,184824188875,In > Out
Feb 2020,213,245,75546,27009181522,224500097100,251509278622,6463,22026,161,197490915578,In > Out
Feb 2020,213,246,77812,26844881664,235819609683,262664491347,6933,22557,151,208974728019,In > Out
Feb 2020,213,247,86272,23665697473,314405285086,338070982559,7231,22206,267,290739587613,In > Out
Feb 2020,213,248,75920,24589199409,284456643308,309045842717,7300,22171,362,259867443899,In > Out
Feb 2020,213,249,71736,22809139923,218212813060,241021952983,6490,22060,311,195403673137,In > Out
Feb 2020,213,25,81763,30549766565,285997026177,316546792742,7272,21463,271,255447259612,In > Out
Feb 2020,213,250,80070,23328569574,266952341803,290280911377,7255,21893,245,243623772229,In > Out
Feb 2020,213,251,89588,22917638897,327238274348,350155913245,7190,22831,348,304320635451,In > Out
Feb 2020,213,252,79364,29489829102,345611796009,375101625111,6798,22615,257,316121966907,In > Out
Feb 2020,213,253,82901,33935170548,287308724038,321243894586,7606,21897,392,253373553490,In > Out
Feb 2020,213,254,83400,20918247423,288539497074,309457744497,7338,22053,252,267621249651,In > Out
Feb 2020,213,26,88829,28348872570,270717093172,299065965742,7755,22828,331,242368220602,In > Out
Feb 2020,213,27,94869,31929605672,396061566164,427991171836,8544,22966,753,364131960492,In > Out
Feb 2020,213,28,90079,26542746092,243778746250,270321492342,7829,23520,272,217236000158,In > Out
Feb 2020,213,29,93583,53515517739,299418188828,352933706567,7689,23352,350,245902671089,In > Out
Feb 2020,213,3,82529,26455554357,295166081180,321621635537,7077,21578,154,268710526823,In > Out
Feb 2020,213,30,108361,27576164312,390309897242,417886061554,8648,22949,285,362733732930,In > Out
Feb 2020,213,31,92721,32596915272,303292074643,335888989915,8325,22785,568,270695159371,In > Out
Feb 2020,213,32,83870,31431763694,295818053751,327249817445,7799,23396,579,264386290057,In > Out
Feb 2020,213,33,84208,27380959850,249682458556,277063418406,7205,22571,203,222301498706,In > Out
Feb 2020,213,34,88308,28298219233,297077630251,325375849484,8306,22749,588,268779411018,In > Out
Feb 2020,213,35,92016,29379644202,310979680248,340359324450,7832,22085,279,281600036046,In > Out
Feb 2020,213,36,93643,61031823425,350868685875,411900509300,8062,25038,568,289836862450,In > Out
Feb 2020,213,37,98132,37430050232,360101915959,397531966191,8134,23360,569,322671865727,In > Out
Feb 2020,213,38,94003,42229378135,338326213187,380555591322,8264,22215,458,296096835052,In > Out
Feb 2020,213,39,93369,25627987362,330365308012,355993295374,8154,23187,411,304737320650,In > Out
Feb 2020,213,4,89017,28250471295,303488525785,331738997080,7473,22448,212,275238054490,In > Out
Feb 2020,213,40,88680,49363726373,297269560689,346633287062,7997,22839,435,247905834316,In > Out
Feb 2020,213,41,83628,24065942526,273993101467,298059043993,7445,22525,206,249927158941,In > Out
Feb 2020,213,42,96481,35464105485,332771703687,368235809172,8292,22820,412,297307598202,In > Out
Feb 2020,213,43,93787,35537247287,327004191840,362541439127,7755,23684,463,291466944553,In > Out
Feb 2020,213,44,87117,26488925310,335898203838,362387129148,7274,22161,225,309409278528,In > Out
Feb 2020,213,45,89885,33500891705,291075720945,324576612650,7754,22917,287,257574829240,In > Out
Feb 2020,213,46,100667,31401351769,368107135176,399508486945,8147,24379,325,336705783407,In > Out
Feb 2020,213,47,83890,27380726271,268090850232,295471576503,7444,22206,317,240710123961,In > Out
Feb 2020,213,48,88095,26082026833,315729503660,341811530493,7318,22713,333,289647476827,In > Out
Feb 2020,213,49,88819,33711195221,251919892892,285631088113,7353,23262,221,218208697671,In > Out
Feb 2020,213,5,80550,22151068417,240402096737,262553165154,7238,23086,228,218251028320,In > Out
Feb 2020,213,50,91485,32249104279,320127086548,352376190827,7733,21896,396,287877982269,In > Out
Feb 2020,213,51,89363,33933453282,308526701233,342460154515,7690,22117,342,274593247951,In > Out
Feb 2020,213,52,79344,31892782654,448449350750,480342133404,7412,22294,371,416556568096,In > Out
Feb 2020,213,53,97591,40803267986,428061118875,468864386861,8319,23840,525,387257850889,In > Out
Feb 2020,213,54,82712,27802047912,236077564178,263879612090,7122,23017,212,208275516266,In > Out
Feb 2020,213,55,90969,27709864027,268545860954,296255724981,7477,23202,265,240835996927,In > Out
Feb 2020,213,56,86026,51581224188,297914752867,349495977055,7358,22642,280,246333528679,In > Out
Feb 2020,213,57,91814,32514365599,314150336105,346664701704,7862,23355,623,281635970506,In > Out
Feb 2020,213,58,89381,28092506285,403703380558,431795886843,9258,22621,2028,375610874273,In > Out
Feb 2020,213,59,86106,32521141417,284069559708,316590701125,7404,22302,375,251548418291,In > Out
Feb 2020,213,6,90090,49072609825,410569763038,459642372863,7948,23206,378,361497153213,In > Out
Feb 2020,213,60,82095,23484004419,265116120514,288600124933,7460,22621,252,241632116095,In > Out
Feb 2020,213,61,86766,33167917470,247209401522,280377318992,7664,21862,367,214041484052,In > Out
Feb 2020,213,62,83641,33773752908,283846734035,317620486943,7290,22951,573,250072981127,In > Out
Feb 2020,213,63,89299,30095083015,266632251184,296727334199,7404,22646,200,236537168169,In > Out
Feb 2020,213,64,98536,63438812354,302767301018,366206113372,8308,23084,359,239328488664,In > Out
Feb 2020,213,65,99478,26023696060,328731482203,354755178263,7785,23745,273,302707786143,In > Out
Feb 2020,213,66,80952,30893957135,275719232583,306613189718,7204,22191,253,244825275448,In > Out
Feb 2020,213,67,92005,37409703902,314982722281,352392426183,7937,23591,537,277573018379,In > Out
Feb 2020,213,68,98437,26655813016,370311453431,396967266447,8051,23504,284,343655640415,In > Out
Feb 2020,213,69,93798,30728769694,324248271612,354977041306,8215,25430,439,293519501918,In > Out
Feb 2020,213,7,87896,70583417287,298367941220,368951358507,7649,21934,364,227784523933,In > Out
Feb 2020,213,70,92022,36407119114,282661727806,319068846920,7089,23017,283,246254608692,In > Out
Feb 2020,213,71,91955,88375744840,340988584761,429364329601,7682,22542,209,252612839921,In > Out
Feb 2020,213,72,93539,28655294127,360775304882,389430599009,7743,22864,475,332120010755,In > Out
Feb 2020,213,73,91420,44831319933,796244838620,841076158553,7794,22337,233,751413518687,In > Out
Feb 2020,213,74,85272,21869824424,220767771785,242637596209,7512,22276,767,198897947361,In > Out
Feb 2020,213,75,74169,22830802746,228953300905,251784103651,6958,21263,224,206122498159,In > Out
Feb 2020,213,76,82045,30201515087,221179279039,251380794126,7849,22430,693,190977763952,In > Out
Feb 2020,213,77,85018,23859827362,249269871992,273129699354,7238,22953,281,225410044630,In > Out
Feb 2020,213,78,84228,29626030895,265581005958,295207036853,7321,21827,349,235954975063,In > Out
Feb 2020,213,79,97379,24445294104,315919401932,340364696036,8074,24399,266,291474107828,In > Out
Feb 2020,213,8,96966,32314299377,357678940661,389993240038,7482,22328,379,325364641284,In > Out
Feb 2020,213,80,122144,36354595671,276830624110,313185219781,7122,23567,165,240476028439,In > Out
Feb 2020,213,81,86268,31067882386,329677805745,360745688131,7295,22424,404,298609923359,In > Out
Feb 2020,213,82,94714,28833163066,294464964753,323298127819,8011,23177,324,265631801687,In > Out
Feb 2020,213,83,99257,28442128140,329422774816,357864902956,8371,23513,1126,300980646676,In > Out
Feb 2020,213,84,99671,42282709264,337699642411,379982351675,7748,23024,298,295416933147,In > Out
Feb 2020,213,85,96359,30645966521,286889250379,317535216900,7915,25459,288,256243283858,In > Out
Feb 2020,213,86,107581,37285879501,352265938210,389551817711,8506,22925,438,314980058709,In > Out
Feb 2020,213,87,94067,38628291805,361092438892,399720730697,8020,23817,611,322464147087,In > Out
Feb 2020,213,88,100230,29062413913,340860329696,369922743609,7793,23758,172,311797915783,In > Out
Feb 2020,213,89,93175,51027306257,313038233662,364065539919,7461,22631,245,262010927405,In > Out
Feb 2020,213,9,84110,25670504287,333138810902,358809315189,7187,22141,268,307468306615,In > Out
Feb 2020,213,90,94485,26045823522,402867728274,428913551796,7973,22949,361,376821904752,In > Out
Feb 2020,213,91,86396,24273601712,266747742636,291021344348,7596,22263,381,242474140924,In > Out
Feb 2020,213,92,103677,40375938480,339094597377,379470535857,8388,23731,340,298718658897,In > Out
Feb 2020,213,93,101681,36239629052,397389019868,433628648920,8377,24434,236,361149390816,In > Out
Feb 2020,213,94,91726,27484302566,311233125773,338717428339,7905,22563,438,283748823207,In > Out
Feb 2020,213,95,110561,30732475229,285431126822,316163602051,7965,22607,605,254698651593,In > Out
Feb 2020,213,96,123805,36893758322,360927140680,397820899002,8001,23364,395,324033382358,In > Out
Feb 2020,213,97,109727,28267717874,440428176321,468695894195,7710,25973,234,412160458447,In > Out
Feb 2020,213,98,92042,30166615049,313108129988,343274745037,7544,22081,360,282941514939,In > Out
Feb 2020,213,99,92320,49807156193,351266583688,401073739881,7856,23264,408,301459427495,In > Out
Feb 2020,214,105,2,72064,3627213,3699277,1,2,1,3555149,In > Out
Feb 2020,214,18,67,15150487,53848730,68999217,29,67,2,38698243,In > Out
Feb 2020,214,29,184,6699127,319790658,326489785,23,183,2,313091531,In > Out
Feb 2020,214,57,67,783571,45259769,46043340,15,67,2,44476198,In > Out
Feb 2020,214,74,213,22837877,147134799,169972676,87,213,3,124296922,In > Out
Feb 2020,214,81,2008,87742460,1390903442,1478645902,296,1926,1,1303160982,In > Out
Feb 2020,215,102,581,100812986,1408164424,1508977410,150,575,3,1307351438,In > Out
Feb 2020,215,108,11,177390,10554232,10731622,4,11,2,10376842,In > Out
Feb 2020,215,113,5355,7402332835,348139302,7750472137,1196,103,4720,7054193533,Out > In
Feb 2020,215,114,703,100951790,724557597,825509387,179,695,3,623605807,In > Out
Feb 2020,215,115,205,7478991,370900898,378379889,29,203,2,363421907,In > Out
Feb 2020,215,117,4,65218,3491433,3556651,2,4,1,3426215,In > Out
Feb 2020,215,119,76,2118523,67886575,70005098,36,76,1,65768052,In > Out
Feb 2020,215,124,139,4261708,114809747,119071455,59,136,2,110548039,In > Out
Feb 2020,215,141,2,360756,390468,751224,2,2,1,29712,In > Out
Feb 2020,215,142,116,5489094,155987115,161476209,53,116,2,150498021,In > Out
Feb 2020,215,145,1,229922,19113,249035,1,1,1,210809,Out > In
Feb 2020,215,148,131,13292277,77821109,91113386,69,131,2,64528832,In > Out
Feb 2020,215,149,333,16125584,777484481,793610065,41,332,2,761358897,In > Out
Feb 2020,215,150,12,351938,5557621,5909559,8,12,2,5205683,In > Out
Feb 2020,215,157,23,3032047,43860640,46892687,14,23,3,40828593,In > Out
Feb 2020,215,16,957,142936368,407957245,550893613,118,928,2,265020877,In > Out
Feb 2020,215,162,1032,302584707,322937523,625522230,92,1005,1,20352816,In > Out
Feb 2020,215,163,1,54508,3755408,3809916,1,1,1,3700900,In > Out
Feb 2020,215,175,6,81462,1280402,1361864,6,6,2,1198940,In > Out
Feb 2020,215,178,986,34859095,1824493301,1859352396,278,965,7,1789634206,In > Out
Feb 2020,215,181,137,4096851,218360263,222457114,23,137,2,214263412,In > Out
Feb 2020,215,190,130,13708819,25347374,39056193,32,129,2,11638555,In > Out
Feb 2020,215,192,33,2224937,72929921,75154858,14,33,2,70704984,In > Out
Feb 2020,215,194,6,98521,5471818,5570339,3,6,1,5373297,In > Out
Feb 2020,215,197,105,4819638,228259656,233079294,36,105,2,223440018,In > Out
Feb 2020,215,201,86,2183910,129912728,132096638,20,86,2,127728818,In > Out
Feb 2020,215,202,55,2230336,46361840,48592176,29,55,2,44131504,In > Out
Feb 2020,215,207,10,2044194,73740082,75784276,3,10,2,71695888,In > Out
Feb 2020,215,208,9,99714,5462748,5562462,7,9,2,5363034,In > Out
Feb 2020,215,209,274,33742374,464905633,498648007,109,272,2,431163259,In > Out
Feb 2020,215,213,780,31402281,922993218,954395499,167,762,3,891590937,In > Out
Feb 2020,215,215,1700,81465714,2275338808,2356804522,424,1596,5,2193873094,In > Out
Feb 2020,215,218,106,6811238,164125033,170936271,44,106,2,157313795,In > Out
Feb 2020,215,220,275,26975531,2841720884,2868696415,50,275,2,2814745353,In > Out
Feb 2020,215,221,703,31427073,429014621,460441694,141,698,2,397587548,In > Out
Feb 2020,215,26,119,4728295,271281738,276010033,22,119,2,266553443,In > Out
Feb 2020,215,30,15,956699,45322317,46279016,6,15,2,44365618,In > Out
Feb 2020,215,38,7,186248,8666808,8853056,4,7,1,8480560,In > Out
Feb 2020,215,39,96,3681029,130085896,133766925,23,96,2,126404867,In > Out
Feb 2020,215,40,449,52341871,1938829538,1991171409,149,444,2,1886487667,In > Out
Feb 2020,215,41,1756,206974644,820104872,1027079516,176,1660,2,613130228,In > Out
Feb 2020,215,53,294,27084124,101982893,129067017,73,292,2,74898769,In > Out
Feb 2020,215,55,134,8487230,960007514,968494744,31,134,2,951520284,In > Out
Feb 2020,215,56,75,1523474,28373687,29897161,55,75,3,26850213,In > Out
Feb 2020,215,61,274,19941343,188743996,208685339,71,274,2,168802653,In > Out
Feb 2020,215,62,46,2471178,125262285,127733463,16,46,2,122791107,In > Out
Feb 2020,215,67,58,1385252,50060326,51445578,21,58,2,48675074,In > Out
Feb 2020,215,74,2,204378,14243089,14447467,2,2,1,14038711,In > Out
Feb 2020,215,75,90,2200717,103971920,106172637,18,90,2,101771203,In > Out
Feb 2020,215,76,1,23109,864429,887538,1,1,1,841320,In > Out
Feb 2020,215,79,190,13245285,389718840,402964125,66,188,2,376473555,In > Out
Feb 2020,215,85,135,3393189,201817419,205210608,20,135,2,198424230,In > Out
Feb 2020,215,91,107,1965952,84662918,86628870,33,107,2,82696966,In > Out
Feb 2020,215,92,818,271892553,10214425522,10486318075,194,805,3,9942532969,In > Out
Feb 2020,215,94,125,4070367,188035944,192106311,21,125,2,183965577,In > Out
Feb 2020,215,96,12,447317,22872434,23319751,9,12,1,22425117,In > Out
Feb 2020,215,97,200,9576689,394645576,404222265,21,200,2,385068887,In > Out
Feb 2020,22,156,175,7604340,330854287,338458627,56,164,2,323249947,In > Out
Feb 2020,221,100,4,708416,52011544,52719960,4,4,1,51303128,In > Out
Feb 2020,221,102,286,44749720,348821442,393571162,131,286,3,304071722,In > Out
Feb 2020,221,105,12,321640,9784058,10105698,8,12,2,9462418,In > Out
Feb 2020,221,106,479,20364613,1163457739,1183822352,122,471,2,1143093126,In > Out
Feb 2020,221,116,6,314446,1371140,1685586,6,6,2,1056694,In > Out
Feb 2020,221,117,733,59622466,226614766,286237232,142,724,2,166992300,In > Out
Feb 2020,221,118,108,693345,15734713,16428058,8,108,2,15041368,In > Out
Feb 2020,221,119,139,1269463475,301871452,1571334927,66,136,5,967592023,Out > In
Feb 2020,221,125,86,7899368,246328740,254228108,59,86,3,238429372,In > Out
Feb 2020,221,127,675,148878683,10678349,159557032,21,675,2,138200334,Out > In
Feb 2020,221,132,422,33929757,286812680,320742437,108,411,2,252882923,In > Out
Feb 2020,221,144,3229,1577855809,1050489599,2628345408,172,2953,2,527366210,Out > In
Feb 2020,221,145,1672,1870319086,1924382664,3794701750,476,1574,2,54063578,In > Out
Feb 2020,221,146,5,875511,61349415,62224926,3,5,2,60473904,In > Out
Feb 2020,221,147,25,1101627,27697889,28799516,19,25,2,26596262,In > Out
Feb 2020,221,148,129,5922433,71311570,77234003,86,129,3,65389137,In > Out
Feb 2020,221,15,7,2994685,524864,3519549,7,1,6,2469821,Out > In
Feb 2020,221,150,71,1455665909,24385874,1480051783,15,60,5,1431280035,Out > In
Feb 2020,221,153,6868,7354231609,5166621170,12520852779,1525,1620,4641,2187610439,Out > In
Feb 2020,221,155,685,73788431,563240700,637029131,157,665,4,489452269,In > Out
Feb 2020,221,159,378,16327309,470834724,487162033,140,369,2,454507415,In > Out
Feb 2020,221,160,428,21091547,894264829,915356376,29,425,2,873173282,In > Out
Feb 2020,221,164,5,456885,12427167,12884052,5,5,1,11970282,In > Out
Feb 2020,221,168,312,138889925,3081635307,3220525232,133,307,4,2942745382,In > Out
Feb 2020,221,172,79,5033559,392225126,397258685,32,79,2,387191567,In > Out
Feb 2020,221,180,268,9223932,173152897,182376829,126,257,3,163928965,In > Out
Feb 2020,221,184,2846,214412383,3403177214,3617589597,559,2630,6,3188764831,In > Out
Feb 2020,221,186,27,1413231,29769733,31182964,19,27,1,28356502,In > Out
Feb 2020,221,189,535,58863665,1318004221,1376867886,190,527,2,1259140556,In > Out
Feb 2020,221,196,3,218690,3076118,3294808,3,3,1,2857428,In > Out
Feb 2020,221,198,169,109473574,7455249,116928823,113,1,161,102018325,Out > In
Feb 2020,221,20,61,3847941,119962823,123810764,44,61,2,116114882,In > Out
Feb 2020,221,200,301,68342091,190512828,258854919,113,295,2,122170737,In > Out
Feb 2020,221,201,3,62538,4609723,4672261,2,3,1,4547185,In > Out
Feb 2020,221,206,120,2688783,53071670,55760453,38,120,3,50382887,In > Out
Feb 2020,221,212,208,18980349,656604838,675585187,116,207,2,637624489,In > Out
Feb 2020,221,221,79,2257094,33844557,36101651,48,78,2,31587463,In > Out
Feb 2020,221,27,353,287218579,600577564,887796143,102,350,2,313358985,In > Out
Feb 2020,221,32,199,11362457,96990496,108352953,104,199,3,85628039,In > Out
Feb 2020,221,42,23,1264072,42273893,43537965,9,23,2,41009821,In > Out
Feb 2020,221,43,1350,100505713,4947434055,5047939768,341,1289,2,4846928342,In > Out
Feb 2020,221,44,222,3577502,283519052,287096554,58,222,2,279941550,In > Out
Feb 2020,221,46,196,68414109,2038056913,2106471022,50,195,2,1969642804,In > Out
Feb 2020,221,51,1,174682,15806,190488,1,1,1,158876,Out > In
Feb 2020,221,57,204,7993774,305091171,313084945,83,203,2,297097397,In > Out
Feb 2020,221,59,340,28572606,198614340,227186946,105,335,2,170041734,In > Out
Feb 2020,221,61,126,3622360,129585235,133207595,59,125,2,125962875,In > Out
Feb 2020,221,62,3,2992139,471646,3463785,3,1,2,2520493,Out > In
Feb 2020,221,66,2,7008,552103,559111,2,2,2,545095,In > Out
Feb 2020,221,73,53,3879979,91282258,95162237,21,53,2,87402279,In > Out
Feb 2020,221,77,2,47866,1024722,1072588,1,2,1,976856,In > Out
Feb 2020,221,78,232,13056429,80636253,93692682,114,225,2,67579824,In > Out
Feb 2020,221,80,1083,249820760,227837601,477658361,66,1049,2,21983159,Out > In
Feb 2020,221,82,1,53906,1987942,2041848,1,1,1,1934036,In > Out
Feb 2020,221,83,546,35721690,475587723,511309413,181,538,2,439866033,In > Out
Feb 2020,221,94,17,241370,5922878,6164248,12,17,2,5681508,In > Out
Feb 2020,222,196,7,5725272,317134626,322859898,6,6,2,311409354,In > Out
Feb 2020,224,10,7,365443,15260503,15625946,6,7,2,14895060,In > Out
Feb 2020,224,107,469,18743135,632727337,651470472,118,469,2,613984202,In > Out
Feb 2020,224,126,19,342851,22706738,23049589,9,19,2,22363887,In > Out
Feb 2020,224,137,635,1830759028,831303019,2662062047,123,635,2,999456009,Out > In
Feb 2020,224,145,1807,72232589,680635585,752868174,24,1698,2,608402996,In > Out
Feb 2020,224,170,285,32555114,117908599,150463713,26,285,3,85353485,In > Out
Feb 2020,224,182,32,407259,27633893,28041152,10,32,2,27226634,In > Out
Feb 2020,224,201,570,42755433,804611941,847367374,91,565,3,761856508,In > Out
Feb 2020,224,203,31,344727,18609973,18954700,7,31,2,18265246,In > Out
Feb 2020,224,221,765,156198674,1073777452,1229976126,200,742,3,917578778,In > Out
Feb 2020,224,223,138,63110616,3170116842,3233227458,37,138,2,3107006226,In > Out
Feb 2020,224,5,489,125343680,4047246450,4172590130,168,476,2,3921902770,In > Out
Feb 2020,224,87,2,12168,904640,916808,2,2,1,892472,In > Out
Feb 2020,224,92,265,35059057,1544345925,1579404982,71,264,2,1509286868,In > Out
Feb 2020,224,97,1,5768,184420,190188,1,1,1,178652,In > Out
Feb 2020,225,103,78,13377786,872074774,885452560,29,78,2,858696988,In > Out
Feb 2020,225,105,1,8016,302272,310288,1,1,1,294256,In > Out
Feb 2020,225,109,71,22808282,210936887,233745169,45,71,2,188128605,In > Out
Feb 2020,225,111,1016,194823784,1026722953,1221546737,193,1014,5,831899169,In > Out
Feb 2020,225,115,167,21981649,64214410,86196059,7,167,2,42232761,In > Out
Feb 2020,225,117,27,1059700,47913453,48973153,18,27,2,46853753,In > Out
Feb 2020,225,120,113,99584265,4949656,104533921,66,1,99,94634609,Out > In
Feb 2020,225,122,478,60126678,2840179366,2900306044,179,476,2,2780052688,In > Out
Feb 2020,225,124,123,6342406,129232712,135575118,53,123,1,122890306,In > Out
Feb 2020,225,126,162,6819488,328028597,334848085,23,162,2,321209109,In > Out
Feb 2020,225,127,1271,156488515,1042117699,1198606214,323,1220,3,885629184,In > Out
Feb 2020,225,129,651,67017074,1445712826,1512729900,190,632,2,1378695752,In > Out
Feb 2020,225,130,5,20552,828921,849473,1,5,1,808369,In > Out
Feb 2020,225,133,1,9851,961775,971626,1,1,1,951924,In > Out
Feb 2020,225,134,56,17830631,355001179,372831810,12,56,3,337170548,In > Out
Feb 2020,225,138,380,19856542,349703547,369560089,104,373,3,329847005,In > Out
Feb 2020,225,142,1,20513,90142,110655,1,1,1,69629,In > Out
Feb 2020,225,144,136,7874863,318825655,326700518,37,136,2,310950792,In > Out
Feb 2020,225,145,315,20621717,544064415,564686132,159,311,2,523442698,In > Out
Feb 2020,225,147,285,49381493,160636210,210017703,136,284,2,111254717,In > Out
Feb 2020,225,149,2533,131468970,2672313677,2803782647,286,2352,7,2540844707,In > Out
Feb 2020,225,150,5,17856,725997,743853,1,5,1,708141,In > Out
Feb 2020,225,152,1422,47886467,2011297836,2059184303,358,1383,2,1963411369,In > Out
Feb 2020,225,160,64,3045792,36559116,39604908,31,64,2,33513324,In > Out
Feb 2020,225,163,1515,965198079,19456183594,20421381673,372,1457,6,18490985515,In > Out
Feb 2020,225,166,300,27121988,155576243,182698231,116,300,3,128454255,In > Out
Feb 2020,225,168,4523,947181166,976057806,1923238972,95,4174,2,28876640,In > Out
Feb 2020,225,175,21,426554,22434792,22861346,10,21,2,22008238,In > Out
Feb 2020,225,176,88,13583471,354256470,367839941,37,88,2,340672999,In > Out
Feb 2020,225,188,496,20639558,936033605,956673163,35,495,2,915394047,In > Out
Feb 2020,225,192,18,18834572,12657295,31491867,13,18,2,6177277,Out > In
Feb 2020,225,193,1,34872,371794,406666,1,1,1,336922,In > Out
Feb 2020,225,196,37,6107869,307441138,313549007,29,37,2,301333269,In > Out
Feb 2020,225,200,1,47299,69912,117211,1,1,1,22613,In > Out
Feb 2020,225,204,1497,464584781,762163773,1226748554,259,1483,4,297578992,In > Out
Feb 2020,225,206,542,29435342,767660136,797095478,139,533,4,738224794,In > Out
Feb 2020,225,209,4,183204,3730004,3913208,3,4,1,3546800,In > Out
Feb 2020,225,21,1,10226,324235,334461,1,1,1,314009,In > Out
Feb 2020,225,210,440,51435971,657369832,708805803,56,437,4,605933861,In > Out
Feb 2020,225,211,302,16242136,207952216,224194352,134,290,3,191710080,In > Out
Feb 2020,225,212,588,57033514,2235895374,2292928888,195,562,2,2178861860,In > Out
Feb 2020,225,214,1567,72905160,997426858,1070332018,488,1499,2,924521698,In > Out
Feb 2020,225,219,361,28673738,1080829063,1109502801,95,361,4,1052155325,In > Out
Feb 2020,225,221,111,2141766,77820439,79962205,60,111,2,75678673,In > Out
Feb 2020,225,222,450,2085675050,549810797,2635485847,159,425,4,1535864253,Out > In
Feb 2020,225,223,5595,6864502487,363382596,7227885083,1184,302,4743,6501119891,Out > In
Feb 2020,225,23,33,9452701,8748917,18201618,6,33,1,703784,Out > In
Feb 2020,225,232,440,22869168,1025792569,1048661737,66,435,2,1002923401,In > Out
Feb 2020,225,36,143,10683026,53472574,64155600,53,140,4,42789548,In > Out
Feb 2020,225,48,579,30629695,705643089,736272784,172,571,2,675013394,In > Out
Feb 2020,225,52,522,40480655,453547360,494028015,233,518,3,413066705,In > Out
Feb 2020,225,71,483,70171413,497753469,567924882,180,479,2,427582056,In > Out
Feb 2020,225,75,1554,134756225,2651481014,2786237239,395,1494,5,2516724789,In > Out
Feb 2020,225,8,952,113249770,1571192418,1684442188,280,937,7,1457942648,In > Out
Feb 2020,225,82,2054,519095110,405764574,924859684,148,1920,2,113330536,Out > In
Feb 2020,225,85,21,9620708,716516668,726137376,2,21,21,706895960,In > Out
Feb 2020,225,86,5,343774,747377,1091151,4,5,2,403603,In > Out
Feb 2020,225,9,9,722731,3808925,4531656,6,9,1,3086194,In > Out
Feb 2020,225,94,175,6108287,70370281,76478568,107,169,2,64261994,In > Out
Feb 2020,225,95,412,80625306,319226385,399851691,179,409,2,238601079,In > Out
Feb 2020,226,77,91,7453218,395877579,403330797,39,91,2,388424361,In > Out
Feb 2020,226,80,66,2539672,73300176,75839848,43,66,2,70760504,In > Out
Feb 2020,226,94,141,7852299,53639720,61492019,50,120,2,45787421,In > Out
Feb 2020,228,100,953,248524459,10790167456,11038691915,348,936,10,10541642997,In > Out
Feb 2020,228,103,762,102275401,3998444743,4100720144,215,755,3,3896169342,In > Out
Feb 2020,228,104,1149,333866279,14636611952,14970478231,324,1121,5,14302745673,In > Out
Feb 2020,228,105,256,22788820,950551163,973339983,88,254,5,927762343,In > Out
Feb 2020,228,107,468,316591015,1533587875,1850178890,95,466,4,1216996860,In > Out
Feb 2020,228,11,1257,86427019,1806140588,1892567607,264,1232,5,1719713569,In > Out
Feb 2020,228,110,356,137605919,772276656,909882575,146,353,4,634670737,In > Out
Feb 2020,228,111,502,87309342,519083155,606392497,174,496,5,431773813,In > Out
Feb 2020,228,113,912,662396656,49578028105,50240424761,199,909,8,48915631449,In > Out
Feb 2020,228,114,485,72235759,5079285144,5151520903,202,480,7,5007049385,In > Out
Feb 2020,228,116,4574,815499316,28249003215,29064502531,861,4146,45,27433503899,In > Out
Feb 2020,228,117,325,61917206,1066983168,1128900374,148,319,3,1005065962,In > Out
Feb 2020,228,119,408,113882495,1218259547,1332142042,146,406,7,1104377052,In > Out
Feb 2020,228,12,1138,455432494,13491275132,13946707626,312,1102,6,13035842638,In > Out
Feb 2020,228,123,1106,269610365,12243826107,12513436472,249,1083,14,11974215742,In > Out
Feb 2020,228,124,773,902650514,2417869131,3320519645,195,755,4,1515218617,In > Out
Feb 2020,228,127,815,102399600,2523726216,2626125816,213,802,4,2421326616,In > Out
Feb 2020,228,128,490,156074844,8745353254,8901428098,179,483,5,8589278410,In > Out
Feb 2020,228,131,788,163844333,5159120166,5322964499,236,783,7,4995275833,In > Out
Feb 2020,228,132,679,81840923,3751273359,3833114282,189,666,7,3669432436,In > Out
Feb 2020,228,134,1343,276349327,3507869573,3784218900,469,1305,13,3231520246,In > Out
Feb 2020,228,135,523,105053140,10179058253,10284111393,222,521,3,10074005113,In > Out
Feb 2020,228,138,513,65769884,2468370271,2534140155,168,507,8,2402600387,In > Out
Feb 2020,228,14,1581,265322620,6895271542,7160594162,386,1542,3,6629948922,In > Out
Feb 2020,228,140,129,11169680,118263184,129432864,69,129,3,107093504,In > Out
Feb 2020,228,141,564,78732098,2088867092,2167599190,177,558,4,2010134994,In > Out
Feb 2020,228,142,626,429208906,7685970760,8115179666,202,617,5,7256761854,In > Out
Feb 2020,228,145,478,824222122,865321111,1689543233,122,464,8,41098989,In > Out
Feb 2020,228,146,1532,711704291,8446008265,9157712556,270,1475,6,7734303974,In > Out
Feb 2020,228,149,915,1348686014,3218733516,4567419530,264,899,6,1870047502,In > Out
Feb 2020,228,15,356,39052249,850214761,889267010,121,347,4,811162512,In > Out
Feb 2020,228,150,442,207823922,894616036,1102439958,135,435,3,686792114,In > Out
Feb 2020,228,151,756,195568315,6034143697,6229712012,234,729,9,5838575382,In > Out
Feb 2020,228,152,323,37510205,1015407992,1052918197,150,319,2,977897787,In > Out
Feb 2020,228,153,1222,1440431203,4519059063,5959490266,173,1205,5,3078627860,In > Out
Feb 2020,228,154,649,305843787,3236142336,3541986123,196,635,4,2930298549,In > Out
Feb 2020,228,155,732,141711137,5315435137,5457146274,232,723,5,5173724000,In > Out
Feb 2020,228,159,161,9619385,228639927,238259312,60,160,2,219020542,In > Out
Feb 2020,228,16,938,536905295,2786258378,3323163673,227,904,4,2249353083,In > Out
Feb 2020,228,160,814,140886565,3980884162,4121770727,259,806,8,3839997597,In > Out
Feb 2020,228,161,401,45040973,1264530178,1309571151,131,399,5,1219489205,In > Out
Feb 2020,228,164,531,112702186,1356844459,1469546645,158,526,4,1244142273,In > Out
Feb 2020,228,165,297,21208944,693676759,714885703,124,295,3,672467815,In > Out
Feb 2020,228,168,940,293704708,4892744841,5186449549,379,912,10,4599040133,In > Out
Feb 2020,228,169,1236,790212186,11742822334,12533034520,342,1212,8,10952610148,In > Out
Feb 2020,228,171,2529,392720186,15310511991,15703232177,341,2326,7,14917791805,In > Out
Feb 2020,228,175,311,46645061,4737165314,4783810375,120,311,3,4690520253,In > Out
Feb 2020,228,178,325,171502939,2106669779,2278172718,136,320,6,1935166840,In > Out
Feb 2020,228,18,1355,502439785,18459476903,18961916688,339,1293,4,17957037118,In > Out
Feb 2020,228,180,335,133027321,7823824542,7956851863,128,335,6,7690797221,In > Out
Feb 2020,228,181,1723,373794483,25243820710,25617615193,382,1676,5,24870026227,In > Out
Feb 2020,228,183,1456,600861409,5699072417,6299933826,191,1422,5,5098211008,In > Out
Feb 2020,228,184,1083,2241251442,10020776025,12262027467,277,1032,15,7779524583,In > Out
Feb 2020,228,186,384,29968194,895869716,925837910,90,383,4,865901522,In > Out
Feb 2020,228,187,993,1355474337,6151939408,7507413745,257,950,7,4796465071,In > Out
Feb 2020,228,191,360,138764097,892753508,1031517605,163,356,5,753989411,In > Out
Feb 2020,228,193,547,49462516,1852580252,1902042768,180,540,5,1803117736,In > Out
Feb 2020,228,194,874,224147205,7735637398,7959784603,252,860,5,7511490193,In > Out
Feb 2020,228,195,1591,1132598749,16108308406,17240907155,312,1523,5,14975709657,In > Out
Feb 2020,228,196,345,32298178,591853235,624151413,124,343,3,559555057,In > Out
Feb 2020,228,198,873,244202046,8734675929,8978877975,239,848,6,8490473883,In > Out
Feb 2020,228,199,295,133951481,473002052,606953533,110,288,13,339050571,In > Out
Feb 2020,228,200,112,8099280,146303982,154403262,67,112,2,138204702,In > Out
Feb 2020,228,201,1922,377644956,24162503288,24540148244,530,1872,13,23784858332,In > Out
Feb 2020,228,202,370,67285536,2074379285,2141664821,172,370,7,2007093749,In > Out
Feb 2020,228,203,875,188918181,4141718610,4330636791,301,859,4,3952800429,In > Out
Feb 2020,228,204,507,147962047,6905324041,7053286088,159,501,6,6757361994,In > Out
Feb 2020,228,206,1034,79956489,1969845929,2049802418,256,1008,6,1889889440,In > Out
Feb 2020,228,208,431,48617885,778596402,827214287,106,424,4,729978517,In > Out
Feb 2020,228,209,916,80180060,3264782822,3344962882,268,905,11,3184602762,In > Out
Feb 2020,228,21,399,43474754,1147708534,1191183288,174,395,7,1104233780,In > Out
Feb 2020,228,210,766,142323243,3948004054,4090327297,258,762,4,3805680811,In > Out
Feb 2020,228,211,612,94433702,2841342958,2935776660,142,608,3,2746909256,In > Out
Feb 2020,228,212,479,222830523,5054848005,5277678528,189,478,8,4832017482,In > Out
Feb 2020,228,214,987,620972747,25133236793,25754209540,271,951,22,24512264046,In > Out
Feb 2020,228,215,843,170456861,4924570237,5095027098,203,795,7,4754113376,In > Out
Feb 2020,228,216,563,59406703,2020274459,2079681162,199,557,3,1960867756,In > Out
Feb 2020,228,217,966,89184834,1846138003,1935322837,211,954,7,1756953169,In > Out
Feb 2020,228,218,1276,217124618,3807656527,4024781145,252,1244,5,3590531909,In > Out
Feb 2020,228,221,505,51461002,1844592429,1896053431,196,499,3,1793131427,In > Out
Feb 2020,228,23,315,44413884,1077913354,1122327238,123,310,2,1033499470,In > Out
Feb 2020,228,24,699,598257765,12390400360,12988658125,222,690,6,11792142595,In > Out
Feb 2020,228,27,625,210066411,11721697688,11931764099,223,618,11,11511631277,In > Out
Feb 2020,228,30,911,186466103,3187807601,3374273704,259,885,5,3001341498,In > Out
Feb 2020,228,31,508,34761884,1783401541,1818163425,178,504,5,1748639657,In > Out
Feb 2020,228,32,760,752830731,20961419257,21714249988,233,714,18,20208588526,In > Out
Feb 2020,228,33,1086,430744348,7851531617,8282275965,312,1066,8,7420787269,In > Out
Feb 2020,228,35,897,184960533,2938785167,3123745700,234,874,11,2753824634,In > Out
Feb 2020,228,36,1130,234511920,2878989968,3113501888,245,1106,8,2644478048,In > Out
Feb 2020,228,37,329,223947259,1578690753,1802638012,98,326,4,1354743494,In > Out
Feb 2020,228,38,804,1098172154,17442520218,18540692372,408,633,38,16344348064,In > Out
Feb 2020,228,39,753,407032799,793081970,1200114769,125,745,8,386049171,In > Out
Feb 2020,228,4,599,81106613,2026820917,2107927530,200,582,14,1945714304,In > Out
Feb 2020,228,41,397,123447207,2543901778,2667348985,142,393,7,2420454571,In > Out
Feb 2020,228,42,227,76720260,711961202,788681462,81,227,5,635240942,In > Out
Feb 2020,228,43,1096,122441784,1795617821,1918059605,264,1069,6,1673176037,In > Out
Feb 2020,228,44,915,330393573,3579925198,3910318771,214,901,6,3249531625,In > Out
Feb 2020,228,45,340,104218345,921242491,1025460836,107,330,5,817024146,In > Out
Feb 2020,228,46,1064,148146201,2453821522,2601967723,209,1060,4,2305675321,In > Out
Feb 2020,228,47,495,189641580,2233600989,2423242569,173,479,14,2043959409,In > Out
Feb 2020,228,48,751,57306657,1514973372,1572280029,215,725,7,1457666715,In > Out
Feb 2020,228,49,336,184455264,2143747240,2328202504,162,331,13,1959291976,In > Out
Feb 2020,228,5,1092,2771757847,5187154432,7958912279,188,1069,12,2415396585,In > Out
Feb 2020,228,51,568,96728588,746624092,843352680,187,554,12,649895504,In > Out
Feb 2020,228,52,249,58624961,991804006,1050428967,108,246,4,933179045,In > Out
Feb 2020,228,53,253,19307495,320284304,339591799,77,250,4,300976809,In > Out
Feb 2020,228,55,733,136297998,3414599993,3550897991,223,729,6,3278301995,In > Out
Feb 2020,228,57,1475,790101507,9440708388,10230809895,374,1444,5,8650606881,In > Out
Feb 2020,228,58,652,163234259,992238399,1155472658,229,643,5,829004140,In > Out
Feb 2020,228,61,1001,263361918,3520609231,3783971149,289,980,10,3257247313,In > Out
Feb 2020,228,62,1056,367843012,3434486352,3802329364,238,1003,11,3066643340,In > Out
Feb 2020,228,63,870,146084583,9944189708,10090274291,221,847,7,9798105125,In > Out
Feb 2020,228,65,556,244426455,4341497783,4585924238,129,550,5,4097071328,In > Out
Feb 2020,228,67,713,3335241224,5231637108,8566878332,277,700,24,1896395884,In > Out
Feb 2020,228,68,887,214105194,12015058302,12229163496,229,867,5,11800953108,In > Out
Feb 2020,228,70,1050,479254573,11981355710,12460610283,245,1030,7,11502101137,In > Out
Feb 2020,228,71,862,1273716160,6983755706,8257471866,285,846,5,5710039546,In > Out
Feb 2020,228,72,949,589926999,9927091361,10517018360,283,916,11,9337164362,In > Out
Feb 2020,228,74,404,86080177,4979467385,5065547562,169,398,4,4893387208,In > Out
Feb 2020,228,79,965,257355301,13412346325,13669701626,290,940,8,13154991024,In > Out
Feb 2020,228,8,514,131501344,612497384,743998728,227,510,11,480996040,In > Out
Feb 2020,228,81,943,130161556,2548395789,2678557345,321,927,7,2418234233,In > Out
Feb 2020,228,82,872,176865771,10501027446,10677893217,240,855,5,10324161675,In > Out
Feb 2020,228,85,1496,254407450,5273902973,5528310423,365,1467,9,5019495523,In > Out
Feb 2020,228,9,1561,273522811,4212340954,4485863765,285,1504,7,3938818143,In > Out
Feb 2020,228,92,304,412117429,1394844213,1806961642,163,250,28,982726784,In > Out
Feb 2020,228,94,935,127868258,4059035000,4186903258,252,919,8,3931166742,In > Out
Feb 2020,228,95,874,212511512,15836954333,16049465845,223,863,6,15624442821,In > Out
Feb 2020,228,97,1273,240414460,8794486690,9034901150,377,1239,14,8554072230,In > Out
Feb 2020,228,98,1359,485647010,5421249692,5906896702,354,1341,11,4935602682,In > Out
Feb 2020,229,103,515,38486090,1480472411,1518958501,103,512,3,1441986321,In > Out
Feb 2020,229,104,881,361025277,4221728790,4582754067,257,866,9,3860703513,In > Out
Feb 2020,229,107,1805,319979445,9885373678,10205353123,321,1742,12,9565394233,In > Out
Feb 2020,229,108,594,113523030,2606357103,2719880133,114,585,5,2492834073,In > Out
Feb 2020,229,109,278,30825997,509036023,539862020,128,276,5,478210026,In > Out
Feb 2020,229,11,890,88178481,3768254022,3856432503,201,877,4,3680075541,In > Out
Feb 2020,229,110,588,528263228,2032129431,2560392659,174,573,6,1503866203,In > Out
Feb 2020,229,111,819,90646346,4870549486,4961195832,197,810,4,4779903140,In > Out
Feb 2020,229,115,1691,201942137,7427108805,7629050942,525,1585,38,7225166668,In > Out
Feb 2020,229,118,720,363976857,1812271762,2176248619,151,715,5,1448294905,In > Out
Feb 2020,229,119,751,61694152,1957654961,2019349113,212,737,4,1895960809,In > Out
Feb 2020,229,120,486,58329627,1280596363,1338925990,180,472,7,1222266736,In > Out
Feb 2020,229,122,742,264689536,5293415818,5558105354,274,733,14,5028726282,In > Out
Feb 2020,229,123,852,1235428022,4738088728,5973516750,213,836,29,3502660706,In > Out
Feb 2020,229,124,687,168214575,7970476713,8138691288,226,676,7,7802262138,In > Out
Feb 2020,229,125,1408,839387127,8391069409,9230456536,317,1365,10,7551682282,In > Out
Feb 2020,229,126,1670,299610365,3770483534,4070093899,172,1643,4,3470873169,In > Out
Feb 2020,229,127,842,119749926,5655407205,5775157131,251,827,4,5535657279,In > Out
Feb 2020,229,128,404,61767715,925141340,986909055,166,393,18,863373625,In > Out
Feb 2020,229,129,331,76536976,3994550121,4071087097,118,330,6,3918013145,In > Out
Feb 2020,229,130,427,31485752,754423627,785909379,179,423,5,722937875,In > Out
Feb 2020,229,132,868,489290962,3830012410,4319303372,270,857,10,3340721448,In > Out
Feb 2020,229,133,276,44507717,1288633421,1333141138,93,274,3,1244125704,In > Out
Feb 2020,229,134,908,118955149,4038369447,4157324596,245,861,23,3919414298,In > Out
Feb 2020,229,135,371,198047864,13220855727,13418903591,131,361,4,13022807863,In > Out
Feb 2020,229,136,215,45541649,2522239954,2567781603,105,214,3,2476698305,In > Out
Feb 2020,229,137,1361,532166579,5059979328,5592145907,282,1273,8,4527812749,In > Out
Feb 2020,229,138,439,454809478,963088905,1417898383,153,429,11,508279427,In > Out
Feb 2020,229,139,663,655612967,3050610655,3706223622,245,648,9,2394997688,In > Out
Feb 2020,229,14,909,121998161,4483874462,4605872623,295,901,4,4361876301,In > Out
Feb 2020,229,142,524,68799708,928044652,996844360,209,521,5,859244944,In > Out
Feb 2020,229,143,330,50515043,1406787544,1457302587,135,330,5,1356272501,In > Out
Feb 2020,229,144,613,115651202,3734877373,3850528575,197,596,4,3619226171,In > Out
Feb 2020,229,145,698,551760249,16586393236,17138153485,301,689,6,16034632987,In > Out
Feb 2020,229,146,506,106578714,5683143407,5789722121,191,502,4,5576564693,In > Out
Feb 2020,229,147,512,132340607,2875929142,3008269749,154,510,2,2743588535,In > Out
Feb 2020,229,148,221,17960290,359342987,377303277,79,221,3,341382697,In > Out
Feb 2020,229,149,562,68406819,2544312038,2612718857,151,555,5,2475905219,In > Out
Feb 2020,229,15,1129,189027951,7915202716,8104230667,350,1070,11,7726174765,In > Out
Feb 2020,229,150,1126,112850865,5526879968,5639730833,283,1098,5,5414029103,In > Out
Feb 2020,229,151,763,777950496,4265178977,5043129473,179,754,7,3487228481,In > Out
Feb 2020,229,153,449,153812681,2231291448,2385104129,129,441,7,2077478767,In > Out
Feb 2020,229,154,442,94379758,1585107244,1679487002,190,439,5,1490727486,In > Out
Feb 2020,229,155,502,57333825,2000452034,2057785859,187,497,4,1943118209,In > Out
Feb 2020,229,156,242,26563324,2282347569,2308910893,123,242,7,2255784245,In > Out
Feb 2020,229,157,583,192921474,22453973602,22646895076,224,569,4,22261052128,In > Out
Feb 2020,229,158,478,44968698,1521910333,1566879031,128,472,2,1476941635,In > Out
Feb 2020,229,159,690,226814989,15671332510,15898147499,250,678,6,15444517521,In > Out
Feb 2020,229,160,1082,89125402,1867828543,1956953945,260,1059,8,1778703141,In > Out
Feb 2020,229,168,1605,770632315,5026721038,5797353353,587,1545,8,4256088723,In > Out
Feb 2020,229,170,597,188983991,1847483995,2036467986,202,587,9,1658500004,In > Out
Feb 2020,229,171,692,59246740,1461076021,1520322761,224,677,7,1401829281,In > Out
Feb 2020,229,174,2796,325033206,8002894137,8327927343,420,2634,12,7677860931,In > Out
Feb 2020,229,175,701,205065245,11986627724,12191692969,225,694,6,11781562479,In > Out
Feb 2020,229,177,707,202833635,3975120852,4177954487,168,694,16,3772287217,In > Out
Feb 2020,229,178,843,154707107,1948293502,2103000609,345,820,14,1793586395,In > Out
Feb 2020,229,18,761,456506827,5265073755,5721580582,271,749,9,4808566928,In > Out
Feb 2020,229,180,1549,238987059,4868253676,5107240735,340,1523,7,4629266617,In > Out
Feb 2020,229,181,1197,345370032,16560569018,16905939050,264,1189,20,16215198986,In > Out
Feb 2020,229,182,2553,337486498,4723698173,5061184671,407,2405,11,4386211675,In > Out
Feb 2020,229,184,481,49020862,828806407,877827269,162,475,3,779785545,In > Out
Feb 2020,229,186,684,309465724,2627606170,2937071894,341,668,14,2318140446,In > Out
Feb 2020,229,189,589,59313021,2047066290,2106379311,186,583,3,1987753269,In > Out
Feb 2020,229,190,3317,801393367,18500558201,19301951568,327,3273,21,17699164834,In > Out
Feb 2020,229,191,836,376843167,7176243521,7553086688,238,827,14,6799400354,In > Out
Feb 2020,229,192,1216,336202084,8963246848,9299448932,317,1162,5,8627044764,In > Out
Feb 2020,229,193,569,39854663,840276896,880131559,121,559,4,800422233,In > Out
Feb 2020,229,194,1426,435146236,8890748228,9325894464,252,1367,7,8455601992,In > Out
Feb 2020,229,195,1233,523161632,5159348380,5682510012,317,1226,7,4636186748,In > Out
Feb 2020,229,199,721,102397845,4631518313,4733916158,224,710,12,4529120468,In > Out
Feb 2020,229,20,683,179162958,3391197795,3570360753,203,672,11,3212034837,In > Out
Feb 2020,229,200,1031,77129444,1598464552,1675593996,254,1025,9,1521335108,In > Out
Feb 2020,229,203,450,107093158,4701072492,4808165650,173,447,7,4593979334,In > Out
Feb 2020,229,208,444,70882954,1887495900,1958378854,119,444,2,1816612946,In > Out
Feb 2020,229,209,446,564431999,1062136106,1626568105,171,444,4,497704107,In > Out
Feb 2020,229,210,1016,163759607,3405093011,3568852618,279,997,8,3241333404,In > Out
Feb 2020,229,211,584,115140502,1217175464,1332315966,229,577,8,1102034962,In > Out
Feb 2020,229,212,1139,148208077,4933664884,5081872961,295,1113,7,4785456807,In > Out
Feb 2020,229,213,468,538892608,723650793,1262543401,185,444,11,184758185,In > Out
Feb 2020,229,214,1263,964493343,21905133778,22869627121,381,1232,10,20940640435,In > Out
Feb 2020,229,215,836,253701158,43638511191,43892212349,253,827,11,43384810033,In > Out
Feb 2020,229,216,550,424897257,1852589763,2277487020,163,543,6,1427692506,In > Out
Feb 2020,229,217,1099,118895483,3448893277,3567788760,295,1065,27,3329997794,In > Out
Feb 2020,229,218,1320,181084924,4193612121,4374697045,254,1299,7,4012527197,In > Out
Feb 2020,229,219,369,2028610621,3753963131,5782573752,144,360,15,1725352510,In > Out
Feb 2020,229,221,1355,471196601,4129470795,4600667396,277,1322,8,3658274194,In > Out
Feb 2020,229,222,611,85650149,3384818653,3470468802,163,592,7,3299168504,In > Out
Feb 2020,229,223,286,144482264,1241874154,1386356418,105,285,4,1097391890,In > Out
Feb 2020,229,23,250,36893616,1224052735,1260946351,58,249,4,1187159119,In > Out
Feb 2020,229,26,573,169096619,7446032894,7615129513,152,570,4,7276936275,In > Out
Feb 2020,229,27,1101,619047203,3425103127,4044150330,192,1073,7,2806055924,In > Out
Feb 2020,229,30,331,204692396,862266263,1066958659,127,330,3,657573867,In > Out
Feb 2020,229,32,2578,357593879,5671669988,6029263867,211,2468,22,5314076109,In > Out
Feb 2020,229,35,1011,537954076,24560038496,25097992572,313,1004,8,24022084420,In > Out
Feb 2020,229,38,1635,453324301,18492184957,18945509258,381,1599,7,18038860656,In > Out
Feb 2020,229,4,1010,139551575,2895028749,3034580324,273,984,3,2755477174,In > Out
Feb 2020,229,42,326,40616217,1569464525,1610080742,149,324,4,1528848308,In > Out
Feb 2020,229,43,341,58620498,852462816,911083314,118,339,6,793842318,In > Out
Feb 2020,229,44,644,670490025,9305239025,9975729050,221,642,5,8634749000,In > Out
Feb 2020,229,45,797,275257136,2900435231,3175692367,224,765,6,2625178095,In > Out
Feb 2020,229,46,187,11542601,284239105,295781706,79,185,6,272696504,In > Out
Feb 2020,229,5,674,88383471,2359820710,2448204181,172,660,3,2271437239,In > Out
Feb 2020,229,52,1240,367191892,4465138239,4832330131,301,1208,12,4097946347,In > Out
Feb 2020,229,53,501,70433406,1929784516,2000217922,159,486,3,1859351110,In > Out
Feb 2020,229,54,622,206439505,1727177867,1933617372,176,620,5,1520738362,In > Out
Feb 2020,229,55,331,147449768,941531745,1088981513,114,330,43,794081977,In > Out
Feb 2020,229,58,919,444803630,7054470975,7499274605,294,892,15,6609667345,In > Out
Feb 2020,229,59,392,41845840,792885049,834730889,134,389,9,751039209,In > Out
Feb 2020,229,6,1253,1302226463,7826452007,9128678470,356,1228,10,6524225544,In > Out
Feb 2020,229,62,968,391376059,26672900508,27064276567,122,968,2,26281524449,In > Out
Feb 2020,229,63,360,31892185,698662640,730554825,124,353,6,666770455,In > Out
Feb 2020,229,64,1297,113006282,3444213240,3557219522,316,1248,6,3331206958,In > Out
Feb 2020,229,66,966,397599498,2898217617,3295817115,191,946,6,2500618119,In > Out
Feb 2020,229,67,827,156346136,2050907279,2207253415,240,812,6,1894561143,In > Out
Feb 2020,229,69,230,76034586,4903299156,4979333742,109,225,5,4827264570,In > Out
Feb 2020,229,7,1377,444477813,5945274478,6389752291,365,1347,10,5500796665,In > Out
Feb 2020,229,70,263,46177367,1961509309,2007686676,110,262,5,1915331942,In > Out
Feb 2020,229,71,591,69822442,3189975252,3259797694,174,588,6,3120152810,In > Out
Feb 2020,229,72,599,201198320,3632496830,3833695150,203,588,13,3431298510,In > Out
Feb 2020,229,73,853,193199824,2494750159,2687949983,240,844,3,2301550335,In > Out
Feb 2020,229,74,580,68047986,1049950240,1117998226,138,579,6,981902254,In > Out
Feb 2020,229,76,581,101185996,3781838883,3883024879,141,570,5,3680652887,In > Out
Feb 2020,229,77,273,70543181,2731610582,2802153763,121,273,7,2661067401,In > Out
Feb 2020,229,78,917,324604384,15478433013,15803037397,331,893,3,15153828629,In > Out
Feb 2020,229,79,587,71179378,2195504342,2266683720,149,585,5,2124324964,In > Out
Feb 2020,229,8,214,44497004,2164751996,2209249000,104,213,4,2120254992,In > Out
Feb 2020,229,80,1652,235148825,9513332636,9748481461,290,1565,8,9278183811,In > Out
Feb 2020,229,81,570,129096479,1742701728,1871798207,212,563,6,1613605249,In > Out
Feb 2020,229,83,336,21418892,614113435,635532327,106,327,5,592694543,In > Out
Feb 2020,229,89,879,132462575,4423739058,4556201633,285,868,9,4291276483,In > Out
Feb 2020,229,90,393,559370976,1070602153,1629973129,111,384,5,511231177,In > Out
Feb 2020,229,92,252,70673173,742245908,812919081,84,252,4,671572735,In > Out
Feb 2020,229,93,632,646061747,6228272317,6874334064,182,623,7,5582210570,In > Out
Feb 2020,229,94,989,136143010,4624796455,4760939465,150,969,7,4488653445,In > Out
Feb 2020,229,96,464,76405629,1904140369,1980545998,175,458,12,1827734740,In > Out
Feb 2020,229,99,813,119475387,4827404789,4946880176,246,785,9,4707929402,In > Out
Feb 2020,23,4,90,9124566,350698035,359822601,9,90,1,341573469,In > Out
Feb 2020,234,110,54,1539243,45436733,46975976,17,54,2,43897490,In > Out
Feb 2020,234,111,135,3323459,75682510,79005969,48,135,3,72359051,In > Out
Feb 2020,234,112,63,2418526,45719611,48138137,39,63,2,43301085,In > Out
Feb 2020,234,113,838,146388116,3351646589,3498034705,196,819,4,3205258473,In > Out
Feb 2020,234,114,310,23913901,352058402,375972303,121,308,2,328144501,In > Out
Feb 2020,234,116,84,22781829,341069599,363851428,50,51,15,318287770,In > Out
Feb 2020,234,120,94,8082800,169191286,177274086,30,94,2,161108486,In > Out
Feb 2020,234,122,1,5123,241612,246735,1,1,1,236489,In > Out
Feb 2020,234,123,48,2135613,137676682,139812295,9,48,2,135541069,In > Out
Feb 2020,234,126,196,6463984,89653544,96117528,97,195,2,83189560,In > Out
Feb 2020,234,129,1046,127957391,417532632,545490023,201,1020,2,289575241,In > Out
Feb 2020,234,130,226,12908811,415430893,428339704,43,224,2,402522082,In > Out
Feb 2020,234,131,10,444301,962997,1407298,5,10,1,518696,In > Out
Feb 2020,234,132,7,525264,8752155,9277419,6,7,2,8226891,In > Out
Feb 2020,234,134,182,9182292,190157238,199339530,61,181,2,180974946,In > Out
Feb 2020,234,135,527,24547301,201306668,225853969,104,514,2,176759367,In > Out
Feb 2020,234,137,751,167871024,271306300,439177324,169,734,2,103435276,In > Out
Feb 2020,234,139,127,8879550,74811718,83691268,59,126,2,65932168,In > Out
Feb 2020,234,144,109,5125600,110406845,115532445,39,109,2,105281245,In > Out
Feb 2020,234,151,1250,88873607,778975898,867849505,249,1196,2,690102291,In > Out
Feb 2020,234,18,280,11309536,229996398,241305934,73,278,2,218686862,In > Out
Feb 2020,234,199,122,22520931,101121114,123642045,63,120,3,78600183,In > Out
Feb 2020,234,200,476,668962211,39163362314,39832324525,95,460,4,38494400103,In > Out
Feb 2020,234,201,10,980776,1384103,2364879,1,10,1,403327,In > Out
Feb 2020,234,224,461,71230847,882891906,954122753,155,455,3,811661059,In > Out
Feb 2020,234,225,343,14659557,119534346,134193903,73,342,2,104874789,In > Out
Feb 2020,234,226,637,12911827,371833214,384745041,178,626,3,358921387,In > Out
Feb 2020,234,228,372,33965800,1087283563,1121249363,124,367,2,1053317763,In > Out
Feb 2020,234,23,127,18759100,783491436,802250536,16,127,12,764732336,In > Out
Feb 2020,234,230,28,11905100,728341460,740246560,10,28,2,716436360,In > Out
Feb 2020,234,231,1,4455,109889,114344,1,1,1,105434,In > Out
Feb 2020,234,234,183,4701745,109310864,114012609,80,183,2,104609119,In > Out
Feb 2020,234,237,1279,193035554,798645799,991681353,220,1211,3,605610245,In > Out
Feb 2020,234,238,1,10008,241244,251252,1,1,1,231236,In > Out
Feb 2020,234,239,352,36181409,392013067,428194476,33,347,2,355831658,In > Out
Feb 2020,234,241,241,15922201,102639809,118562010,80,240,2,86717608,In > Out
Feb 2020,234,29,315,14288664,295642189,309930853,42,313,6,281353525,In > Out
Feb 2020,234,40,2,116000,6207889,6323889,1,2,1,6091889,In > Out
Feb 2020,234,44,489,30230588,143989520,174220108,77,485,2,113758932,In > Out
Feb 2020,234,46,115,3826022,71366294,75192316,55,114,3,67540272,In > Out
Feb 2020,234,56,111,4677190,87017480,91694670,65,110,2,82340290,In > Out
Feb 2020,234,58,200,18031944,430080100,448112044,44,200,2,412048156,In > Out
Feb 2020,234,66,298,28195122,169959976,198155098,57,294,2,141764854,In > Out
Feb 2020,234,68,133,14710009,96181244,110891253,67,133,2,81471235,In > Out
Feb 2020,234,76,660,64101376,1129878820,1193980196,188,643,2,1065777444,In > Out
Feb 2020,234,78,8,5459014,301826673,307285687,5,8,2,296367659,In > Out
Feb 2020,234,79,188,7005186,227337157,234342343,58,187,3,220331971,In > Out
Feb 2020,234,81,412,30846338,214789853,245636191,145,409,2,183943515,In > Out
Feb 2020,234,83,233,64240239,1717959994,1782200233,121,230,2,1653719755,In > Out
Feb 2020,234,84,313,37294719,123861836,161156555,83,311,2,86567117,In > Out
Feb 2020,234,89,141,1243223,23995549,25238772,3,141,2,22752326,In > Out
Feb 2020,234,96,22,225934,10379487,10605421,9,21,2,10153553,In > Out
Feb 2020,234,99,1359,143813133,1685970206,1829783339,228,1296,5,1542157073,In > Out
Feb 2020,235,212,34,184115,11702983,11887098,2,34,1,11518868,In > Out
Feb 2020,235,223,429189,5415552244,228867091456,234282643700,811,28232,2,223451539212,In > Out
Feb 2020,235,44,1,1284,3085659,3086943,1,1,1,3084375,In > Out
Feb 2020,236,253,10893,4799266532,15371480462,20170746994,1935,8684,36,10572213930,In > Out
Feb 2020,239,161,31,3364805,148460363,151825168,17,31,2,145095558,In > Out
Feb 2020,239,162,243,28854616,375555451,404410067,88,238,2,346700835,In > Out
Feb 2020,239,163,306,13811029,367465013,381276042,110,292,2,353653984,In > Out
Feb 2020,239,164,172,17678731,646584782,664263513,79,169,2,628906051,In > Out
Feb 2020,239,165,121,9748614,340391105,350139719,63,118,2,330642491,In > Out
Feb 2020,239,166,60,4691533,199399686,204091219,20,60,2,194708153,In > Out
Feb 2020,239,167,86,5870998,270064358,275935356,29,86,2,264193360,In > Out
Feb 2020,239,168,148,9350093,235015887,244365980,68,148,2,225665794,In > Out
Feb 2020,239,171,43,3860515,141631295,145491810,16,43,2,137770780,In > Out
Feb 2020,239,172,33,4164748,208033564,212198312,11,33,2,203868816,In > Out
Feb 2020,239,173,26,1433445,32373624,33807069,20,26,2,30940179,In > Out
Feb 2020,239,174,76,6067350,285079597,291146947,20,76,2,279012247,In > Out
Feb 2020,239,175,10,567525,38335044,38902569,8,10,2,37767519,In > Out
Feb 2020,239,178,56,6600803,336133603,342734406,20,56,2,329532800,In > Out
Feb 2020,239,182,103,8851700,330569134,339420834,57,102,2,321717434,In > Out
Feb 2020,239,184,199,12155499,336033505,348189004,82,196,2,323878006,In > Out
Feb 2020,239,185,31,3522684,156847592,160370276,12,31,2,153324908,In > Out
Feb 2020,239,186,36,2155887,91722053,93877940,22,36,2,89566166,In > Out
Feb 2020,239,187,44,5140435,214698977,219839412,22,44,2,209558542,In > Out
Feb 2020,239,188,198,9066362,401325142,410391504,59,197,2,392258780,In > Out
Feb 2020,239,189,45,3005284,108871952,111877236,29,45,2,105866668,In > Out
Feb 2020,239,191,3,835034744,317644128,1152678872,2,3,3,517390616,Out > In
Feb 2020,239,198,26,1577429,27396693,28974122,15,26,2,25819264,In > Out
Feb 2020,239,199,43,3763428,186767414,190530842,17,43,2,183003986,In > Out
Feb 2020,239,201,31,1996337,62675070,64671407,12,31,2,60678733,In > Out
Feb 2020,239,220,29,1693990,99300400,100994390,12,29,2,97606410,In > Out
Feb 2020,241,136,85,6177753,532917300,539095053,7,85,1,526739547,In > Out
Feb 2020,241,181,85,4412005,159196180,163608185,21,85,2,154784175,In > Out
Feb 2020,241,182,264,15474965,632567350,648042315,121,263,2,617092385,In > Out
Feb 2020,241,183,14,1054487,91309954,92364441,10,14,2,90255467,In > Out
Feb 2020,241,196,1269,13430915,457408184,470839099,31,1235,2,443977269,In > Out
Feb 2020,241,199,462,50113195,363391124,413504319,140,452,2,313277929,In > Out
Feb 2020,241,219,26,2456351,17105319,19561670,11,26,3,14648968,In > Out
Feb 2020,241,220,384,45761571,661975885,707737456,176,372,2,616214314,In > Out
Feb 2020,241,223,46,2515536,129852009,132367545,10,46,1,127336473,In > Out
Feb 2020,241,224,126,8889774,177391195,186280969,60,126,2,168501421,In > Out
Feb 2020,241,225,191,33216087,114565997,147782084,74,191,2,81349910,In > Out
Feb 2020,241,228,618,58209726,362676050,420885776,127,605,2,304466324,In > Out
Feb 2020,241,229,542,110983669,229813625,340797294,151,531,2,118829956,In > Out
Feb 2020,241,230,1680,823299764,7735520352,8558820116,337,1639,6,6912220588,In > Out
Feb 2020,241,232,8,64053,2329507,2393560,7,8,1,2265454,In > Out
Feb 2020,241,233,104,4625040,182696812,187321852,44,103,2,178071772,In > Out
Feb 2020,241,234,218,11079989,126664436,137744425,118,217,3,115584447,In > Out
Feb 2020,241,235,4902,2166556291,6009423296,8175979587,181,4363,3,3842867005,In > Out
Feb 2020,241,6,15,620303,36413707,37034010,6,15,1,35793404,In > Out
Feb 2020,242,110,2,19527,203109,222636,1,2,1,183582,In > Out
Feb 2020,242,122,1,3072000,2741400,5813400,1,1,1,330600,Out > In
Feb 2020,242,140,81,6706268,230256887,236963155,30,81,2,223550619,In > Out
Feb 2020,242,230,5,50340088,26407080,76747168,2,4,4,23933008,Out > In
Feb 2020,242,40,4,89228543,219013425,308241968,2,4,4,129784882,In > Out
Feb 2020,242,41,120,1687612,17563130,19250742,1,119,1,15875518,In > Out
Feb 2020,246,106,156,6270538,169277413,175547951,67,156,2,163006875,In > Out
Feb 2020,246,129,70,1565561,64211367,65776928,24,70,2,62645806,In > Out
Feb 2020,246,132,123,6531915,182106592,188638507,53,123,2,175574677,In > Out
Feb 2020,246,138,309,17567647,259725329,277292976,113,307,2,242157682,In > Out
Feb 2020,246,140,122,6807556,181027011,187834567,22,122,2,174219455,In > Out
Feb 2020,246,141,11,1437153,6621934,8059087,6,11,2,5184781,In > Out
Feb 2020,246,142,920,35387111,703128597,738515708,162,910,2,667741486,In > Out
Feb 2020,246,143,259,6902752,196512304,203415056,71,259,2,189609552,In > Out
Feb 2020,246,155,100,5076333,137198357,142274690,31,100,2,132122024,In > Out
Feb 2020,246,160,396,29314418,686591680,715906098,178,395,2,657277262,In > Out
Feb 2020,246,161,4,316619,351686,668305,3,4,2,35067,In > Out
Feb 2020,246,166,407,45521757,770058709,815580466,177,404,2,724536952,In > Out
Feb 2020,246,177,439,23408184,626881261,650289445,134,432,2,603473077,In > Out
Feb 2020,246,180,555,40224315,1202207879,1242432194,192,540,3,1161983564,In > Out
Feb 2020,246,185,486,29744205,236261356,266005561,106,478,2,206517151,In > Out
Feb 2020,246,193,97,5496399,192200120,197696519,29,97,2,186703721,In > Out
Feb 2020,246,195,93,3066297,59804421,62870718,46,92,2,56738124,In > Out
Feb 2020,246,197,245,12776069,497648957,510425026,66,244,2,484872888,In > Out
Feb 2020,246,198,58,2158625,43360114,45518739,21,58,2,41201489,In > Out
Feb 2020,246,20,30,971869,11703435,12675304,12,30,2,10731566,In > Out
Feb 2020,246,201,311,6803149,236627802,243430951,22,309,2,229824653,In > Out
Feb 2020,246,206,351,14624286,423574068,438198354,116,344,2,408949782,In > Out
Feb 2020,246,208,223,26373732,253711892,280085624,61,220,2,227338160,In > Out
Feb 2020,246,209,403,19706306,322769041,342475347,124,396,2,303062735,In > Out
Feb 2020,246,210,3,102715,6146489,6249204,3,3,1,6043774,In > Out
Feb 2020,246,214,93,6549067,105858403,112407470,33,93,2,99309336,In > Out
Feb 2020,246,215,54,2807821,107980166,110787987,17,54,2,105172345,In > Out
Feb 2020,246,220,348,27304158,623714338,651018496,120,344,2,596410180,In > Out
Feb 2020,246,222,83,6483324,209981748,216465072,20,82,2,203498424,In > Out
Feb 2020,246,227,118,6735883,221126279,227862162,51,117,2,214390396,In > Out
Feb 2020,246,229,244,11416848,330886762,342303610,64,239,2,319469914,In > Out
Feb 2020,246,233,132,8517009,285777562,294294571,25,132,2,277260553,In > Out
Feb 2020,246,234,505,28595658,640586721,669182379,157,502,2,611991063,In > Out
Feb 2020,246,241,164,7431083,170785416,178216499,58,164,2,163354333,In > Out
Feb 2020,246,245,3,181391,299761,481152,3,3,2,118370,In > Out
Feb 2020,246,246,11,369844,20335946,20705790,9,11,2,19966102,In > Out
Feb 2020,246,252,126,3309461,64459511,67768972,74,125,2,61150050,In > Out
Feb 2020,246,41,131,4900849,188552002,193452851,61,128,2,183651153,In > Out
Feb 2020,246,42,77,2953124,59439174,62392298,23,77,2,56486050,In > Out
Feb 2020,246,43,84,3603526,105306542,108910068,30,84,2,101703016,In > Out
Feb 2020,246,44,126,5167141,149145178,154312319,56,126,2,143978037,In > Out
Feb 2020,246,45,9383,520968624,27998323300,28519291924,71,9300,2,27477354676,In > Out
Feb 2020,246,46,167,16581304,199994884,216576188,78,166,2,183413580,In > Out
Feb 2020,246,47,65,1546252,57373259,58919511,19,65,2,55827007,In > Out
Feb 2020,246,48,106,6073815,181276329,187350144,34,106,2,175202514,In > Out
Feb 2020,246,49,64,1822500,45864794,47687294,19,64,2,44042294,In > Out
Feb 2020,246,50,102,4046603,138087913,142134516,35,102,2,134041310,In > Out
Feb 2020,246,51,79,2952008,105810943,108762951,20,77,2,102858935,In > Out
Feb 2020,246,52,112,7109181,285708577,292817758,28,112,2,278599396,In > Out
Feb 2020,246,53,144,9986348,297991732,307978080,64,143,2,288005384,In > Out
Feb 2020,246,54,152,9937189,397497580,407434769,54,152,2,387560391,In > Out
Feb 2020,246,55,81,3263125,138075620,141338745,18,81,2,134812495,In > Out
Feb 2020,246,56,69,2732149,101179384,103911533,21,69,2,98447235,In > Out
Feb 2020,246,57,49,1796950,96454475,98251425,19,49,2,94657525,In > Out
Feb 2020,246,58,68,2284254,72884128,75168382,18,67,2,70599874,In > Out
Feb 2020,246,59,298,20866575,529114186,549980761,155,296,2,508247611,In > Out
Feb 2020,246,60,102,5031014,222815477,227846491,22,101,2,217784463,In > Out
Feb 2020,246,61,73,3016685,153170820,156187505,17,73,2,150154135,In > Out
Feb 2020,246,62,55,2063527,106288027,108351554,23,53,2,104224500,In > Out
Feb 2020,246,63,57,2032835,78294491,80327326,15,57,2,76261656,In > Out
Feb 2020,246,64,82,4166662,164304405,168471067,22,82,2,160137743,In > Out
Feb 2020,246,65,183,9049795,300741529,309791324,80,179,2,291691734,In > Out
Feb 2020,246,66,125,3672823,107013229,110686052,59,124,2,103340406,In > Out
Feb 2020,246,67,41,566939,18837777,19404716,25,41,2,18270838,In > Out
Feb 2020,246,68,89,3864323,143618596,147482919,40,88,2,139754273,In > Out
Feb 2020,246,69,106,2989802,93038006,96027808,43,106,2,90048204,In > Out
Feb 2020,246,70,79,3403985,97844110,101248095,41,79,2,94440125,In > Out
Feb 2020,246,71,88,14087397,116293654,130381051,29,87,2,102206257,In > Out
Feb 2020,246,72,72,2521093,74249819,76770912,34,72,2,71728726,In > Out
Feb 2020,246,73,114,4852872,120105056,124957928,41,114,2,115252184,In > Out
Feb 2020,246,74,61,2953826,76309797,79263623,22,60,2,73355971,In > Out
Feb 2020,246,75,110,3297838,145744809,149042647,43,109,2,142446971,In > Out
Feb 2020,246,76,152,6002726,162990032,168992758,55,150,2,156987306,In > Out
Feb 2020,246,77,208,11013606,214630823,225644429,73,202,2,203617217,In > Out
Feb 2020,246,78,177,44621777,249451570,294073347,56,175,2,204829793,In > Out
Feb 2020,246,79,86,3577604,106757558,110335162,31,85,2,103179954,In > Out
Feb 2020,246,80,97,3652891,107702019,111354910,32,95,2,104049128,In > Out
Feb 2020,246,81,52,2942428,117957599,120900027,20,51,2,115015171,In > Out
Feb 2020,246,82,148,26914169,144851266,171765435,46,148,2,117937097,In > Out
Feb 2020,246,83,107,3217075,97725150,100942225,33,106,2,94508075,In > Out
Feb 2020,246,84,56,1985828,72652480,74638308,20,56,2,70666652,In > Out
Feb 2020,246,85,232,9800965,272540325,282341290,87,228,2,262739360,In > Out
Feb 2020,246,86,48,1594523,50279255,51873778,18,48,2,48684732,In > Out
Feb 2020,246,87,125,3292869,125777822,129070691,45,125,2,122484953,In > Out
Feb 2020,246,88,133,3465140,119961420,123426560,46,133,2,116496280,In > Out
Feb 2020,248,111,158,6980673,497509263,504489936,39,155,2,490528590,In > Out
Feb 2020,248,131,125,8812588,251696015,260508603,53,121,2,242883427,In > Out
Feb 2020,25,22,6,528445,1722546,2250991,6,6,2,1194101,In > Out
Feb 2020,250,116,5,53764,1790695,1844459,1,5,1,1736931,In > Out
Feb 2020,250,15,2597,1496493239,35815444444,37311937683,600,1892,5,34318951205,In > Out
Feb 2020,250,193,198,27513123,340385685,367898808,56,197,3,312872562,In > Out
Feb 2020,250,201,3264,1097905881,5350572893,6448478774,354,2872,17,4252667012,In > Out
Feb 2020,250,204,19056,1920892965,38554462627,40475355592,647,11067,9,36633569662,In > Out
Feb 2020,250,3,16,1856899,1499729,3356628,2,6,6,357170,Out > In
Feb 2020,250,34,4091,110077394,3736117612,3846195006,285,3767,3,3626040218,In > Out
Feb 2020,250,39,1640,249646661,10161547485,10411194146,369,1579,7,9911900824,In > Out
Feb 2020,250,41,1697,423325151,3735191670,4158516821,254,1679,8,3311866519,In > Out
Feb 2020,250,49,2,164287,58853,223140,2,2,1,105434,Out > In
Feb 2020,250,51,37,3291999,17242356,20534355,20,35,17,13950357,In > Out
Feb 2020,256,11,8,18417470,439819,18857289,6,1,8,17977651,Out > In
Feb 2020,256,12,59,40428781,1626072,42054853,24,59,1,38802709,Out > In
Feb 2020,256,15,169,6533267,324994355,331527622,9,169,4,318461088,In > Out
Feb 2020,256,248,217809,75643521037,1215459063755,1291102584792,15381,30452,875,1139815542718,In > Out
Feb 2020,256,249,199898,90087537334,1099092118423,1189179655757,15643,30504,1213,1009004581089,In > Out
Feb 2020,256,250,203198,62424346746,786153313318,848577660064,14748,31361,773,723728966572,In > Out
Feb 2020,256,251,198752,66792589959,879368417383,946161007342,14863,30074,1058,812575827424,In > Out
Feb 2020,256,252,212328,91235803627,1313275105570,1404510909197,14872,30400,871,1222039301943,In > Out
Feb 2020,256,253,208124,78571872999,805583303782,884155176781,15038,30434,859,727011430783,In > Out
Feb 2020,256,254,181009,81805883118,594560849698,676366732816,13565,29892,757,512754966580,In > Out
Feb 2020,26,2,11,27356,1663717,1691073,2,11,1,1636361,In > Out
Feb 2020,26,66,8,27111,2236918,2264029,3,8,1,2209807,In > Out
Feb 2020,29,132,353,92221674,524264686,616486360,180,351,3,432043012,In > Out
Feb 2020,29,142,120,5434288,182314845,187749133,38,120,2,176880557,In > Out
Feb 2020,29,144,2,96973,4448146,4545119,2,2,1,4351173,In > Out
Feb 2020,29,149,1,5373,275066,280439,1,1,1,269693,In > Out
Feb 2020,29,15,3,16897,398092,414989,3,3,2,381195,In > Out
Feb 2020,29,162,8,3840237,9360537,13200774,3,8,1,5520300,In > Out
Feb 2020,29,163,11,4014417,17834498,21848915,7,11,1,13820081,In > Out
Feb 2020,29,17,1,52591,3174908,3227499,1,1,1,3122317,In > Out
Feb 2020,29,175,2,68813,1443579,1512392,2,2,2,1374766,In > Out
Feb 2020,29,19,339,22097437,211759675,233857112,170,337,2,189662238,In > Out
Feb 2020,29,192,20,21787403,2100403555,2122190958,8,20,2,2078616152,In > Out
Feb 2020,29,200,18,825268,6776615,7601883,13,18,1,5951347,In > Out
Feb 2020,29,201,504,57472796,295301638,352774434,193,500,3,237828842,In > Out
Feb 2020,29,214,72,2978865,33263052,36241917,33,72,2,30284187,In > Out
Feb 2020,29,216,1387,537797760,1429594796,1967392556,250,1339,3,891797036,In > Out
Feb 2020,29,27,464,19747706,309468445,329216151,197,457,2,289720739,In > Out
Feb 2020,29,36,1,16241,925532,941773,1,1,1,909291,In > Out
Feb 2020,29,40,468,34108434,414610256,448718690,119,467,2,380501822,In > Out
Feb 2020,29,52,13025,1747988232,27789004996,29536993228,1707,9329,38,26041016764,In > Out
Feb 2020,3,195,407,121223242,137038588,258261830,11,393,3,15815346,In > Out
Feb 2020,3,196,92,888879,95213673,96102552,4,91,1,94324794,In > Out
Feb 2020,3,197,5,40754,2390907,2431661,2,5,1,2350153,In > Out
Feb 2020,3,199,3,40597,4611189,4651786,2,3,1,4570592,In > Out
Feb 2020,35,111,42,7296307,6713516,14009823,1,42,1,582791,Out > In
Feb 2020,35,112,17,5756709,4921570,10678279,2,17,2,835139,Out > In
Feb 2020,35,116,550,2859432,105706515,108565947,1,550,1,102847083,In > Out
Feb 2020,35,118,3,5884,432648,438532,1,3,1,426764,In > Out
Feb 2020,35,16,24,1737031,4450032,6187063,5,24,2,2713001,In > Out
Feb 2020,35,161,8,89673,4398202,4487875,2,8,1,4308529,In > Out
Feb 2020,35,162,13,41655,2702110,2743765,4,13,1,2660455,In > Out
Feb 2020,35,164,4,13063,551980,565043,3,4,2,538917,In > Out
Feb 2020,35,165,17,42304,2909168,2951472,3,17,1,2866864,In > Out
Feb 2020,35,17,11,53176,4929642,4982818,3,11,1,4876466,In > Out
Feb 2020,35,181,15,102412,4813198,4915610,6,15,1,4710786,In > Out
Feb 2020,35,182,20,64995,4109926,4174921,3,20,1,4044931,In > Out
Feb 2020,35,183,16,69071,4242516,4311587,4,16,1,4173445,In > Out
Feb 2020,35,191,23,5437240,1847849,7285089,12,23,2,3589391,Out > In
Feb 2020,35,193,5,216969,8905454,9122423,3,5,1,8688485,In > Out
Feb 2020,35,195,28,412140,5622562,6034702,2,28,2,5210422,In > Out
Feb 2020,35,198,11,50099,5038790,5088889,6,11,1,4988691,In > Out
Feb 2020,35,199,21,114621,6230118,6344739,7,21,1,6115497,In > Out
Feb 2020,35,200,7,36390,1776346,1812736,3,7,1,1739956,In > Out
Feb 2020,35,201,10,24462,1569201,1593663,1,10,1,1544739,In > Out
Feb 2020,35,23,9,928704,91706246,92634950,4,9,2,90777542,In > Out
Feb 2020,35,232,1,966204,414224417,415190621,1,1,1,413258213,In > Out
Feb 2020,35,98,13,58010,3651550,3709560,4,13,1,3593540,In > Out
Feb 2020,4,104,19,182128,13006723,13188851,3,19,2,12824595,In > Out
Feb 2020,4,105,1009,91004826,840971118,931975944,151,978,2,749966292,In > Out
Feb 2020,4,106,8120,842724082,35724055833,36566779915,528,6235,4,34881331751,In > Out
Feb 2020,4,11,17,685438,88838878,89524316,8,17,2,88153440,In > Out
Feb 2020,4,112,870,90193430,615556282,705749712,192,852,2,525362852,In > Out
Feb 2020,4,113,506,46161731,553026126,599187857,175,505,2,506864395,In > Out
Feb 2020,4,12,18,3352067,46595653,49947720,12,18,2,43243586,In > Out
Feb 2020,4,14,522,110514924,1925761878,2036276802,132,516,4,1815246954,In > Out
Feb 2020,4,15,275,15402127,204487626,219889753,125,273,2,189085499,In > Out
Feb 2020,4,17,249,549454883,2032792823,2582247706,119,247,4,1483337940,In > Out
Feb 2020,4,2,1038,55839469,525799519,581638988,217,996,3,469960050,In > Out
Feb 2020,4,20,6,509444,491158,1000602,1,1,1,18286,Out > In
Feb 2020,4,223,10,178260,5319700,5497960,1,10,1,5141440,In > Out
Feb 2020,4,35,1312,92954514,2624103342,2717057856,238,1265,3,2531148828,In > Out
Feb 2020,40,18,1,3322,146660,149982,1,1,1,143338,In > Out
Feb 2020,40,21,2,10248,421741,431989,1,2,1,411493,In > Out
Feb 2020,40,9,19,128155,5378795,5506950,4,19,1,5250640,In > Out
Feb 2020,43,4,1,6125525,63857,6189382,1,1,1,6061668,Out > In
Feb 2020,44,26,3473,11440700310,52829624194,64270324504,631,3162,54,41388923884,In > Out
Feb 2020,44,28,36852,4547740113,214230734817,218778474930,266,14682,84,209682994704,In > Out
Feb 2020,45,161,1375,792548578,8477489002,9270037580,327,1290,26,7684940424,In > Out
Feb 2020,45,187,2502,947385002,24049285093,24996670095,608,2302,90,23101900091,In > Out
Feb 2020,46,11,251,50317830,3619695920,3670013750,98,251,2,3569378090,In > Out
Feb 2020,46,113,105,14128048,1191362420,1205490468,24,105,2,1177234372,In > Out
Feb 2020,46,116,883,165828750,688385170,854213920,303,874,3,522556420,In > Out
Feb 2020,46,121,102,29673852,1245745803,1275419655,32,102,2,1216071951,In > Out
Feb 2020,46,127,450,59132891,3476968860,3536101751,180,446,16,3417835969,In > Out
Feb 2020,46,132,168,99687939,3969517318,4069205257,58,164,2,3869829379,In > Out
Feb 2020,46,135,123,13914685,931482032,945396717,42,123,2,917567347,In > Out
Feb 2020,46,152,1276,220065047,14604813286,14824878333,313,1249,8,14384748239,In > Out
Feb 2020,46,156,681,73028754,5210916279,5283945033,137,672,4,5137887525,In > Out
Feb 2020,46,17,6,165035,1718976,1884011,3,6,1,1553941,In > Out
Feb 2020,46,172,43,2229856,167782846,170012702,14,43,1,165552990,In > Out
Feb 2020,46,18,390,99188102,600536123,699724225,90,390,4,501348021,In > Out
Feb 2020,46,183,149,90468380,424781921,515250301,65,148,60,334313541,In > Out
Feb 2020,46,185,40,4127156,184274329,188401485,30,39,2,180147173,In > Out
Feb 2020,46,196,19,634374,24742194,25376568,13,19,2,24107820,In > Out
Feb 2020,46,21,12,3839392,207846200,211685592,4,12,2,204006808,In > Out
Feb 2020,46,210,511,398405984,5382477823,5780883807,100,391,51,4984071839,In > Out
Feb 2020,46,212,35,16335561,784353883,800689444,14,35,2,768018322,In > Out
Feb 2020,46,215,1978,1426098131,15868168403,17294266534,565,1890,28,14442070272,In > Out
Feb 2020,46,22,190,89655830,2095332330,2184988160,51,190,2,2005676500,In > Out
Feb 2020,46,221,217,297624007,14184660758,14482284765,92,216,4,13887036751,In > Out
Feb 2020,46,23,16,2886290,35562637,38448927,5,16,3,32676347,In > Out
Feb 2020,46,26,18,415582,7037216,7452798,8,18,2,6621634,In > Out
Feb 2020,46,27,4,26147,666461,692608,4,4,2,640314,In > Out
Feb 2020,46,28,869,605863412,27317889338,27923752750,308,526,79,26712025926,In > Out
Feb 2020,46,29,1471,3016201928,6655339618,9671541546,411,1333,47,3639137690,In > Out
Feb 2020,46,38,11,584510,4511339,5095849,9,11,1,3926829,In > Out
Feb 2020,46,39,94,4805504,184201743,189007247,22,94,2,179396239,In > Out
Feb 2020,46,48,265,431214161,19878283254,20309497415,77,259,2,19447069093,In > Out
Feb 2020,46,55,93,40190834,1410267446,1450458280,42,93,2,1370076612,In > Out
Feb 2020,46,57,2858,571292527,15688011770,16259304297,426,2615,6,15116719243,In > Out
Feb 2020,46,61,196,9995720,726050845,736046565,78,196,2,716055125,In > Out
Feb 2020,46,67,11,2995060,24802110,27797170,5,11,2,21807050,In > Out
Feb 2020,46,76,832,616111865,6509470543,7125582408,284,717,119,5893358678,In > Out
Feb 2020,46,77,176,45294643,3332223674,3377518317,56,176,2,3286929031,In > Out
Feb 2020,47,11,7,337496,21991850,22329346,4,7,2,21654354,In > Out
Feb 2020,48,164,29,5205491,20730542,25936033,12,29,1,15525051,In > Out
Feb 2020,48,50,8406,775236241,34879767223,35655003464,192,6565,11,34104530982,In > Out
Feb 2020,48,92,1950,1071191190,6499946209,7571137399,421,1871,66,5428755019,In > Out
Feb 2020,49,113,17725,3395802986,20969986858,24365789844,1940,11311,15,17574183872,In > Out
Feb 2020,49,114,16136,2453524800,22272123371,24725648171,1824,10626,45,19818598571,In > Out
Feb 2020,49,115,17157,2780373330,50668802523,53449175853,1782,11435,110,47888429193,In > Out
Feb 2020,49,116,18859,4691682420,23347493744,28039176164,1861,11392,9,18655811324,In > Out
Feb 2020,49,117,21714,3867347047,29391346180,33258693227,1678,13324,16,25523999133,In > Out
Feb 2020,49,118,21507,3096436326,26935445211,30031881537,1371,14177,10,23839008885,In > Out
Feb 2020,49,119,23523,16230683299,59515638116,75746321415,2264,15014,12,43284954817,In > Out
Feb 2020,49,120,26443,15676844925,34272575990,49949420915,1791,14730,25,18595731065,In > Out
Feb 2020,49,121,20007,2919785453,40720251346,43640036799,1734,12392,11,37800465893,In > Out
Feb 2020,49,122,17109,3001221515,24034315313,27035536828,1715,11514,14,21033093798,In > Out
Feb 2020,49,123,24334,4697531603,44551708741,49249240344,1921,13852,33,39854177138,In > Out
Feb 2020,49,124,18269,3895442716,18876110104,22771552820,1655,11601,9,14980667388,In > Out
Feb 2020,49,125,104380,45156223264,187139262357,232295485621,3735,16747,154,141983039093,In > Out
Feb 2020,49,126,109293,28431052738,206367021089,234798073827,4092,17000,110,177935968351,In > Out
Feb 2020,49,196,184,23320815745,63026769351,86347585096,130,1,184,39705953606,In > Out
Feb 2020,49,212,48,8267011816,1358131121,9625142937,43,1,48,6908880695,Out > In
Feb 2020,49,244,250,92025304,107563300,199588604,5,1,1,15537996,In > Out
Feb 2020,5,13,3,506620,75329038,75835658,1,3,1,74822418,In > Out
Feb 2020,5,2,2,242821,41566280,41809101,1,2,1,41323459,In > Out
Feb 2020,5,22,37,735118,37283364,38018482,27,36,3,36548246,In > Out
Feb 2020,5,25,147,10100687,456060095,466160782,64,143,11,445959408,In > Out
Feb 2020,5,27,93,1994383,57852922,59847305,33,93,2,55858539,In > Out
Feb 2020,5,6,4,7137552,76993,7214545,1,4,1,7060559,Out > In
Feb 2020,50,241,5,41446,1158063,1199509,2,5,1,1116617,In > Out
Feb 2020,50,52,14,1057022,54177324,55234346,6,14,2,53120302,In > Out
Feb 2020,51,10,13,1604072,79949845,81553917,7,13,2,78345773,In > Out
Feb 2020,51,103,1235,101270236,755425206,856695442,245,1189,4,654154970,In > Out
Feb 2020,51,151,720,40962373,870888572,911850945,184,698,2,829926199,In > Out
Feb 2020,51,152,324,46149756,2515228595,2561378351,126,313,3,2469078839,In > Out
Feb 2020,51,153,22,646942,17362551,18009493,11,22,2,16715609,In > Out
Feb 2020,51,154,684,72304129,4674129996,4746434125,91,666,214,4601825867,In > Out
Feb 2020,51,156,566,68822257,334048624,402870881,114,556,3,265226367,In > Out
Feb 2020,51,157,113,24100035,1168997668,1193097703,29,113,2,1144897633,In > Out
Feb 2020,51,160,254,36314674,516490192,552804866,29,98,3,480175518,In > Out
Feb 2020,51,161,14,112668,2822459,2935127,7,14,1,2709791,In > Out
Feb 2020,51,162,60,140930009,121714576,262644585,23,60,3,19215433,Out > In
Feb 2020,51,163,357,75586385,135979714,211566099,6,355,2,60393329,In > Out
Feb 2020,51,165,2,9437484,147189527,156627011,2,2,1,137752043,In > Out
Feb 2020,51,167,10,475699,2241430,2717129,9,10,2,1765731,In > Out
Feb 2020,51,168,970,38132326,1875040292,1913172618,280,954,3,1836907966,In > Out
Feb 2020,51,169,6,463976,5001011,5464987,4,6,1,4537035,In > Out
Feb 2020,51,172,776,55708777,418343838,474052615,269,761,3,362635061,In > Out
Feb 2020,51,174,56,2826002,68900527,71726529,27,56,2,66074525,In > Out
Feb 2020,51,177,166,11221710,272765270,283986980,24,164,2,261543560,In > Out
Feb 2020,51,179,903,712712232,192389905,905102137,195,879,2,520322327,Out > In
Feb 2020,51,180,919,62937733,1735097684,1798035417,209,888,3,1672159951,In > Out
Feb 2020,51,182,918,2058022520,7252951119,9310973639,22,893,205,5194928599,In > Out
Feb 2020,51,183,2,124578,118017,242595,1,1,1,6561,Out > In
Feb 2020,51,184,731,49357048,857683703,907040751,196,711,2,808326655,In > Out
Feb 2020,51,187,27,930442,72552570,73483012,11,27,2,71622128,In > Out
Feb 2020,51,188,194,4378271,55524589,59902860,64,191,2,51146318,In > Out
Feb 2020,51,194,339,15959931,290645352,306605283,171,335,3,274685421,In > Out
Feb 2020,51,199,2,144290,2539574,2683864,2,2,1,2395284,In > Out
Feb 2020,51,205,563,49693180,1429964568,1479657748,201,545,2,1380271388,In > Out
Feb 2020,51,210,19,2288821,163365870,165654691,9,19,2,161077049,In > Out
Feb 2020,51,211,477,49182677,211382754,260565431,85,474,2,162200077,In > Out
Feb 2020,51,212,395,30059241,587149171,617208412,182,391,2,557089930,In > Out
Feb 2020,51,213,162,8005487,89211866,97217353,82,162,2,81206379,In > Out
Feb 2020,51,219,114,5903487,280513310,286416797,10,114,2,274609823,In > Out
Feb 2020,51,220,3,28806,1268368,1297174,3,3,1,1239562,In > Out
Feb 2020,51,221,574,52793296,206197236,258990532,86,566,2,153403940,In > Out
Feb 2020,51,224,112,10561193,353616763,364177956,7,112,2,343055570,In > Out
Feb 2020,51,226,838,42462011,963968889,1006430900,294,808,3,921506878,In > Out
Feb 2020,51,228,36,1975976,62309532,64285508,22,36,3,60333556,In > Out
Feb 2020,51,232,126,193727902,165895163,359623065,30,124,6,27832739,Out > In
Feb 2020,51,236,50,672255,140502825,141175080,3,50,2,139830570,In > Out
Feb 2020,51,237,195,14726539,262933303,277659842,34,195,2,248206764,In > Out
Feb 2020,51,238,2,23036,671354,694390,2,2,2,648318,In > Out
Feb 2020,51,239,1229,131926635,5789719088,5921645723,259,1198,2,5657792453,In > Out
Feb 2020,51,30,686,64629591,432200092,496829683,158,665,6,367570501,In > Out
Feb 2020,51,31,8,622127,73053078,73675205,4,8,2,72430951,In > Out
Feb 2020,51,35,58,2278896,161353270,163632166,14,58,2,159074374,In > Out
Feb 2020,51,4,11,554715,28420776,28975491,7,11,1,27866061,In > Out
Feb 2020,51,45,389,28173125,385915492,414088617,127,383,2,357742367,In > Out
Feb 2020,51,5,11,986950,50897551,51884501,6,11,1,49910601,In > Out
Feb 2020,51,6,13,955792,61897837,62853629,6,13,1,60942045,In > Out
Feb 2020,51,77,42,1873807,115047102,116920909,15,42,3,113173295,In > Out
Feb 2020,51,78,2,450764904549,3302486101,454067390650,1,2,1,447462418448,Out > In
Feb 2020,52,10,44,28589249,99437124,128026373,22,44,3,70847875,In > Out
Feb 2020,52,113,518,32415506,497293184,529708690,122,514,3,464877678,In > Out
Feb 2020,52,115,141,3946744,194745178,198691922,29,141,2,190798434,In > Out
Feb 2020,52,116,35,406695,42413979,42820674,18,35,2,42007284,In > Out
Feb 2020,52,118,4,118345,5357700,5476045,3,4,1,5239355,In > Out
Feb 2020,52,119,1440,115416743,1663145202,1778561945,334,1395,5,1547728459,In > Out
Feb 2020,52,12,32,2114953,259513611,261628564,10,32,2,257398658,In > Out
Feb 2020,52,120,192,29216329,331331166,360547495,45,191,4,302114837,In > Out
Feb 2020,52,124,74,1526097,89894150,91420247,45,74,2,88368053,In > Out
Feb 2020,52,13,15,118739,4669674,4788413,6,15,1,4550935,In > Out
Feb 2020,52,141,22,2257536,145633253,147890789,7,22,1,143375717,In > Out
Feb 2020,52,142,4,43533,3916210,3959743,4,4,1,3872677,In > Out
Feb 2020,52,143,92,2757246,194218465,196975711,27,92,2,191461219,In > Out
Feb 2020,52,149,33,14117487,1068089453,1082206940,9,25,3,1053971966,In > Out
Feb 2020,52,15,4,18403,674401,692804,4,4,1,655998,In > Out
Feb 2020,52,16,7,23605,937117,960722,6,7,1,913512,In > Out
Feb 2020,52,164,18,3430003,110343444,113773447,7,18,2,106913441,In > Out
Feb 2020,52,172,8,35669,1088767,1124436,6,8,1,1053098,In > Out
Feb 2020,52,197,8,805974,63220607,64026581,5,8,1,62414633,In > Out
Feb 2020,52,199,10,560867,32679087,33239954,7,10,1,32118220,In > Out
Feb 2020,52,22,5,24507,755353,779860,5,5,1,730846,In > Out
Feb 2020,52,24,23,1284663,75850305,77134968,7,23,1,74565642,In > Out
Feb 2020,52,25,59,1493144,68492226,69985370,15,59,2,66999082,In > Out
Feb 2020,52,251,565,189998956,4425909499,4615908455,254,557,6,4235910543,In > Out
Feb 2020,52,252,16,12385592,11712716,24098308,12,16,1,672876,Out > In
Feb 2020,52,253,11,530116,20329662,20859778,9,11,1,19799546,In > Out
Feb 2020,52,29,51,3445294,349448229,352893523,10,51,2,346002935,In > Out
Feb 2020,52,33,2,670477,12576537,13247014,2,2,1,11906060,In > Out
Feb 2020,52,35,25,1435282,98655378,100090660,9,25,1,97220096,In > Out
Feb 2020,52,36,22,2628369,223737444,226365813,8,22,1,221109075,In > Out
Feb 2020,52,37,23,1722314,121771274,123493588,8,23,1,120048960,In > Out
Feb 2020,52,38,26,4290805,1270555996,1274846801,10,26,2,1266265191,In > Out
Feb 2020,52,4,24,2327584,122180574,124508158,7,24,1,119852990,In > Out
Feb 2020,52,6,53,2531323,167141738,169673061,13,53,2,164610415,In > Out
Feb 2020,52,8,20,1624974,103023025,104647999,5,20,1,101398051,In > Out
Feb 2020,52,9,24,1491455,146575330,148066785,8,24,1,145083875,In > Out
Feb 2020,52,90,180,7031013,80159209,87190222,77,179,3,73128196,In > Out
Feb 2020,52,91,292,38682791,636989368,675672159,147,291,8,598306577,In > Out
Feb 2020,52,92,152,15364223,199556645,214920868,85,152,2,184192422,In > Out
Feb 2020,52,93,719,257246461,1853851003,2111097464,200,700,2,1596604542,In > Out
Feb 2020,52,94,343,22245062,948199988,970445050,121,343,3,925954926,In > Out
Feb 2020,52,95,235,38275131,288242045,326517176,109,232,3,249966914,In > Out
Feb 2020,52,97,4,328015,20395382,20723397,3,4,1,20067367,In > Out
Feb 2020,52,98,404,176884842,840523055,1017407897,102,398,3,663638213,In > Out
Feb 2020,53,169,17,421473307,80664996,502138303,8,17,15,340808311,Out > In
Feb 2020,54,103,40,836477,41841361,42677838,15,40,2,41004884,In > Out
Feb 2020,54,104,117,3910895,159884462,163795357,50,117,2,155973567,In > Out
Feb 2020,54,105,104,3086178,127952887,131039065,53,103,2,124866709,In > Out
Feb 2020,54,106,108,2843096,117149210,119992306,40,108,2,114306114,In > Out
Feb 2020,54,107,160,5159612,174442339,179601951,46,159,2,169282727,In > Out
Feb 2020,54,108,100,2315333,92738293,95053626,43,100,2,90422960,In > Out
Feb 2020,54,109,138,4561992,186214661,190776653,51,137,2,181652669,In > Out
Feb 2020,54,110,147,2958047,132032312,134990359,38,147,2,129074265,In > Out
Feb 2020,54,115,161,4857791,251300825,256158616,26,161,2,246443034,In > Out
Feb 2020,54,116,143,4190589,161321304,165511893,54,143,2,157130715,In > Out
Feb 2020,54,117,143,5205638,211722243,216927881,49,141,2,206516605,In > Out
Feb 2020,54,118,224,6383408,300630444,307013852,48,223,2,294247036,In > Out
Feb 2020,54,119,213,8627826,321538601,330166427,51,213,2,312910775,In > Out
Feb 2020,54,12,12,617739,30572566,31190305,6,12,1,29954827,In > Out
Feb 2020,54,120,177,4671927,174100885,178772812,58,175,2,169428958,In > Out
Feb 2020,54,121,84,3036056,118007184,121043240,45,84,2,114971128,In > Out
Feb 2020,54,122,122,3516723,165210162,168726885,42,122,2,161693439,In > Out
Feb 2020,54,127,154,3787241,236563159,240350400,15,152,2,232775918,In > Out
Feb 2020,54,128,115,2738245,158970427,161708672,19,114,2,156232182,In > Out
Feb 2020,54,129,93,1800640,103305644,105106284,17,93,2,101505004,In > Out
Feb 2020,54,130,101,1873136,109789994,111663130,16,101,2,107916858,In > Out
Feb 2020,54,131,188,5499738,306212757,311712495,25,188,2,300713019,In > Out
Feb 2020,54,132,84,3514203,207844779,211358982,22,82,2,204330576,In > Out
Feb 2020,54,133,105,2666703,144688309,147355012,18,105,2,142021606,In > Out
Feb 2020,54,134,82,2474221,140659546,143133767,14,81,2,138185325,In > Out
Feb 2020,54,139,70,1284030,41108450,42392480,24,70,2,39824420,In > Out
Feb 2020,54,140,39,886230,43385245,44271475,17,39,2,42499015,In > Out
Feb 2020,54,141,58,1494661,54101666,55596327,20,58,2,52607005,In > Out
Feb 2020,54,142,75,3237039,148863409,152100448,24,75,2,145626370,In > Out
Feb 2020,54,143,43,856212,35442775,36298987,18,43,2,34586563,In > Out
Feb 2020,54,144,75,1714386,66344496,68058882,28,74,2,64630110,In > Out
Feb 2020,54,145,55,1404570,56372854,57777424,19,55,2,54968284,In > Out
Feb 2020,54,146,109,2151144,97965484,100116628,26,109,2,95814340,In > Out
Feb 2020,54,155,20,3253566,246309665,249563231,10,20,2,243056099,In > Out
Feb 2020,54,166,49,812698,31891476,32704174,15,49,2,31078778,In > Out
Feb 2020,54,167,35,529755,22253576,22783331,13,35,2,21723821,In > Out
Feb 2020,54,20,15,3045472,210341772,213387244,6,15,1,207296300,In > Out
Feb 2020,54,21,12,1742466,110740155,112482621,5,12,1,108997689,In > Out
Feb 2020,54,22,13,3359399,264504451,267863850,8,13,1,261145052,In > Out
Feb 2020,54,23,15,2670960,207395260,210066220,7,15,1,204724300,In > Out
Feb 2020,54,24,14,1699210,135994656,137693866,7,14,1,134295446,In > Out
Feb 2020,54,25,13,1447416,88155391,89602807,6,13,1,86707975,In > Out
Feb 2020,54,26,16,1624945,112971674,114596619,7,15,1,111346729,In > Out
Feb 2020,54,27,12,1466413,105467435,106933848,8,12,1,104001022,In > Out
Feb 2020,54,28,103,6252917,261670660,267923577,43,102,2,255417743,In > Out
Feb 2020,54,29,148,7236322,144673197,151909519,92,148,2,137436875,In > Out
Feb 2020,54,30,31,3067161,187986358,191053519,18,31,2,184919197,In > Out
Feb 2020,54,31,15,2471390,190441786,192913176,8,15,1,187970396,In > Out
Feb 2020,54,32,22,2090794,139019927,141110721,13,22,2,136929133,In > Out
Feb 2020,54,33,13,2312664,179346193,181658857,6,13,1,177033529,In > Out
Feb 2020,54,34,9,961382,64783232,65744614,6,9,1,63821850,In > Out
Feb 2020,54,35,17,2932434,190715213,193647647,8,17,1,187782779,In > Out
Feb 2020,54,36,48,8132877,158862946,166995823,25,48,2,150730069,In > Out
Feb 2020,54,37,175,9833371,296582744,306416115,86,175,2,286749373,In > Out
Feb 2020,54,38,35,3407965,239545005,242952970,17,35,2,236137040,In > Out
Feb 2020,54,39,135,5785536,348306930,354092466,57,135,2,342521394,In > Out
Feb 2020,54,40,238,75145458,707171408,782316866,80,234,2,632025950,In > Out
Feb 2020,54,41,54,41400721,109246889,150647610,26,54,2,67846168,In > Out
Feb 2020,54,42,17,1718474,121612196,123330670,9,17,2,119893722,In > Out
Feb 2020,54,43,22,1712022,116190207,117902229,11,22,2,114478185,In > Out
Feb 2020,54,44,58,3072973,193972987,197045960,34,58,2,190900014,In > Out
Feb 2020,54,45,138,8969534,205210942,214180476,77,138,2,196241408,In > Out
Feb 2020,54,46,89,3955164,142119707,146074871,52,89,2,138164543,In > Out
Feb 2020,54,47,15,1091494,73166396,74257890,12,15,2,72074902,In > Out
Feb 2020,54,48,21,1975871,114303903,116279774,13,21,2,112328032,In > Out
Feb 2020,54,49,15,2042132,130973777,133015909,5,15,1,128931645,In > Out
Feb 2020,54,50,23,1879828,110280418,112160246,16,23,2,108400590,In > Out
Feb 2020,54,51,192,17007702,247209233,264216935,87,191,2,230201531,In > Out
Feb 2020,54,52,169,8670338,297738679,306409017,90,167,2,289068341,In > Out
Feb 2020,54,53,13,936929,57569633,58506562,7,13,1,56632704,In > Out
Feb 2020,54,54,24,2580710,189355113,191935823,14,24,2,186774403,In > Out
Feb 2020,54,55,51,7172696,454757481,461930177,36,51,2,447584785,In > Out
Feb 2020,54,56,112,3961604,156499676,160461280,58,112,2,152538072,In > Out
Feb 2020,54,57,15,1514895,78999551,80514446,8,15,2,77484656,In > Out
Feb 2020,54,58,47,6713824,257852181,264566005,21,47,2,251138357,In > Out
Feb 2020,54,59,10,622027,45104721,45726748,7,10,2,44482694,In > Out
Feb 2020,54,60,18,3363858,226726203,230090061,8,18,1,223362345,In > Out
Feb 2020,54,61,45,3502829,201689626,205192455,30,45,2,198186797,In > Out
Feb 2020,54,62,57,3560885,130944618,134505503,27,57,2,127383733,In > Out
Feb 2020,54,63,11,1019829,65753497,66773326,6,11,1,64733668,In > Out
Feb 2020,54,64,13,1535605,100062859,101598464,7,13,1,98527254,In > Out
Feb 2020,54,67,111,7191172,303671288,310862460,52,111,2,296480116,In > Out
Feb 2020,54,68,140,9403332,429086799,438490131,69,138,2,419683467,In > Out
Feb 2020,54,69,351,19347210,1005494499,1024841709,97,346,2,986147289,In > Out
Feb 2020,54,7,5,163546,859574,1023120,4,5,1,696028,In > Out
Feb 2020,54,70,250,11785206,614055420,625840626,68,247,2,602270214,In > Out
Feb 2020,54,71,176,8577767,310616653,319194420,80,176,2,302038886,In > Out
Feb 2020,54,72,164,9014594,436822235,445836829,74,163,2,427807641,In > Out
Feb 2020,54,73,190,11386307,539034343,550420650,80,187,2,527648036,In > Out
Feb 2020,54,74,165,10483456,528197139,538680595,38,164,2,517713683,In > Out
Feb 2020,54,76,21,4011017,332006342,336017359,11,21,2,327995325,In > Out
Feb 2020,54,77,102,2550376,139201785,141752161,28,102,2,136651409,In > Out
Feb 2020,54,79,17,2591188,176493601,179084789,9,17,1,173902413,In > Out
Feb 2020,54,80,13,2483113,137781729,140264842,7,13,1,135298616,In > Out
Feb 2020,54,81,18,2820595,236703804,239524399,8,18,1,233883209,In > Out
Feb 2020,54,82,18,2534248,204843691,207377939,10,18,1,202309443,In > Out
Feb 2020,54,83,16,3344920,256850116,260195036,9,16,1,253505196,In > Out
Feb 2020,54,84,18,2981378,224097699,227079077,9,18,1,221116321,In > Out
Feb 2020,54,85,10,852962,38837914,39690876,6,10,1,37984952,In > Out
Feb 2020,54,86,15,1986011,130400654,132386665,6,15,1,128414643,In > Out
Feb 2020,54,91,153,4685701,232592432,237278133,39,153,2,227906731,In > Out
Feb 2020,54,92,166,4979501,258689065,263668566,42,166,2,253709564,In > Out
Feb 2020,54,93,111,2604395,85858630,88463025,44,111,2,83254235,In > Out
Feb 2020,54,95,116,2727976,95815529,98543505,59,115,2,93087553,In > Out
Feb 2020,54,96,97,2497158,139748751,142245909,18,97,2,137251593,In > Out
Feb 2020,54,97,140,4006555,173917700,177924255,42,139,2,169911145,In > Out
Feb 2020,54,98,107,3109828,125219414,128329242,46,107,2,122109586,In > Out
Feb 2020,54,99,118,6316266,183577412,189893678,48,118,2,177261146,In > Out
Feb 2020,55,100,670,54667230,919326219,973993449,196,670,2,864658989,In > Out
Feb 2020,55,104,955,986611587,6204961580,7191573167,191,927,4,5218349993,In > Out
Feb 2020,55,106,473,58217411,373043478,431260889,86,466,3,314826067,In > Out
Feb 2020,55,114,155,6048664,61418063,67466727,82,153,3,55369399,In > Out
Feb 2020,55,121,408,52874224,277388701,330262925,166,404,3,224514477,In > Out
Feb 2020,55,13,29,1549386,159747778,161297164,15,29,2,158198392,In > Out
Feb 2020,55,130,1,97406,10932132,11029538,1,1,1,10834726,In > Out
Feb 2020,55,72,11,327093,4575403,4902496,5,11,2,4248310,In > Out
Feb 2020,55,96,187,2040015,32314332,34354347,20,187,1,30274317,In > Out
Feb 2020,56,131,4,28648772,27222448,55871220,4,4,1,1426324,Out > In
Feb 2020,56,132,1118,118396843,2941772991,3060169834,348,1094,4,2823376148,In > Out
Feb 2020,56,134,24,820991,19935716,20756707,17,24,2,19114725,In > Out
Feb 2020,56,138,110,5679700,337746796,343426496,24,110,2,332067096,In > Out
Feb 2020,56,143,3,13408,867419,880827,2,3,1,854011,In > Out
Feb 2020,56,145,233,19245311,159127551,178372862,54,233,2,139882240,In > Out
Feb 2020,56,146,2063,175051520,4955393836,5130445356,303,1981,2,4780342316,In > Out
Feb 2020,56,148,209,9519426,187761097,197280523,95,207,2,178241671,In > Out
Feb 2020,56,150,966,149141415,276375009,425516424,96,943,2,127233594,In > Out
Feb 2020,56,151,19,1453496,96436376,97889872,8,19,1,94982880,In > Out
Feb 2020,56,152,1,125676,13371,139047,1,1,1,112305,Out > In
Feb 2020,56,153,9,890772,66207366,67098138,4,9,1,65316594,In > Out
Feb 2020,56,154,794,57546399,1544017705,1601564104,135,772,3,1486471306,In > Out
Feb 2020,56,155,181,3452132,143403148,146855280,36,181,2,139951016,In > Out
Feb 2020,56,157,56,23878500,992698424,1016576924,33,53,2,968819924,In > Out
Feb 2020,56,161,1107,55923485,1518519626,1574443111,245,1062,5,1462596141,In > Out
Feb 2020,56,162,3,45415,590626,636041,2,3,2,545211,In > Out
Feb 2020,56,163,50,1032488,32874531,33907019,34,50,2,31842043,In > Out
Feb 2020,56,164,209,7028858,713878107,720906965,28,209,2,706849249,In > Out
Feb 2020,56,166,98,12953231,395294482,408247713,50,98,2,382341251,In > Out
Feb 2020,56,169,899,17235226,351717541,368952767,55,899,2,334482315,In > Out
Feb 2020,56,172,542,52370677,360773273,413143950,187,538,2,308402596,In > Out
Feb 2020,56,177,2169,90950687,2938397795,3029348482,504,2069,3,2847447108,In > Out
Feb 2020,56,181,279,35046857,477186566,512233423,131,279,2,442139709,In > Out
Feb 2020,56,182,149,30202518,277185116,307387634,44,149,2,246982598,In > Out
Feb 2020,56,190,466,23552235,1975650496,1999202731,113,460,2,1952098261,In > Out
Feb 2020,56,194,96,12706502,8516562,21223064,6,5,2,4189940,Out > In
Feb 2020,56,196,518,53942788,247535800,301478588,95,505,2,193593012,In > Out
Feb 2020,56,199,189,2449217,25123359,27572576,13,189,1,22674142,In > Out
Feb 2020,56,221,600,23523896,683782780,707306676,192,583,2,660258884,In > Out
Feb 2020,56,223,219,22953031,437120043,460073074,63,218,3,414167012,In > Out
Feb 2020,56,224,167,8253355,255641994,263895349,65,167,2,247388639,In > Out
Feb 2020,56,225,115,8728936,154843792,163572728,52,115,3,146114856,In > Out
Feb 2020,56,226,131,8590720,110283157,118873877,45,131,2,101692437,In > Out
Feb 2020,56,228,8,606238,65435832,66042070,3,8,2,64829594,In > Out
Feb 2020,56,229,8,920482,127466181,128386663,8,8,2,126545699,In > Out
Feb 2020,56,230,9,2367965,113058050,115426015,4,9,2,110690085,In > Out
Feb 2020,56,232,60,2899898,96093577,98993475,34,60,2,93193679,In > Out
Feb 2020,56,235,120,7728591,250404496,258133087,57,120,2,242675905,In > Out
Feb 2020,56,236,94,11695499,27347778,39043277,46,94,2,15652279,In > Out
Feb 2020,56,240,82,3676757,165155578,168832335,39,82,2,161478821,In > Out
Feb 2020,56,241,335,44391162,836390731,880781893,141,332,2,791999569,In > Out
Feb 2020,56,242,3713,2966700345,9917045953,12883746298,281,3443,4,6950345608,In > Out
Feb 2020,56,243,63,3296255,263045781,266342036,25,62,2,259749526,In > Out
Feb 2020,56,244,985,278463078,24831646363,25110109441,157,960,2,24553183285,In > Out
Feb 2020,56,247,1441,304502384,288300199,592802583,111,1355,2,16202185,Out > In
Feb 2020,56,249,103,241535709,392996178,634531887,65,102,5,151460469,In > Out
Feb 2020,56,250,61,1659628,87911420,89571048,16,61,2,86251792,In > Out
Feb 2020,56,252,269,50653117,382911220,433564337,116,266,2,332258103,In > Out
Feb 2020,56,253,313,11617573,901815301,913432874,107,313,2,890197728,In > Out
Feb 2020,57,134,108,4217054,202429680,206646734,15,108,2,198212626,In > Out
Feb 2020,57,135,2,247876,111080,358956,2,2,1,136796,Out > In
Feb 2020,57,138,2,315316,33117,348433,2,2,1,282199,Out > In
Feb 2020,57,140,26,419221,27043182,27462403,12,26,2,26623961,In > Out
Feb 2020,57,148,219,48447193,272198296,320645489,77,219,3,223751103,In > Out
Feb 2020,57,150,81,3543625,126846553,130390178,27,81,2,123302928,In > Out
Feb 2020,57,159,15,427429,5775273,6202702,12,15,2,5347844,In > Out
Feb 2020,57,160,28,762771,38189774,38952545,12,28,2,37427003,In > Out
Feb 2020,57,170,20,1139526,4610155,5749681,14,20,2,3470629,In > Out
Feb 2020,57,171,1,4655,330137,334792,1,1,1,325482,In > Out
Feb 2020,57,172,44,2161291,101302032,103463323,16,43,2,99140741,In > Out
Feb 2020,57,174,25,3691065,123701199,127392264,8,25,1,120010134,In > Out
Feb 2020,57,175,21,1432279,57603271,59035550,11,21,2,56170992,In > Out
Feb 2020,57,176,24,1239137,52313148,53552285,12,24,2,51074011,In > Out
Feb 2020,57,179,21,372948,22658025,23030973,11,21,2,22285077,In > Out
Feb 2020,57,180,272,2316640293,46482397,2363122690,11,272,4,2270157896,Out > In
Feb 2020,57,182,3,107254,1586118,1693372,3,3,1,1478864,In > Out
Feb 2020,57,184,7,661860,2682854,3344714,4,7,2,2020994,In > Out
Feb 2020,57,186,1,20621,810071,830692,1,1,1,789450,In > Out
Feb 2020,57,2,20,7921621,395233197,403154818,7,20,2,387311576,In > Out
Feb 2020,58,209,638,52235173,523116949,575352122,243,601,3,470881776,In > Out
Feb 2020,58,212,290,18255741,224727795,242983536,98,286,3,206472054,In > Out
Feb 2020,58,218,138,5360296,99462778,104823074,64,137,2,94102482,In > Out
Feb 2020,58,219,18,292128,18479407,18771535,12,18,2,18187279,In > Out
Feb 2020,58,220,506,54020442,311631717,365652159,163,505,2,257611275,In > Out
Feb 2020,58,222,62,3262745,302407882,305670627,15,62,2,299145137,In > Out
Feb 2020,58,224,130,3438999,35373010,38812009,38,130,2,31934011,In > Out
Feb 2020,58,234,746,660946280,1467140553,2128086833,214,719,8,806194273,In > Out
Feb 2020,58,237,591,30063097,4058516318,4088579415,198,582,3,4028453221,In > Out
Feb 2020,59,16,782,155484256,140437493,295921749,30,776,2,15046763,Out > In
Feb 2020,59,18,72,1655089236,427200106,2082289342,33,52,70,1227889130,Out > In
Feb 2020,59,19,733,443009936,139610192,582620128,20,726,1,303399744,Out > In
Feb 2020,59,20,65,637664,58081068,58718732,10,65,1,57443404,In > Out
Feb 2020,59,21,73,1603163563,586140446,2189304009,50,59,70,1017023117,Out > In
Feb 2020,6,132,10,1103465,39600748,40704213,3,9,1,38497283,In > Out
Feb 2020,6,153,611,44575444,266436909,311012353,209,603,2,221861465,In > Out
Feb 2020,6,164,10,168946,9397967,9566913,6,10,2,9229021,In > Out
Feb 2020,6,29,194,18222257,68303353,86525610,94,193,2,50081096,In > Out
Feb 2020,6,4,1025,131917155,538232146,670149301,332,990,2,406314991,In > Out
Feb 2020,6,43,76,3991111,246247471,250238582,14,75,2,242256360,In > Out
Feb 2020,6,45,119,14783463,572966798,587750261,80,119,4,558183335,In > Out
Feb 2020,6,5,673,102512228,327797046,430309274,175,666,2,225284818,In > Out
Feb 2020,6,6,598,66535874,1203745221,1270281095,217,586,2,1137209347,In > Out
Feb 2020,6,8,38,944823,37438551,38383374,13,38,2,36493728,In > Out
Feb 2020,63,109,233,148556649,796602252,945158901,110,233,2,648045603,In > Out
Feb 2020,63,112,97,6194298,113404235,119598533,49,97,2,107209937,In > Out
Feb 2020,63,126,1699,101411463,880133332,981544795,85,1627,2,778721869,In > Out
Feb 2020,63,127,112,10609118,219587652,230196770,53,112,2,208978534,In > Out
Feb 2020,63,147,96,880732,20187398,21068130,6,96,3,19306666,In > Out
Feb 2020,63,149,644,59903226,675852648,735755874,195,632,3,615949422,In > Out
Feb 2020,63,153,159,6550899,353166215,359717114,23,158,2,346615316,In > Out
Feb 2020,63,186,1722,90810033,764969519,855779552,82,1664,2,674159486,In > Out
Feb 2020,63,22,425,34032483,742816691,776849174,143,422,2,708784208,In > Out
Feb 2020,63,223,250,30050663,187945293,217995956,125,247,2,157894630,In > Out
Feb 2020,63,27,49,6381679,32997019,39378698,31,49,2,26615340,In > Out
Feb 2020,63,31,746,82377927,550181744,632559671,199,745,3,467803817,In > Out
Feb 2020,63,38,171,33771076,2544258013,2578029089,30,170,2,2510486937,In > Out
Feb 2020,63,46,12,292222,8197215,8489437,5,12,2,7904993,In > Out
Feb 2020,65,112,149,4157977,85217118,89375095,67,148,2,81059141,In > Out
Feb 2020,65,124,2,10464,1084980,1095444,2,2,1,1074516,In > Out
Feb 2020,65,134,205,12152156,108963987,121116143,121,201,2,96811831,In > Out
Feb 2020,65,142,90,5102523,65657946,70760469,53,89,3,60555423,In > Out
Feb 2020,65,145,173,11237614,117090247,128327861,87,173,2,105852633,In > Out
Feb 2020,65,149,347,48252160,507596061,555848221,156,342,2,459343901,In > Out
Feb 2020,65,159,6,105301,2331118,2436419,6,6,2,2225817,In > Out
Feb 2020,65,165,175,6375268,84736073,91111341,94,174,2,78360805,In > Out
Feb 2020,65,17,300,16482730,280497784,296980514,127,298,2,264015054,In > Out
Feb 2020,65,177,253,11254697,239447593,250702290,93,252,3,228192896,In > Out
Feb 2020,65,18,675,218398437,944489793,1162888230,251,665,2,726091356,In > Out
Feb 2020,65,187,26,2543457,25112446,27655903,11,25,2,22568989,In > Out
Feb 2020,65,21,37,357662927,36244674,393907601,4,37,3,321418253,Out > In
Feb 2020,65,219,8,160437,1387609,1548046,8,8,2,1227172,In > Out
Feb 2020,65,226,1303,683740656,2855131918,3538872574,115,881,392,2171391262,In > Out
Feb 2020,65,23,24,123961722,208433682,332395404,6,24,3,84471960,In > Out
Feb 2020,65,25,22,590260,10114188,10704448,8,22,2,9523928,In > Out
Feb 2020,65,32,172,11122065,375879161,387001226,96,170,4,364757096,In > Out
Feb 2020,65,38,32,83242218,15900380,99142598,16,32,1,67341838,Out > In
Feb 2020,65,41,348,18246630,513376268,531622898,103,346,2,495129638,In > Out
Feb 2020,65,44,1490,241270539,36392788371,36634058910,389,1453,2,36151517832,In > Out
Feb 2020,65,45,2,6975,286107,293082,2,2,2,279132,In > Out
Feb 2020,65,58,246,10264527,456197766,466462293,61,245,3,445933239,In > Out
Feb 2020,65,76,390,24563915,785269051,809832966,146,387,2,760705136,In > Out
Feb 2020,65,78,570,59580438,741357907,800938345,181,559,3,681777469,In > Out
Feb 2020,65,83,2,368830,11758781,12127611,2,2,1,11389951,In > Out
Feb 2020,65,90,534,106368217,618743549,725111766,162,524,4,512375332,In > Out
Feb 2020,65,91,601,53016668,1095414719,1148431387,221,595,2,1042398051,In > Out
Feb 2020,65,97,217,126891624,456393562,583285186,94,217,4,329501938,In > Out
Feb 2020,65,99,840,782748092,511305344,1294053436,167,824,3,271442748,Out > In
Feb 2020,7,107,682,34399132,1279385793,1313784925,218,670,2,1244986661,In > Out
Feb 2020,7,108,43,1103639,29522697,30626336,22,43,2,28419058,In > Out
Feb 2020,7,11,372,78669320,629651804,708321124,136,371,3,550982484,In > Out
Feb 2020,7,119,15064,31881086542,37355582482,69236669024,1985,11709,25,5474495940,In > Out
Feb 2020,7,12,1028,268966912,1168001214,1436968126,126,991,3,899034302,In > Out
Feb 2020,7,129,198,3932177,172955958,176888135,21,197,2,169023781,In > Out
Feb 2020,7,15,222,7804910,440310097,448115007,71,220,3,432505187,In > Out
Feb 2020,7,165,26,870796,31662391,32533187,4,26,2,30791595,In > Out
Feb 2020,7,172,524,684229990,4781395507,5465625497,65,509,2,4097165517,In > Out
Feb 2020,7,186,19,574073,4964056,5538129,5,19,2,4389983,In > Out
Feb 2020,7,202,1617,1345252219,1672002918,3017255137,294,1539,3,326750699,In > Out
Feb 2020,7,208,30,1525331,79811491,81336822,11,30,2,78286160,In > Out
Feb 2020,7,213,181,2807733,268399202,271206935,13,175,2,265591469,In > Out
Feb 2020,7,234,79,1929057,131140643,133069700,15,78,2,129211586,In > Out
Feb 2020,7,240,752,39597696,715316942,754914638,231,735,2,675719246,In > Out
Feb 2020,7,247,31,997831,49655987,50653818,10,31,2,48658156,In > Out
Feb 2020,7,26,893,19395980,171770065,191166045,13,893,2,152374085,In > Out
Feb 2020,7,35,149,1206032,18068709,19274741,6,149,1,16862677,In > Out
Feb 2020,7,47,22,178437,7729060,7907497,3,22,1,7550623,In > Out
Feb 2020,7,49,234,14560615,222651133,237211748,101,234,2,208090518,In > Out
Feb 2020,7,56,561,68951176,286627328,355578504,159,558,2,217676152,In > Out
Feb 2020,7,58,14,1228465,56064906,57293371,10,14,2,54836441,In > Out
Feb 2020,7,69,14,80535,2598185,2678720,3,14,1,2517650,In > Out
Feb 2020,7,77,1,69010,38621,107631,1,1,1,30389,Out > In
Feb 2020,7,8,1010,131113281,1284123721,1415237002,207,975,5,1153010440,In > Out
Feb 2020,7,84,761,120820706,1868878683,1989699389,231,761,2,1748057977,In > Out
Feb 2020,7,90,815,52956039,449930511,502886550,158,808,2,396974472,In > Out
Feb 2020,7,91,4,46332,1347269,1393601,2,4,1,1300937,In > Out
Feb 2020,70,10,412,38845275,1665361682,1704206957,147,396,7,1626516407,In > Out
Feb 2020,70,100,2157,453808902,8100564350,8554373252,427,2073,9,7646755448,In > Out
Feb 2020,70,101,582,102134597,3562445737,3664580334,220,572,3,3460311140,In > Out
Feb 2020,70,103,474,76744546,1968520909,2045265455,172,469,5,1891776363,In > Out
Feb 2020,70,104,1406,923367112,4389290153,5312657265,273,1368,12,3465923041,In > Out
Feb 2020,70,106,492,1594883580,2251144613,3846028193,167,487,10,656261033,In > Out
Feb 2020,70,107,927,78106079,2247636638,2325742717,225,888,2,2169530559,In > Out
Feb 2020,70,108,598,229615627,4359099774,4588715401,222,589,4,4129484147,In > Out
Feb 2020,70,11,472,107429881,3127620150,3235050031,156,463,7,3020190269,In > Out
Feb 2020,70,113,996,473414598,7384853312,7858267910,265,980,19,6911438714,In > Out
Feb 2020,70,114,1864,382732057,8010590204,8393322261,413,1800,6,7627858147,In > Out
Feb 2020,70,115,758,109356778,1647041236,1756398014,238,736,4,1537684458,In > Out
Feb 2020,70,121,1240,334952195,4674699789,5009651984,420,1182,6,4339747594,In > Out
Feb 2020,70,122,192,110227208,7821080085,7931307293,88,192,3,7710852877,In > Out
Feb 2020,70,124,480,290482524,2924306580,3214789104,150,471,12,2633824056,In > Out
Feb 2020,70,125,1128,190718929,15522130148,15712849077,315,1107,7,15331411219,In > Out
Feb 2020,70,128,508,56124741,1190436023,1246560764,189,500,10,1134311282,In > Out
Feb 2020,70,13,494,178998062,3012571122,3191569184,142,491,6,2833573060,In > Out
Feb 2020,70,131,1431,148933497,4468831599,4617765096,327,1367,13,4319898102,In > Out
Feb 2020,70,134,2134,524110589,7239949276,7764059865,418,1753,117,6715838687,In > Out
Feb 2020,70,135,590,1344063545,2929743681,4273807226,255,583,9,1585680136,In > Out
Feb 2020,70,136,1160,275206127,5783433975,6058640102,248,1124,10,5508227848,In > Out
Feb 2020,70,138,867,189419605,3123998679,3313418284,299,844,8,2934579074,In > Out
Feb 2020,70,139,564,83844765,1275345438,1359190203,132,561,4,1191500673,In > Out
Feb 2020,70,14,1170,174026203,5659183937,5833210140,211,1159,5,5485157734,In > Out
Feb 2020,70,140,1081,185142988,9011057285,9196200273,249,1060,9,8825914297,In > Out
Feb 2020,70,142,1326,183869394,8100465498,8284334892,274,1286,7,7916596104,In > Out
Feb 2020,70,143,422,275360265,6805360947,7080721212,111,419,5,6530000682,In > Out
Feb 2020,70,146,889,124448798,4072804818,4197253616,216,887,4,3948356020,In > Out
Feb 2020,70,148,370,211345176,11019011969,11230357145,167,364,7,10807666793,In > Out
Feb 2020,70,149,1704,258953427,6089626806,6348580233,318,1587,51,5830673379,In > Out
Feb 2020,70,15,1114,1403804841,3274483879,4678288720,266,1084,15,1870679038,In > Out
Feb 2020,70,151,2439,582680874,15849158615,16431839489,303,2304,2,15266477741,In > Out
Feb 2020,70,158,1697,353674155,3668219176,4021893331,468,1689,10,3314545021,In > Out
Feb 2020,70,159,582,155009102,7108458908,7263468010,265,578,6,6953449806,In > Out
Feb 2020,70,165,1623,222158762,9542550026,9764708788,381,1546,11,9320391264,In > Out
Feb 2020,70,166,940,279489859,3014818503,3294308362,240,925,4,2735328644,In > Out
Feb 2020,70,168,1098,122453287,5517799292,5640252579,312,1091,5,5395346005,In > Out
Feb 2020,70,169,1059,295442727,2045325783,2340768510,272,1037,6,1749883056,In > Out
Feb 2020,70,171,633,94325179,3730924193,3825249372,270,617,10,3636599014,In > Out
Feb 2020,70,174,1466,236674578,3748397946,3985072524,251,1401,16,3511723368,In > Out
Feb 2020,70,175,1224,158717163,7939179807,8097896970,382,1036,125,7780462644,In > Out
Feb 2020,70,177,435,122445167,5980429076,6102874243,139,432,2,5857983909,In > Out
Feb 2020,70,178,653,143371323,4409470654,4552841977,172,639,6,4266099331,In > Out
Feb 2020,70,179,445,191393363,4429777568,4621170931,186,443,4,4238384205,In > Out
Feb 2020,70,18,447,110503838,1286591405,1397095243,188,439,6,1176087567,In > Out
Feb 2020,70,181,788,316003590,7603766959,7919770549,237,781,4,7287763369,In > Out
Feb 2020,70,183,883,229646675,10552520767,10782167442,309,863,5,10322874092,In > Out
Feb 2020,70,187,1428,401131033,4398858467,4799989500,357,1394,19,3997727434,In > Out
Feb 2020,70,188,295,70416569,2150473221,2220889790,116,294,6,2080056652,In > Out
Feb 2020,70,189,851,671209484,35597663878,36268873362,243,836,5,34926454394,In > Out
Feb 2020,70,19,657,96716354,1245605441,1342321795,271,650,3,1148889087,In > Out
Feb 2020,70,192,345,184513119,1249385375,1433898494,127,344,5,1064872256,In > Out
Feb 2020,70,193,1287,443622865,10207952466,10651575331,315,1236,14,9764329601,In > Out
Feb 2020,70,196,976,194026036,3731760181,3925786217,281,948,3,3537734145,In > Out
Feb 2020,70,197,626,49063964,909959748,959023712,182,624,5,860895784,In > Out
Feb 2020,70,199,331,371433922,847086368,1218520290,124,329,4,475652446,In > Out
Feb 2020,70,20,1404,203071656,2694117692,2897189348,366,1370,7,2491046036,In > Out
Feb 2020,70,200,1490,235744479,7905828778,8141573257,313,1454,5,7670084299,In > Out
Feb 2020,70,201,1681,201283004,3623500069,3824783073,200,1625,7,3422217065,In > Out
Feb 2020,70,204,635,150770276,9251889761,9402660037,237,623,6,9101119485,In > Out
Feb 2020,70,206,974,211649966,5661882208,5873532174,326,944,34,5450232242,In > Out
Feb 2020,70,207,496,147567981,1339993273,1487561254,154,491,4,1192425292,In > Out
Feb 2020,70,208,802,261552154,4344363413,4605915567,295,791,7,4082811259,In > Out
Feb 2020,70,209,704,144751727,2566784549,2711536276,165,686,10,2422032822,In > Out
Feb 2020,70,21,88,16744526,607948352,624692878,43,88,4,591203826,In > Out
Feb 2020,70,210,741,437547890,1720621876,2158169766,327,717,15,1283073986,In > Out
Feb 2020,70,211,680,69909281,1349561957,1419471238,155,672,4,1279652676,In > Out
Feb 2020,70,214,1007,1168253287,3079555224,4247808511,312,905,40,1911301937,In > Out
Feb 2020,70,216,541,385957335,946522849,1332480184,204,532,5,560565514,In > Out
Feb 2020,70,217,483,111792487,1439778716,1551571203,165,482,5,1327986229,In > Out
Feb 2020,70,218,903,268295739,1610894962,1879190701,243,881,4,1342599223,In > Out
Feb 2020,70,222,632,217111267,1259763781,1476875048,213,626,8,1042652514,In > Out
Feb 2020,70,223,692,256696661,3475920717,3732617378,279,677,9,3219224056,In > Out
Feb 2020,70,23,399,1114267479,1019787911,2134055390,175,395,6,94479568,Out > In
Feb 2020,70,25,1152,126716957,2512076686,2638793643,247,1140,4,2385359729,In > Out
Feb 2020,70,26,700,91424960,4943738620,5035163580,219,693,5,4852313660,In > Out
Feb 2020,70,27,736,935160076,2690686159,3625846235,302,729,10,1755526083,In > Out
Feb 2020,70,28,1673,220144848,9359641185,9579786033,309,1595,8,9139496337,In > Out
Feb 2020,70,30,749,313975593,3721453763,4035429356,247,740,13,3407478170,In > Out
Feb 2020,70,32,451,258221574,2755692757,3013914331,183,447,4,2497471183,In > Out
Feb 2020,70,33,633,142105495,1901844459,2043949954,224,627,10,1759738964,In > Out
Feb 2020,70,34,1307,233183243,14227732906,14460916149,380,1261,12,13994549663,In > Out
Feb 2020,70,35,533,74742549,1981868444,2056610993,188,522,6,1907125895,In > Out
Feb 2020,70,37,628,56652894,1617763960,1674416854,169,618,8,1561111066,In > Out
Feb 2020,70,39,640,69584372,1957511874,2027096246,186,635,6,1887927502,In > Out
Feb 2020,70,4,366,513331932,2730415440,3243747372,160,356,12,2217083508,In > Out
Feb 2020,70,40,706,241732317,3075236403,3316968720,189,648,12,2833504086,In > Out
Feb 2020,70,43,740,371565364,7997830543,8369395907,171,717,5,7626265179,In > Out
Feb 2020,70,44,2138,442537034,6041257920,6483794954,289,2018,29,5598720886,In > Out
Feb 2020,70,45,870,294112818,16568985552,16863098370,223,857,6,16274872734,In > Out
Feb 2020,70,47,740,64135683,3137560440,3201696123,167,733,6,3073424757,In > Out
Feb 2020,70,48,1619,543332588,8683096495,9226429083,334,1591,8,8139763907,In > Out
Feb 2020,70,51,937,221803931,6620260180,6842064111,288,919,7,6398456249,In > Out
Feb 2020,70,54,277,42331970,310259489,352591459,111,276,3,267927519,In > Out
Feb 2020,70,56,1167,839930112,5166928263,6006858375,272,1133,18,4326998151,In > Out
Feb 2020,70,58,555,130285874,1857007932,1987293806,155,546,2,1726722058,In > Out
Feb 2020,70,59,1272,229088561,9343324952,9572413513,319,1251,3,9114236391,In > Out
Feb 2020,70,6,1171,73534716,2176112869,2249647585,258,1135,6,2102578153,In > Out
Feb 2020,70,61,509,91542060,1036916704,1128458764,132,506,6,945374644,In > Out
Feb 2020,70,62,359,23933146,771974743,795907889,125,358,6,748041597,In > Out
Feb 2020,70,64,388,90776989,487964132,578741121,127,388,5,397187143,In > Out
Feb 2020,70,66,1049,250669672,5201505858,5452175530,410,1023,22,4950836186,In > Out
Feb 2020,70,67,630,102081144,1948861087,2050942231,177,611,12,1846779943,In > Out
Feb 2020,70,68,888,505607710,3911966506,4417574216,232,867,8,3406358796,In > Out
Feb 2020,70,7,365,43419871,769266828,812686699,132,360,2,725846957,In > Out
Feb 2020,70,70,1314,273025357,3872028489,4145053846,400,1245,41,3599003132,In > Out
Feb 2020,70,71,284,42032910,875745606,917778516,128,283,6,833712696,In > Out
Feb 2020,70,72,968,266171760,18970340089,19236511849,352,933,6,18704168329,In > Out
Feb 2020,70,74,660,165518140,4678716462,4844234602,246,646,4,4513198322,In > Out
Feb 2020,70,75,672,58426616,763775667,822202283,273,657,22,705349051,In > Out
Feb 2020,70,76,419,33641940,580983788,614625728,155,413,4,547341848,In > Out
Feb 2020,70,77,1207,226717489,8239486431,8466203920,288,1164,9,8012768942,In > Out
Feb 2020,70,79,1457,442245256,4621551777,5063797033,303,1425,8,4179306521,In > Out
Feb 2020,70,83,622,81459599,2026270926,2107730525,190,602,10,1944811327,In > Out
Feb 2020,70,85,320,96209157,3966860698,4063069855,123,315,3,3870651541,In > Out
Feb 2020,70,89,903,521137472,1801228112,2322365584,243,888,6,1280090640,In > Out
Feb 2020,70,91,848,134137183,9002144821,9136282004,164,846,5,8868007638,In > Out
Feb 2020,70,92,358,35994759,2663447068,2699441827,130,355,3,2627452309,In > Out
Feb 2020,70,94,2250,217878155,3568490212,3786368367,465,2188,17,3350612057,In > Out
Feb 2020,70,95,504,612761085,2737445193,3350206278,142,503,6,2124684108,In > Out
Feb 2020,70,96,1407,183229392,7062468065,7245697457,203,1389,7,6879238673,In > Out
Feb 2020,72,35,6,518432,852685,1371117,1,6,1,334253,In > Out
Feb 2020,73,10,241,5617964,38831315,44449279,5,241,2,33213351,In > Out
Feb 2020,73,100,142,4579292,258662912,263242204,60,142,2,254083620,In > Out
Feb 2020,73,101,89,14354721,228292286,242647007,34,88,2,213937565,In > Out
Feb 2020,73,102,643,191086502,3410208612,3601295114,135,642,4,3219122110,In > Out
Feb 2020,73,104,1000,34618010,1076644099,1111262109,212,980,2,1042026089,In > Out
Feb 2020,73,105,194,18324382,46961991,65286373,64,193,2,28637609,In > Out
Feb 2020,73,106,2410,190897863,5114185186,5305083049,501,2228,3,4923287323,In > Out
Feb 2020,73,107,1624,82834985,2150712210,2233547195,210,1558,2,2067877225,In > Out
Feb 2020,73,108,324,17061254,184028216,201089470,134,321,2,166966962,In > Out
Feb 2020,73,109,1049,96862065,1073677394,1170539459,219,1024,2,976815329,In > Out
Feb 2020,73,11,23,3371839,350469602,353841441,11,23,2,347097763,In > Out
Feb 2020,73,111,848,40138435,564830541,604968976,297,831,2,524692106,In > Out
Feb 2020,73,113,815,140736883,1160767216,1301504099,148,801,4,1020030333,In > Out
Feb 2020,73,115,137,10573714,171712737,182286451,63,136,2,161139023,In > Out
Feb 2020,73,117,1422,97521307,1701351629,1798872936,268,1369,4,1603830322,In > Out
Feb 2020,73,12,27,29012359,828789952,857802311,18,27,2,799777593,In > Out
Feb 2020,73,120,1407,127796577,481336826,609133403,202,1367,2,353540249,In > Out
Feb 2020,73,121,301,65139599,226381253,291520852,108,298,2,161241654,In > Out
Feb 2020,73,122,68,3124258,298593630,301717888,31,68,2,295469372,In > Out
Feb 2020,73,123,61,1714925,136121248,137836173,22,61,2,134406323,In > Out
Feb 2020,73,127,2617,166110803,1486071060,1652181863,320,2440,3,1319960257,In > Out
Feb 2020,73,129,3,81194,442092,523286,2,3,2,360898,In > Out
Feb 2020,73,13,476,22833076,1002154414,1024987490,164,472,2,979321338,In > Out
Feb 2020,73,130,1602,254518018,1655127677,1909645695,98,1501,4,1400609659,In > Out
Feb 2020,73,132,3,13248,471986,485234,2,3,1,458738,In > Out
Feb 2020,73,134,652,35174056,1250724864,1285898920,193,636,2,1215550808,In > Out
Feb 2020,73,135,19,1172667,155296517,156469184,13,19,2,154123850,In > Out
Feb 2020,73,136,49,1105083,125380809,126485892,13,49,2,124275726,In > Out
Feb 2020,73,137,23,33259893,316592653,349852546,4,23,3,283332760,In > Out
Feb 2020,73,138,558,24751180,737286731,762037911,141,545,3,712535551,In > Out
Feb 2020,73,139,744,38648798,1086270557,1124919355,138,734,2,1047621759,In > Out
Feb 2020,73,14,6,180290,2215295,2395585,5,6,1,2035005,In > Out
Feb 2020,73,141,591,80641924,943991239,1024633163,166,581,2,863349315,In > Out
Feb 2020,73,142,72,6365976,134522660,140888636,16,72,4,128156684,In > Out
Feb 2020,73,143,963,106218780,1219036893,1325255673,177,936,3,1112818113,In > Out
Feb 2020,73,144,191,16303833,82837741,99141574,87,190,2,66533908,In > Out
Feb 2020,73,145,215,18599160,723926328,742525488,24,215,2,705327168,In > Out
Feb 2020,73,15,10,101821,16372361,16474182,4,10,2,16270540,In > Out
Feb 2020,73,157,13,2218070,2649547,4867617,11,9,4,431477,In > Out
Feb 2020,73,16,15,1773693,40918810,42692503,7,15,2,39145117,In > Out
Feb 2020,73,160,8,4473176,11838750,16311926,6,8,3,7365574,In > Out
Feb 2020,73,162,92,9360862,224056054,233416916,15,92,2,214695192,In > Out
Feb 2020,73,163,300,23103268,275584053,298687321,113,297,3,252480785,In > Out
Feb 2020,73,166,63,17956652,760994624,778951276,12,63,2,743037972,In > Out
Feb 2020,73,168,20,5049204,230034934,235084138,3,20,1,224985730,In > Out
Feb 2020,73,169,910,73976726,840996933,914973659,228,878,3,767020207,In > Out
Feb 2020,73,17,549,22091948,520732434,542824382,193,544,3,498640486,In > Out
Feb 2020,73,170,345,24494561,1256992491,1281487052,100,343,2,1232497930,In > Out
Feb 2020,73,172,590,50660952,2251936087,2302597039,225,583,2,2201275135,In > Out
Feb 2020,73,173,149,12856978,263257231,276114209,40,142,2,250400253,In > Out
Feb 2020,73,177,1572,90342378,2378992237,2469334615,415,1536,2,2288649859,In > Out
Feb 2020,73,18,63,1913412,143026407,144939819,13,63,2,141112995,In > Out
Feb 2020,73,181,24410,38316430103,62100930647,100417360750,2968,13423,83,23784500544,In > Out
Feb 2020,73,189,2,255939,7648944,7904883,2,2,2,7393005,In > Out
Feb 2020,73,19,13,340863,1755854,2096717,4,13,2,1414991,In > Out
Feb 2020,73,190,132,1217229,17253190,18470419,5,130,4,16035961,In > Out
Feb 2020,73,191,57,1856966,76997220,78854186,18,57,2,75140254,In > Out
Feb 2020,73,193,2,310274,16465978,16776252,2,2,2,16155704,In > Out
Feb 2020,73,195,104,1531151,12658834,14189985,4,101,3,11127683,In > Out
Feb 2020,73,196,902,250136637,12116371562,12366508199,199,883,2,11866234925,In > Out
Feb 2020,73,198,67,917898,8018264,8936162,6,67,4,7100366,In > Out
Feb 2020,73,20,12,147543,3008456,3155999,7,12,2,2860913,In > Out
Feb 2020,73,201,1281,75836517,2088229142,2164065659,175,1256,4,2012392625,In > Out
Feb 2020,73,202,13,897760,135132152,136029912,5,13,2,134234392,In > Out
Feb 2020,73,203,13,1664217,181323610,182987827,6,13,2,179659393,In > Out
Feb 2020,73,205,19,1113484,14209324,15322808,13,19,2,13095840,In > Out
Feb 2020,73,206,262,44908869,786255631,831164500,87,262,2,741346762,In > Out
Feb 2020,73,209,1,102983,2565188,2668171,1,1,1,2462205,In > Out
Feb 2020,73,211,3268,430147412,6703052933,7133200345,530,3046,8,6272905521,In > Out
Feb 2020,73,212,1,168425,4595800,4764225,1,1,1,4427375,In > Out
Feb 2020,73,213,9,466853,24012928,24479781,5,9,2,23546075,In > Out
Feb 2020,73,215,1409,97645119,1039359805,1137004924,422,1366,2,941714686,In > Out
Feb 2020,73,217,27,3906143,2766741,6672884,1,27,27,1139402,Out > In
Feb 2020,73,218,57,6401525,41544598,47946123,30,57,3,35143073,In > Out
Feb 2020,73,22,362,22069936,353025370,375095306,144,359,2,330955434,In > Out
Feb 2020,73,220,134,1359394,16623908,17983302,3,134,3,15264514,In > Out
Feb 2020,73,223,937,658273589,2378289338,3036562927,290,918,3,1720015749,In > Out
Feb 2020,73,224,20,6496441,186270874,192767315,10,19,2,179774433,In > Out
Feb 2020,73,237,936,3794414603,84028356,3878442959,462,1,632,3710386247,Out > In
Feb 2020,73,24,2,7158,277464,284622,2,2,1,270306,In > Out
Feb 2020,73,241,53,2401951,36496336,38898287,23,53,1,34094385,In > Out
Feb 2020,73,245,431,64086026,568410309,632496335,169,430,4,504324283,In > Out
Feb 2020,73,246,885,100136851,1947742560,2047879411,242,860,4,1847605709,In > Out
Feb 2020,73,247,256,31076218,2350454319,2381530537,37,252,2,2319378101,In > Out
Feb 2020,73,25,613,61225356,1118463593,1179688949,148,596,2,1057238237,In > Out
Feb 2020,73,27,1142,191981339,390250554,582231893,138,1112,3,198269215,In > Out
Feb 2020,73,28,86,37165036,84461048,121626084,33,86,3,47296012,In > Out
Feb 2020,73,3,1,5349,919313,924662,1,1,1,913964,In > Out
Feb 2020,73,30,713,85668077,316314838,401982915,162,701,4,230646761,In > Out
Feb 2020,73,31,76,224198176,51969412,276167588,55,1,24,172228764,Out > In
Feb 2020,73,32,68,188990112,40866221,229856333,56,1,26,148123891,Out > In
Feb 2020,73,33,520,59751681,1358866176,1418617857,191,513,2,1299114495,In > Out
Feb 2020,73,34,340,9726295,422720349,432446644,72,338,2,412994054,In > Out
Feb 2020,73,36,820,54837240,1579793535,1634630775,232,800,4,1524956295,In > Out
Feb 2020,73,37,167,17448216,64786048,82234264,15,167,2,47337832,In > Out
Feb 2020,73,38,2468,140411054,1274503430,1414914484,197,2282,3,1134092376,In > Out
Feb 2020,73,39,119,7208712,287407680,294616392,57,119,2,280198968,In > Out
Feb 2020,73,4,455,68729396,3652808145,3721537541,7,454,2,3584078749,In > Out
Feb 2020,73,41,1462,164881050,1055968882,1220849932,191,1418,4,891087832,In > Out
Feb 2020,73,42,9,4507897,137473563,141981460,6,8,2,132965666,In > Out
Feb 2020,73,45,945,95641499,1230258319,1325899818,368,923,3,1134616820,In > Out
Feb 2020,73,47,1344,39559131,856042537,895601668,215,1298,2,816483406,In > Out
Feb 2020,73,5,30,1002125,9765849,10767974,13,30,2,8763724,In > Out
Feb 2020,73,52,13,53868,1789816,1843684,4,13,2,1735948,In > Out
Feb 2020,73,53,26,3952381,90931042,94883423,9,26,2,86978661,In > Out
Feb 2020,73,54,1233,59979154,762786836,822765990,216,1182,4,702807682,In > Out
Feb 2020,73,55,811,49579879,1139845232,1189425111,71,786,4,1090265353,In > Out
Feb 2020,73,56,311,41351643,334186745,375538388,123,308,2,292835102,In > Out
Feb 2020,73,57,11,3079947,44623483,47703430,6,11,2,41543536,In > Out
Feb 2020,73,58,770,104441581,3506349268,3610790849,214,747,3,3401907687,In > Out
Feb 2020,73,6,27,856322,17611174,18467496,13,27,2,16754852,In > Out
Feb 2020,73,62,380,23280870,428080922,451361792,121,370,4,404800052,In > Out
Feb 2020,73,69,502,248334667,11151728789,11400063456,16,499,2,10903394122,In > Out
Feb 2020,73,7,9,43880,1489423,1533303,1,9,1,1445543,In > Out
Feb 2020,73,70,530,42320013,507369290,549689303,212,523,2,465049277,In > Out
Feb 2020,73,72,819,43194283,655429035,698623318,198,796,3,612234752,In > Out
Feb 2020,73,73,53,3284513,135229895,138514408,21,51,2,131945382,In > Out
Feb 2020,73,74,1,4694,170986,175680,1,1,1,166292,In > Out
Feb 2020,73,76,2033,83245765,1597191790,1680437555,173,1957,2,1513946025,In > Out
Feb 2020,73,77,268,5634794,151607923,157242717,4,268,2,145973129,In > Out
Feb 2020,73,78,509,74382244,768562424,842944668,132,504,4,694180180,In > Out
Feb 2020,73,79,944,154795122,1154305821,1309100943,200,920,3,999510699,In > Out
Feb 2020,73,8,8,37895,2406683,2444578,4,8,1,2368788,In > Out
Feb 2020,73,80,3169,162945833,5896204952,6059150785,232,2889,3,5733259119,In > Out
Feb 2020,73,81,2,16310,1622978,1639288,2,2,1,1606668,In > Out
Feb 2020,73,82,90,9667062,71441523,81108585,35,90,2,61774461,In > Out
Feb 2020,73,83,297,18232380,635541768,653774148,82,295,2,617309388,In > Out
Feb 2020,73,84,42,1679613,517919765,519599378,12,42,2,516240152,In > Out
Feb 2020,73,86,58,1842524,98784933,100627457,28,58,2,96942409,In > Out
Feb 2020,73,87,92,8886494,98394106,107280600,44,91,2,89507612,In > Out
Feb 2020,73,88,67,3971961,77409151,81381112,43,67,2,73437190,In > Out
Feb 2020,73,89,220,5642402,66271508,71913910,59,220,2,60629106,In > Out
Feb 2020,73,9,5,1694145,312813309,314507454,4,5,2,311119164,In > Out
Feb 2020,73,90,163,7199097,121916789,129115886,80,162,2,114717692,In > Out
Feb 2020,73,91,818,81415851,520863866,602279717,79,806,2,439448015,In > Out
Feb 2020,73,92,133,2164983,171373444,173538427,27,132,2,169208461,In > Out
Feb 2020,73,96,765,54466684,607452865,661919549,278,752,2,552986181,In > Out
Feb 2020,73,99,1022,55573403,1727246654,1782820057,289,977,3,1671673251,In > Out
Feb 2020,74,10,298,18045367,214042310,232087677,130,294,2,195996943,In > Out
Feb 2020,74,101,217,5954327,279807686,285762013,92,217,2,273853359,In > Out
Feb 2020,74,104,36,1454394,23723351,25177745,15,36,2,22268957,In > Out
Feb 2020,74,105,221,60166414,1542979520,1603145934,58,221,3,1482813106,In > Out
Feb 2020,74,106,518,34920314,292673350,327593664,249,510,2,257753036,In > Out
Feb 2020,74,107,2167,832988554,4237032735,5070021289,304,2048,7,3404044181,In > Out
Feb 2020,74,113,68,4644240,159514741,164158981,28,68,2,154870501,In > Out
Feb 2020,74,114,1323,1293599647,1568591431,2862191078,379,1240,4,274991784,In > Out
Feb 2020,74,115,62,15562788,131148919,146711707,36,62,2,115586131,In > Out
Feb 2020,74,116,27,721513,3903251,4624764,9,27,2,3181738,In > Out
Feb 2020,74,120,115,9911176,141993735,151904911,54,115,2,132082559,In > Out
Feb 2020,74,125,1383,51095950,854181876,905277826,229,1326,2,803085926,In > Out
Feb 2020,74,127,294,20995021,404136126,425131147,123,294,2,383141105,In > Out
Feb 2020,74,13,32,6388507,41384296,47772803,23,32,2,34995789,In > Out
Feb 2020,74,134,27,2275260,102834502,105109762,17,27,2,100559242,In > Out
Feb 2020,74,135,186,15443409,771506153,786949562,48,186,2,756062744,In > Out
Feb 2020,74,141,237,204436571,272401791,476838362,128,224,17,67965220,In > Out
Feb 2020,74,145,77,9820039,35360694,45180733,35,77,2,25540655,In > Out
Feb 2020,74,147,452,21043349,1005536000,1026579349,180,444,2,984492651,In > Out
Feb 2020,74,149,206,167975658,383200966,551176624,91,206,6,215225308,In > Out
Feb 2020,74,152,91,4553095,100802260,105355355,53,91,2,96249165,In > Out
Feb 2020,74,155,15,83999,8314229,8398228,12,15,1,8230230,In > Out
Feb 2020,74,156,983,469112366,2967547014,3436659380,225,964,2,2498434648,In > Out
Feb 2020,74,162,107,3144552,286769581,289914133,46,107,2,283625029,In > Out
Feb 2020,74,164,114,19401344,154940222,174341566,71,111,2,135538878,In > Out
Feb 2020,74,165,278,16417087,157218907,173635994,133,276,2,140801820,In > Out
Feb 2020,74,169,1037,163511834,3428757944,3592269778,221,982,2,3265246110,In > Out
Feb 2020,74,170,1152,12235427063,1575185968,13810613031,340,1109,4,10660241095,Out > In
Feb 2020,74,172,174,8970746,123435349,132406095,102,169,4,114464603,In > Out
Feb 2020,74,173,23,695501,33341872,34037373,4,23,2,32646371,In > Out
Feb 2020,74,175,595,26069437,181264130,207333567,172,585,2,155194693,In > Out
Feb 2020,74,177,4,70269,1918492,1988761,4,4,1,1848223,In > Out
Feb 2020,74,179,2438,563568586,4477027631,5040596217,478,2282,5,3913459045,In > Out
Feb 2020,74,182,7,420714,6986967,7407681,6,7,2,6566253,In > Out
Feb 2020,74,183,471,70978712,735645798,806624510,140,464,2,664667086,In > Out
Feb 2020,74,184,200,11639321,219474770,231114091,88,198,2,207835449,In > Out
Feb 2020,74,186,179,51661394,75541594,127202988,63,178,2,23880200,In > Out
Feb 2020,74,195,169,4140146,153930330,158070476,20,169,2,149790184,In > Out
Feb 2020,74,198,318,28922628,545046506,573969134,104,316,3,516123878,In > Out
Feb 2020,74,20,240,19307787,151314251,170622038,98,239,2,132006464,In > Out
Feb 2020,74,200,920,122843344,916044174,1038887518,228,902,2,793200830,In > Out
Feb 2020,74,202,488,76688521,2231575756,2308264277,195,479,4,2154887235,In > Out
Feb 2020,74,203,107,26543791,330712122,357255913,50,106,3,304168331,In > Out
Feb 2020,74,205,84,3557205,115990062,119547267,27,84,2,112432857,In > Out
Feb 2020,74,206,4406,81172935091,12584497871,93757432962,483,1765,256,68588437220,Out > In
Feb 2020,74,207,535,62383563,2877335164,2939718727,155,532,2,2814951601,In > Out
Feb 2020,74,21,818,76539403,1103386523,1179925926,162,809,3,1026847120,In > Out
Feb 2020,74,210,433,71243056,1120979599,1192222655,128,425,3,1049736543,In > Out
Feb 2020,74,211,33,6877999,18086220,24964219,18,33,1,11208221,In > Out
Feb 2020,74,213,33,27185612,271932884,299118496,26,32,3,244747272,In > Out
Feb 2020,74,214,84,7834471,114945137,122779608,38,82,2,107110666,In > Out
Feb 2020,74,215,1498,125130059,2965757200,3090887259,393,1407,3,2840627141,In > Out
Feb 2020,74,216,3,565974,40001,605975,2,3,1,525973,Out > In
Feb 2020,74,218,30,825611,16281328,17106939,21,30,2,15455717,In > Out
Feb 2020,74,222,951,111425275,485172752,596598027,158,925,2,373747477,In > Out
Feb 2020,74,229,205,11399379,245463156,256862535,106,204,2,234063777,In > Out
Feb 2020,74,23,21,429489,12176738,12606227,1,21,1,11747249,In > Out
Feb 2020,74,230,6,68022,3205790,3273812,4,6,1,3137768,In > Out
Feb 2020,74,233,263,23513285,221328268,244841553,113,258,3,197814983,In > Out
Feb 2020,74,235,1339,126612944,682560597,809173541,261,1292,2,555947653,In > Out
Feb 2020,74,238,20,32661767,838894460,871556227,14,20,2,806232693,In > Out
Feb 2020,74,24,378,58245306,184558732,242804038,83,374,2,126313426,In > Out
Feb 2020,74,240,217,26621255,210924886,237546141,101,214,4,184303631,In > Out
Feb 2020,74,247,32,2084980,103721188,105806168,22,32,2,101636208,In > Out
Feb 2020,74,251,305,77133773,181979374,259113147,108,304,2,104845601,In > Out
Feb 2020,74,28,1,6840,589570,596410,1,1,1,582730,In > Out
Feb 2020,74,36,1,94282,11438,105720,1,1,1,82844,Out > In
Feb 2020,74,39,275,9818636,324057932,333876568,72,265,2,314239296,In > Out
Feb 2020,74,40,150,11892621,160217653,172110274,64,150,2,148325032,In > Out
Feb 2020,74,41,183,48665747,1454009779,1502675526,32,182,3,1405344032,In > Out
Feb 2020,74,43,305,16873287,384946207,401819494,166,301,2,368072920,In > Out
Feb 2020,74,44,276,9951901,694622919,704574820,45,275,2,684671018,In > Out
Feb 2020,74,45,90,12996113,8985942,21982055,7,6,2,4010171,Out > In
Feb 2020,74,47,34,734844,27206550,27941394,27,34,2,26471706,In > Out
Feb 2020,74,50,837,129206419,206656044,335862463,146,816,2,77449625,In > Out
Feb 2020,74,52,35,31726684,10694955,42421639,25,8,17,21031729,Out > In
Feb 2020,74,57,94,5924034,146367762,152291796,38,94,2,140443728,In > Out
Feb 2020,74,58,290,25029306,144268692,169297998,133,289,1,119239386,In > Out
Feb 2020,74,61,807,57092368,1726683198,1783775566,210,788,4,1669590830,In > Out
Feb 2020,74,64,950,30990376109,3363330709,34353706818,328,928,2,27627045400,Out > In
Feb 2020,74,65,44,1902292,96043747,97946039,19,44,2,94141455,In > Out
Feb 2020,74,67,468,24431300,98757252,123188552,99,460,2,74325952,In > Out
Feb 2020,74,70,56,2261233,395558458,397819691,20,56,2,393297225,In > Out
Feb 2020,74,72,51,4252660,82108190,86360850,29,51,3,77855530,In > Out
Feb 2020,74,73,828,40583679,825305750,865889429,222,809,2,784722071,In > Out
Feb 2020,74,74,121,34075119,30588593,64663712,11,120,2,3486526,Out > In
Feb 2020,74,75,96,2696538,68936326,71632864,37,96,2,66239788,In > Out
Feb 2020,74,78,68,2416500,252992321,255408821,17,68,2,250575821,In > Out
Feb 2020,74,79,579,85799595,3451232969,3537032564,129,560,4,3365433374,In > Out
Feb 2020,74,88,63,2863815,58458214,61322029,41,63,2,55594399,In > Out
Feb 2020,74,89,9,128303,2834349,2962652,5,9,1,2706046,In > Out
Feb 2020,74,94,53,4412266,14195195,18607461,24,53,1,9782929,In > Out
Feb 2020,75,144,191,43559459,69080349,112639808,31,190,3,25520890,In > Out
Feb 2020,75,187,26,504231,28612879,29117110,6,26,2,28108648,In > Out
Feb 2020,75,192,159,28195630,485188019,513383649,57,159,2,456992389,In > Out
Feb 2020,75,213,1602,126764728,1623177211,1749941939,178,1563,2,1496412483,In > Out
Feb 2020,75,36,2,48850,2081856,2130706,2,2,1,2033006,In > Out
Feb 2020,77,121,32,1494056,3966216,5460272,5,4,2,2472160,In > Out
Feb 2020,77,122,905,154006587,317431513,471438100,5,6,2,163424926,In > Out
Feb 2020,77,123,7,172838,1928008,2100846,1,7,1,1755170,In > Out
Feb 2020,77,134,13,25996,1462652,1488648,1,13,1,1436656,In > Out
Feb 2020,77,231,2902,308733408,7805844989,8114578397,596,2737,14,7497111581,In > Out
Feb 2020,79,10,2,437504,24536,462040,1,2,1,412968,Out > In
Feb 2020,79,11,649,67578914,6187287685,6254866599,30,642,19,6119708771,In > Out
Feb 2020,79,14,29579,19649068871,864022369849,883671438720,2625,12442,19,844373300978,In > Out
Feb 2020,79,9,144,2564539,310342406,312906945,7,144,1,307777867,In > Out
Feb 2020,80,10,2487,231107923,12174192148,12405300071,395,2355,2,11943084225,In > Out
Feb 2020,80,111,420,40770010,285451551,326221561,109,417,3,244681541,In > Out
Feb 2020,80,133,42,2894526,68198974,71093500,12,42,2,65304448,In > Out
Feb 2020,80,136,137,13447911,475237643,488685554,72,137,5,461789732,In > Out
Feb 2020,80,149,160,12730523,319075984,331806507,80,149,5,306345461,In > Out
Feb 2020,80,224,262,32779084,989133115,1021912199,117,252,12,956354031,In > Out
Feb 2020,80,51,1768,274477118,4691184536,4965661654,445,1726,3,4416707418,In > Out
Feb 2020,80,93,77,5615919,185490130,191106049,39,77,2,179874211,In > Out
Feb 2020,81,139,34,6498113,451642,6949755,1,34,1,6046471,Out > In
Feb 2020,81,26,17,467119857,14087958,481207815,2,17,2,453031899,Out > In
Feb 2020,81,29,3,483465,45215,528680,1,3,1,438250,Out > In
Feb 2020,81,30,14,213052637,7389008,220441645,6,14,2,205663629,Out > In
Feb 2020,81,31,31,373189926,11554879,384744805,4,31,2,361635047,Out > In
Feb 2020,81,32,9,11074980,569719,11644699,3,9,2,10505261,Out > In
Feb 2020,81,33,3,745648,131202,876850,1,3,1,614446,Out > In
Feb 2020,81,35,96,9794927,1068968062,1078762989,25,96,2,1059173135,In > Out
Feb 2020,81,45,145,37510917,13106012,50616929,7,145,3,24404905,Out > In
Feb 2020,81,76,7,1290930,724407,2015337,3,7,1,566523,Out > In
Feb 2020,82,10,18,182516469,8867907,191384376,9,18,1,173648562,Out > In
Feb 2020,82,100,29,2898996,18075032,20974028,22,29,2,15176036,In > Out
Feb 2020,82,103,484,33587528,3365933308,3399520836,32,484,2,3332345780,In > Out
Feb 2020,82,104,13,189544,5712745,5902289,5,13,1,5523201,In > Out
Feb 2020,82,109,26,484088,28944521,29428609,8,26,2,28460433,In > Out
Feb 2020,82,115,437,17930659,878915415,896846074,23,436,2,860984756,In > Out
Feb 2020,82,116,822,173085090,3279407659,3452492749,229,813,4,3106322569,In > Out
Feb 2020,82,125,24,741692,29381142,30122834,16,24,2,28639450,In > Out
Feb 2020,82,128,195,8986105,883885061,892871166,49,195,2,874898956,In > Out
Feb 2020,82,129,173,22266412,621259667,643526079,57,170,2,598993255,In > Out
Feb 2020,82,137,74,6600394,227918532,234518926,24,74,2,221318138,In > Out
Feb 2020,82,141,369,45460433,820163150,865623583,129,369,2,774702717,In > Out
Feb 2020,82,142,1232,120298171,2050974850,2171273021,402,1189,2,1930676679,In > Out
Feb 2020,82,145,2,120184,457183,577367,2,2,2,336999,In > Out
Feb 2020,82,149,163,3786881,230784120,234571001,92,163,2,226997239,In > Out
Feb 2020,82,151,535,24505981,141848002,166353983,129,521,16,117342021,In > Out
Feb 2020,82,152,215,25342177,1122087428,1147429605,85,215,3,1096745251,In > Out
Feb 2020,82,162,1007,73644130,2916802446,2990446576,257,984,5,2843158316,In > Out
Feb 2020,82,208,24,878353,8323510,9201863,14,24,2,7445157,In > Out
Feb 2020,82,22,76,2284983,53197710,55482693,55,76,1,50912727,In > Out
Feb 2020,82,224,712,21355804,574980517,596336321,119,712,2,553624713,In > Out
Feb 2020,82,225,2,100686,2709914,2810600,2,2,2,2609228,In > Out
Feb 2020,82,231,3,1019704,780250,1799954,3,3,2,239454,Out > In
Feb 2020,82,235,51,451693,91117322,91569015,16,51,2,90665629,In > Out
Feb 2020,82,237,13,611125,24438141,25049266,3,13,1,23827016,In > Out
Feb 2020,82,239,9,41441,1262266,1303707,6,9,1,1220825,In > Out
Feb 2020,82,3,3,185423,10371523,10556946,3,3,1,10186100,In > Out
Feb 2020,82,44,131,12302022,62899567,75201589,20,131,2,50597545,In > Out
Feb 2020,82,53,420,22364515,790080131,812444646,34,420,2,767715616,In > Out
Feb 2020,82,54,1538,43371814,2708372619,2751744433,217,1482,2,2665000805,In > Out
Feb 2020,82,56,1202,126810382,9021805844,9148616226,359,1164,9,8894995462,In > Out
Feb 2020,82,57,10,1794799,21012535,22807334,9,10,2,19217736,In > Out
Feb 2020,82,58,16,657649,6265145,6922794,10,16,2,5607496,In > Out
Feb 2020,82,60,66,1656994,34853340,36510334,36,66,2,33196346,In > Out
Feb 2020,82,61,11,1502471,50346239,51848710,7,11,2,48843768,In > Out
Feb 2020,82,74,182,29383266,169184274,198567540,77,181,2,139801008,In > Out
Feb 2020,82,82,61,1914459,131326170,133240629,32,61,2,129411711,In > Out
Feb 2020,82,83,39,4444425,2857767,7302192,6,39,2,1586658,Out > In
Feb 2020,82,85,16,10834373,76939601,87773974,9,16,2,66105228,In > Out
Feb 2020,82,86,13,1529745,3466988,4996733,11,13,2,1937243,In > Out
Feb 2020,82,87,357,32171374,688669530,720840904,130,355,2,656498156,In > Out
Feb 2020,82,92,384,34568620,452040346,486608966,157,381,4,417471726,In > Out
Feb 2020,82,93,4,546098,986083,1532181,4,4,2,439985,In > Out
Feb 2020,83,107,1319,76720315,1032896464,1109616779,379,1285,2,956176149,In > Out
Feb 2020,83,109,365,25560115,334706048,360266163,139,364,3,309145933,In > Out
Feb 2020,83,112,325,30793521,1637494143,1668287664,161,323,4,1606700622,In > Out
Feb 2020,83,113,354,32261992,141061555,173323547,101,352,2,108799563,In > Out
Feb 2020,83,114,534,49237834,376685964,425923798,171,522,2,327448130,In > Out
Feb 2020,83,115,292,21956849,205845118,227801967,135,291,2,183888269,In > Out
Feb 2020,83,121,36,8224868,82317298,90542166,20,36,2,74092430,In > Out
Feb 2020,83,123,619,37441430,697982466,735423896,265,609,2,660541036,In > Out
Feb 2020,83,125,515,22082949,388137428,410220377,172,498,2,366054479,In > Out
Feb 2020,83,130,8,2314768,484272,2799040,4,1,2,1830496,Out > In
Feb 2020,83,145,663,55159224,558490209,613649433,248,602,2,503330985,In > Out
Feb 2020,83,146,88,4309316,32629862,36939178,56,88,2,28320546,In > Out
Feb 2020,83,147,101,6124669,161922922,168047591,51,101,2,155798253,In > Out
Feb 2020,83,149,627,616351352,5871344589,6487695941,156,619,3,5254993237,In > Out
Feb 2020,83,152,723,31753821,901982029,933735850,244,715,3,870228208,In > Out
Feb 2020,83,153,2918,144037215,2779970919,2924008134,398,2708,2,2635933704,In > Out
Feb 2020,83,154,536,61401495,359629967,421031462,240,527,2,298228472,In > Out
Feb 2020,83,156,961,557557575,1109525537,1667083112,353,945,15,551967962,In > Out
Feb 2020,83,157,248,19081967,251988256,271070223,115,248,2,232906289,In > Out
Feb 2020,83,158,10,510445,2048693,2559138,6,10,2,1538248,In > Out
Feb 2020,83,160,487,40398355,1238993752,1279392107,204,484,2,1198595397,In > Out
Feb 2020,83,161,299,31339930,414786543,446126473,39,299,2,383446613,In > Out
Feb 2020,83,163,257,23020989,616997385,640018374,71,254,2,593976396,In > Out
Feb 2020,83,165,78,76722941,58846301,135569242,44,78,3,17876640,Out > In
Feb 2020,83,166,1117,125409759,235076301,360486060,148,1098,4,109666542,In > Out
Feb 2020,84,36,6678,552677371,10031003337,10583680708,949,5513,5,9478325966,In > Out
Feb 2020,85,10,7,29640,1182462,1212102,1,7,1,1152822,In > Out
Feb 2020,85,100,24,522897,7925310,8448207,10,24,2,7402413,In > Out
Feb 2020,85,101,87,10662389,37424355,48086744,19,87,2,26761966,In > Out
Feb 2020,85,102,185,288162098,156513736,444675834,93,184,2,131648362,Out > In
Feb 2020,85,103,4,53631,1255172,1308803,3,4,1,1201541,In > Out
Feb 2020,85,104,12,2763318,56079168,58842486,9,12,2,53315850,In > Out
Feb 2020,85,105,326,27464647,424575326,452039973,123,323,3,397110679,In > Out
Feb 2020,85,106,112,4047182,106394363,110441545,68,112,2,102347181,In > Out
Feb 2020,85,107,305,33978526,147566325,181544851,59,303,2,113587799,In > Out
Feb 2020,85,110,52,5229105,39677388,44906493,18,52,2,34448283,In > Out
Feb 2020,85,111,111,5251777,226186446,231438223,29,111,2,220934669,In > Out
Feb 2020,85,112,263,40770259,321592050,362362309,127,262,3,280821791,In > Out
Feb 2020,85,114,85,3316786,70398330,73715116,50,85,2,67081544,In > Out
Feb 2020,85,117,238,18172353,307733001,325905354,125,238,2,289560648,In > Out
Feb 2020,85,118,542,302140578,478177731,780318309,139,527,2,176037153,In > Out
Feb 2020,85,119,145,4313373,52297533,56610906,45,144,2,47984160,In > Out
Feb 2020,85,120,278,12499215,535393936,547893151,104,276,3,522894721,In > Out
Feb 2020,85,121,230,23583291,493264745,516848036,107,230,2,469681454,In > Out
Feb 2020,85,122,78,2229526,61297703,63527229,30,77,2,59068177,In > Out
Feb 2020,85,123,90,4657907,52433450,57091357,36,90,2,47775543,In > Out
Feb 2020,85,124,972,27326467,1840010966,1867337433,79,969,2,1812684499,In > Out
Feb 2020,85,126,491,32510977,1443605051,1476116028,127,490,2,1411094074,In > Out
Feb 2020,85,127,187,16721208,144100181,160821389,79,184,2,127378973,In > Out
Feb 2020,85,130,628,587719169,1755222143,2342941312,249,617,2,1167502974,In > Out
Feb 2020,85,131,789,151642435,2076541662,2228184097,208,778,5,1924899227,In > Out
Feb 2020,85,132,131,19919474,237224628,257144102,47,130,2,217305154,In > Out
Feb 2020,85,133,6,153158,1517797,1670955,6,6,2,1364639,In > Out
Feb 2020,85,134,177,106419056,76203263,182622319,120,176,2,30215793,Out > In
Feb 2020,85,135,507,585183906,2362762772,2947946678,161,507,2,1777578866,In > Out
Feb 2020,85,136,205,69942539,110468629,180411168,72,197,2,40526090,In > Out
Feb 2020,85,137,120,10586602,25854441,36441043,58,120,2,15267839,In > Out
Feb 2020,85,138,137,417461922,275081435,692543357,83,137,4,142380487,Out > In
Feb 2020,85,140,362,18511317,1096862338,1115373655,102,359,2,1078351021,In > Out
Feb 2020,85,142,495,17656392,1196656462,1214312854,64,486,2,1179000070,In > Out
Feb 2020,85,143,7,52719,3146179,3198898,4,7,2,3093460,In > Out
Feb 2020,85,147,2,51116046,2318297,53434343,2,2,1,48797749,Out > In
Feb 2020,85,148,285,38082227,4504231448,4542313675,60,279,2,4466149221,In > Out
Feb 2020,85,149,40,1765493,18159460,19924953,28,40,2,16393967,In > Out
Feb 2020,85,15,15,848853,3269373,4118226,10,15,2,2420520,In > Out
Feb 2020,85,150,684,24817706,508840764,533658470,181,677,3,484023058,In > Out
Feb 2020,85,151,51,8528483,26195143,34723626,24,51,2,17666660,In > Out
Feb 2020,85,152,3,19445,846423,865868,2,3,1,826978,In > Out
Feb 2020,85,153,235,78193147,344583475,422776622,135,233,2,266390328,In > Out
Feb 2020,85,154,42,764711,28808590,29573301,15,42,2,28043879,In > Out
Feb 2020,85,155,41,1399771,26933209,28332980,21,41,2,25533438,In > Out
Feb 2020,85,156,1,183479,890595,1074074,1,1,1,707116,In > Out
Feb 2020,85,16,7,160150892,1179397212,1339548104,6,1,3,1019246320,In > Out
Feb 2020,85,168,6,413676,3342886,3756562,4,6,1,2929210,In > Out
Feb 2020,85,172,616,32197516,2534281432,2566478948,78,615,2,2502083916,In > Out
Feb 2020,85,174,138,585477230,211880010,797357240,62,138,2,373597220,Out > In
Feb 2020,85,184,273,22361093,1572893696,1595254789,50,271,2,1550532603,In > Out
Feb 2020,85,23,21,1102691,6793876,7896567,16,21,2,5691185,In > Out
Feb 2020,85,24,11,308669,3823569,4132238,7,11,2,3514900,In > Out
Feb 2020,85,28,144,4477493,64482144,68959637,55,143,2,60004651,In > Out
Feb 2020,85,30,21,526483,7045485,7571968,8,21,2,6519002,In > Out
Feb 2020,85,42,1,215690,19636,235326,1,1,1,196054,Out > In
Feb 2020,85,44,7,755824,680889,1436713,4,7,2,74935,Out > In
Feb 2020,85,48,228,103873581,50752805,154626386,15,228,2,53120776,Out > In
Feb 2020,85,49,11,76501,4670420,4746921,6,11,1,4593919,In > Out
Feb 2020,85,5,2,269160,28691,297851,1,2,1,240469,Out > In
Feb 2020,85,51,210,66640703,7003514497,7070155200,28,210,2,6936873794,In > Out
Feb 2020,85,52,32,13078609,92761745,105840354,22,32,2,79683136,In > Out
Feb 2020,85,53,202,9727271,378240096,387967367,67,200,2,368512825,In > Out
Feb 2020,85,54,646,40006940,435137363,475144303,168,636,2,395130423,In > Out
Feb 2020,85,55,90,2516901,32960701,35477602,22,90,2,30443800,In > Out
Feb 2020,85,56,157,7821581,142804871,150626452,92,155,8,134983290,In > Out
Feb 2020,85,57,537,192624684,670408934,863033618,160,526,2,477784250,In > Out
Feb 2020,85,59,49,812375,18974863,19787238,18,49,2,18162488,In > Out
Feb 2020,85,6,804,499588343,973435302,1473023645,110,784,5,473846959,In > Out
Feb 2020,85,60,33,3782561,58240538,62023099,18,33,2,54457977,In > Out
Feb 2020,85,61,12,3725352,12644754,16370106,7,12,2,8919402,In > Out
Feb 2020,85,62,17,212443,5378761,5591204,7,17,2,5166318,In > Out
Feb 2020,85,63,16,154138,4174670,4328808,7,16,2,4020532,In > Out
Feb 2020,85,64,10,94622,3650022,3744644,6,10,2,3555400,In > Out
Feb 2020,85,65,82,1602258,25590571,27192829,37,82,2,23988313,In > Out
Feb 2020,85,66,49,2530870,43776074,46306944,36,49,2,41245204,In > Out
Feb 2020,85,67,42,1016420,19955342,20971762,21,42,2,18938922,In > Out
Feb 2020,85,69,50,939513,25731554,26671067,20,50,2,24792041,In > Out
Feb 2020,85,7,2,5354,365949,371303,1,2,1,360595,In > Out
Feb 2020,85,75,615,126189530,871627204,997816734,241,603,2,745437674,In > Out
Feb 2020,85,77,233,32836076,188589930,221426006,134,233,2,155753854,In > Out
Feb 2020,85,78,1,11487,126312,137799,1,1,1,114825,In > Out
Feb 2020,85,79,22,1799121,9478725,11277846,13,22,2,7679604,In > Out
Feb 2020,85,81,14,270312,3289562,3559874,7,14,2,3019250,In > Out
Feb 2020,85,82,17,940976,55325656,56266632,7,17,2,54384680,In > Out
Feb 2020,85,83,13,144566,7516126,7660692,10,13,2,7371560,In > Out
Feb 2020,85,84,16,204913,14638628,14843541,9,16,2,14433715,In > Out
Feb 2020,85,85,3,211691,370599,582290,3,3,1,158908,In > Out
Feb 2020,85,86,11,106510,7582213,7688723,5,11,2,7475703,In > Out
Feb 2020,85,87,7,55619,2962710,3018329,6,7,2,2907091,In > Out
Feb 2020,85,88,6,911591,39079706,39991297,5,6,2,38168115,In > Out
Feb 2020,85,89,6,1983626,3569699,5553325,4,6,1,1586073,In > Out
Feb 2020,85,93,10,43506,1358218,1401724,10,10,2,1314712,In > Out
Feb 2020,86,198,4,12257,601875,614132,1,4,1,589618,In > Out
Feb 2020,86,66,1,8096618,8482056,16578674,1,1,1,385438,In > Out
Feb 2020,88,22,9,242309,5594379,5836688,1,9,1,5352070,In > Out
Feb 2020,89,100,1,2127856,8376632,10504488,1,1,1,6248776,In > Out
Feb 2020,89,107,456,95850972,291683240,387534212,58,448,2,195832268,In > Out
Feb 2020,89,109,13,492235,4306479,4798714,8,13,2,3814244,In > Out
Feb 2020,89,110,1226,146926270,596838641,743764911,227,1166,2,449912371,In > Out
Feb 2020,89,111,198,4241890,574524397,578766287,32,196,2,570282507,In > Out
Feb 2020,89,115,1151,91735060,5681963289,5773698349,304,1116,2,5590228229,In > Out
Feb 2020,89,120,155,1202597,269377422,270580019,22,154,2,268174825,In > Out
Feb 2020,89,121,8,53179,7404846,7458025,7,8,2,7351667,In > Out
Feb 2020,89,123,292,30023412,120637679,150661091,122,291,6,90614267,In > Out
Feb 2020,89,124,293,79223576,892534003,971757579,87,291,2,813310427,In > Out
Feb 2020,89,127,55,4241067,137253892,141494959,20,55,2,133012825,In > Out
Feb 2020,89,128,988,19512334,1950274915,1969787249,36,911,2,1930762581,In > Out
Feb 2020,89,130,1896,539659696,1154305628,1693965324,417,1828,2,614645932,In > Out
Feb 2020,89,131,134,8417092,205489452,213906544,64,134,2,197072360,In > Out
Feb 2020,89,136,349,23388839,365498567,388887406,87,346,3,342109728,In > Out
Feb 2020,89,14,1,61578246,324800,61903046,1,1,1,61253446,Out > In
Feb 2020,89,140,92,19655490,170475030,190130520,33,92,2,150819540,In > Out
Feb 2020,89,141,444,44138344,303876136,348014480,189,441,2,259737792,In > Out
Feb 2020,89,20,2,6048,366680,372728,1,2,2,360632,In > Out
Feb 2020,89,21,12,251724,4407818,4659542,2,12,12,4156094,In > Out
Feb 2020,89,50,4,476189,752383,1228572,2,4,2,276194,In > Out
Feb 2020,89,51,104,4218727,57601348,61820075,63,104,2,53382621,In > Out
Feb 2020,89,52,523,126457393,390287961,516745354,118,514,2,263830568,In > Out
Feb 2020,89,56,21,946517,21151775,22098292,14,20,3,20205258,In > Out
Feb 2020,89,57,62,3310250,58122255,61432505,21,62,2,54812005,In > Out
Feb 2020,89,59,1324,297751411,1550357078,1848108489,250,1287,3,1252605667,In > Out
Feb 2020,89,60,436,119949246,1493335010,1613284256,70,427,2,1373385764,In > Out
Feb 2020,89,61,259,32352194,208257237,240609431,88,256,3,175905043,In > Out
Feb 2020,89,62,177,7968463,84987489,92955952,78,177,2,77019026,In > Out
Feb 2020,89,63,18,1179069,3482736,4661805,9,18,2,2303667,In > Out
Feb 2020,89,64,2,37679,4117077,4154756,1,2,1,4079398,In > Out
Feb 2020,89,65,58,2131392,81251490,83382882,28,58,2,79120098,In > Out
Feb 2020,89,67,14,644114,8473366,9117480,6,14,2,7829252,In > Out
Feb 2020,89,69,181,6560544,206596474,213157018,101,181,2,200035930,In > Out
Feb 2020,89,70,134,4499301,60710998,65210299,16,134,2,56211697,In > Out
Feb 2020,89,72,438,18278421,592716442,610994863,182,432,2,574438021,In > Out
Feb 2020,89,73,105,2451945,102054379,104506324,65,104,2,99602434,In > Out
Feb 2020,89,74,388,48591233,651417956,700009189,122,384,2,602826723,In > Out
Feb 2020,89,76,5,23641,3525778,3549419,4,5,2,3502137,In > Out
Feb 2020,89,77,1237,1793901445,3542620336,5336521781,393,1209,2,1748718891,In > Out
Feb 2020,89,79,12,1413505,67537759,68951264,7,12,2,66124254,In > Out
Feb 2020,89,80,137,4332653,157639960,161972613,49,137,2,153307307,In > Out
Feb 2020,89,81,51,249215,11059929,11309144,13,51,2,10810714,In > Out
Feb 2020,89,82,813,78930747,736057177,814987924,224,794,2,657126430,In > Out
Feb 2020,89,83,148,12959385,109932350,122891735,33,147,2,96972965,In > Out
Feb 2020,89,84,446,29451975,928963301,958415276,213,439,2,899511326,In > Out
Feb 2020,89,85,97,4312377,144798579,149110956,29,97,2,140486202,In > Out
Feb 2020,89,87,868,187494250,2474128213,2661622463,319,851,3,2286633963,In > Out
Feb 2020,89,88,16,5283168,5026458,10309626,11,16,2,256710,Out > In
Feb 2020,89,89,2,257999,28016,286015,2,2,1,229983,Out > In
Feb 2020,89,93,5,433350,466560,899910,1,1,1,33210,In > Out
Feb 2020,89,94,418,50720608,236197352,286917960,169,415,2,185476744,In > Out
Feb 2020,89,96,158,11482623,1508720885,1520203508,54,156,2,1497238262,In > Out
Feb 2020,89,98,1503,204062798,304171590,508234388,208,1436,3,100108792,In > Out
Feb 2020,9,153,4,711586,17371562,18083148,1,4,1,16659976,In > Out
Feb 2020,9,154,1178,115996685,2091133517,2207130202,408,1147,3,1975136832,In > Out
Feb 2020,9,155,713,42188989,564584861,606773850,168,702,3,522395872,In > Out
Feb 2020,9,157,15,211657,10077673,10289330,7,15,2,9866016,In > Out
Feb 2020,9,158,68,647138,102860176,103507314,16,68,2,102213038,In > Out
Feb 2020,9,159,24,541517,65061255,65602772,13,24,2,64519738,In > Out
Feb 2020,9,160,19,828098,15530570,16358668,12,19,2,14702472,In > Out
Feb 2020,9,162,79,3216435,188987487,192203922,22,79,2,185771052,In > Out
Feb 2020,9,164,13,643586,80464741,81108327,10,13,2,79821155,In > Out
Feb 2020,9,3,1,4574,170511,175085,1,1,1,165937,In > Out
Feb 2020,9,52,48,2329600,159953841,162283441,22,48,2,157624241,In > Out
Feb 2020,9,53,18,270942,14671476,14942418,8,18,2,14400534,In > Out
Feb 2020,9,56,274,21565748,206119002,227684750,77,270,2,184553254,In > Out
Feb 2020,9,59,49,1916970,87065677,88982647,13,49,2,85148707,In > Out
Feb 2020,9,60,514,63369986,1180496118,1243866104,141,511,2,1117126132,In > Out
Feb 2020,9,61,18,180525,37905301,38085826,13,18,2,37724776,In > Out
Feb 2020,9,62,5,1105859,68068,1173927,3,5,1,1037791,Out > In
Feb 2020,9,64,3,130020,514889,644909,3,3,2,384869,In > Out
Feb 2020,90,10,857,139965221,3442662562,3582627783,192,830,3,3302697341,In > Out
Feb 2020,90,100,1069,127887993,2382107284,2509995277,237,1043,3,2254219291,In > Out
Feb 2020,90,101,303,8988862,204157338,213146200,136,302,2,195168476,In > Out
Feb 2020,90,102,808,226920057,7144040130,7370960187,188,791,3,6917120073,In > Out
Feb 2020,90,104,166,10024235,27560228,37584463,28,166,2,17535993,In > Out
Feb 2020,90,105,16,78515,9362991,9441506,10,16,2,9284476,In > Out
Feb 2020,90,106,29,2518134,71579247,74097381,8,29,2,69061113,In > Out
Feb 2020,90,107,229,21522143,286832240,308354383,125,228,2,265310097,In > Out
Feb 2020,90,11,593,435817992,1527160531,1962978523,211,580,8,1091342539,In > Out
Feb 2020,90,110,336,32369396,245133446,277502842,123,334,3,212764050,In > Out
Feb 2020,90,111,318,37866446,1235343120,1273209566,140,318,3,1197476674,In > Out
Feb 2020,90,112,70,2091922,485424972,487516894,3,70,2,483333050,In > Out
Feb 2020,90,117,73,11055710,301524061,312579771,50,73,2,290468351,In > Out
Feb 2020,90,118,196,65579857,2382774831,2448354688,70,195,2,2317194974,In > Out
Feb 2020,90,12,563,31248323,801854557,833102880,216,551,2,770606234,In > Out
Feb 2020,90,124,470,132393524,379939997,512333521,91,468,2,247546473,In > Out
Feb 2020,90,126,404,6799057,764410370,771209427,50,404,2,757611313,In > Out
Feb 2020,90,127,25,1965539,458573876,460539415,9,25,2,456608337,In > Out
Feb 2020,90,135,123,6977203,154225229,161202432,73,123,2,147248026,In > Out
Feb 2020,90,14,1632,346074379,4566044596,4912118975,361,1566,6,4219970217,In > Out
Feb 2020,90,141,153,21340178,649135525,670475703,71,153,2,627795347,In > Out
Feb 2020,90,17,673,64584041,1328702296,1393286337,174,607,2,1264118255,In > Out
Feb 2020,90,18,6,202850,9953097,10155947,1,6,1,9750247,In > Out
Feb 2020,90,21,199,50012127,148572976,198585103,71,199,4,98560849,In > Out
Feb 2020,90,214,312,14607038,194546205,209153243,49,312,2,179939167,In > Out
Feb 2020,90,22,257,30749493,786372080,817121573,103,248,2,755622587,In > Out
Feb 2020,90,220,518,39778753,634911619,674690372,163,513,2,595132866,In > Out
Feb 2020,90,23,620,40499095,849795864,890294959,135,613,4,809296769,In > Out
Feb 2020,90,230,56,2503887,94116175,96620062,13,56,2,91612288,In > Out
Feb 2020,90,235,4557,3608863770,224903131,3833766901,320,84,4232,3383960639,Out > In
Feb 2020,90,236,752,395364499,5247393432,5642757931,198,716,15,4852028933,In > Out
Feb 2020,90,24,1740,256027612,5292512185,5548539797,325,1658,2,5036484573,In > Out
Feb 2020,90,25,503,47572602,479482710,527055312,191,498,2,431910108,In > Out
Feb 2020,90,253,5902,22015704097,10343316085,32359020182,1014,5416,14,11672388012,Out > In
Feb 2020,90,27,313,29971547,1202056872,1232028419,49,310,2,1172085325,In > Out
Feb 2020,90,29,1104,2960155124,1434505039,4394660163,169,1083,7,1525650085,Out > In
Feb 2020,90,3,127,6687737,146205825,152893562,65,127,3,139518088,In > Out
Feb 2020,90,31,623,166668401,6778151610,6944820011,169,616,3,6611483209,In > Out
Feb 2020,90,33,1594,34147745,1223536308,1257684053,213,1425,2,1189388563,In > Out
Feb 2020,90,34,647,156991580,3765948235,3922939815,249,620,4,3608956655,In > Out
Feb 2020,90,35,119,133101490,3724872678,3857974168,65,119,2,3591771188,In > Out
Feb 2020,90,36,36,3360925,96298307,99659232,14,36,2,92937382,In > Out
Feb 2020,90,38,81,2951127,77178955,80130082,47,81,3,74227828,In > Out
Feb 2020,90,39,21,1035425,9145315,10180740,12,21,2,8109890,In > Out
Feb 2020,90,40,609,33533643,419832672,453366315,225,592,3,386299029,In > Out
Feb 2020,90,41,302,33141315,116253167,149394482,108,302,2,83111852,In > Out
Feb 2020,90,42,69,2759458,26603596,29363054,48,69,2,23844138,In > Out
Feb 2020,90,43,1387,425992977,7323622357,7749615334,299,1340,6,6897629380,In > Out
Feb 2020,90,44,391,76723782,2654819169,2731542951,132,386,2,2578095387,In > Out
Feb 2020,90,45,757,46665207,442241390,488906597,240,736,2,395576183,In > Out
Feb 2020,90,46,358,27632765,570503917,598136682,140,354,2,542871152,In > Out
Feb 2020,90,47,452,101007794,4181942834,4282950628,53,447,3,4080935040,In > Out
Feb 2020,90,48,3181,551990677,6997311912,7549302589,547,2921,4,6445321235,In > Out
Feb 2020,90,49,329,77506424,861398214,938904638,157,328,2,783891790,In > Out
Feb 2020,90,5,629,76013432,569280697,645294129,223,614,2,493267265,In > Out
Feb 2020,90,50,302,37246679,312436621,349683300,117,302,3,275189942,In > Out
Feb 2020,90,52,228,5712309,149501275,155213584,27,227,2,143788966,In > Out
Feb 2020,90,53,16,848981,4659477,5508458,10,16,2,3810496,In > Out
Feb 2020,90,54,652,41423791,896814529,938238320,201,643,2,855390738,In > Out
Feb 2020,90,55,100,88082714,248363078,336445792,11,99,2,160280364,In > Out
Feb 2020,90,58,450,38513995,1025910819,1064424814,125,450,2,987396824,In > Out
Feb 2020,90,6,542,54464957,701227964,755692921,183,528,2,646763007,In > Out
Feb 2020,90,61,89,12390287,372692339,385082626,41,89,2,360302052,In > Out
Feb 2020,90,62,909,47113566,677405775,724519341,305,882,4,630292209,In > Out
Feb 2020,90,63,266,113200247,2687942090,2801142337,48,260,3,2574741843,In > Out
Feb 2020,90,64,70,2278310,45266955,47545265,32,70,2,42988645,In > Out
Feb 2020,90,66,260,62117393,2286145734,2348263127,33,260,2,2224028341,In > Out
Feb 2020,90,67,73,5373213,91084962,96458175,37,73,2,85711749,In > Out
Feb 2020,90,68,7925,996350666,3210515487,4206866153,283,6699,4,2214164821,In > Out
Feb 2020,90,7,720,41916163,1052609033,1094525196,135,706,3,1010692870,In > Out
Feb 2020,90,70,12,2397851,75260487,77658338,7,12,1,72862636,In > Out
Feb 2020,90,71,114,14475342,135908023,150383365,62,114,1,121432681,In > Out
Feb 2020,90,72,179,12746573,131212628,143959201,72,176,3,118466055,In > Out
Feb 2020,90,73,374,34778236,619646734,654424970,143,374,2,584868498,In > Out
Feb 2020,90,74,199,9831498,417241939,427073437,29,199,2,407410441,In > Out
Feb 2020,90,75,485,173679872,3868399060,4042078932,161,478,2,3694719188,In > Out
Feb 2020,90,76,315,17951259,344331317,362282576,71,314,2,326380058,In > Out
Feb 2020,90,77,657,45489354,545374022,590863376,223,650,2,499884668,In > Out
Feb 2020,90,78,494,77186644,2522336734,2599523378,122,490,2,2445150090,In > Out
Feb 2020,90,79,234,14901065,276266996,291168061,93,234,2,261365931,In > Out
Feb 2020,90,8,250,108549051,715839262,824388313,103,250,2,607290211,In > Out
Feb 2020,90,80,222,11300304,203556042,214856346,82,221,3,192255738,In > Out
Feb 2020,90,82,218,2711987,321659691,324371678,26,215,2,318947704,In > Out
Feb 2020,90,83,566,63887637,1864979815,1928867452,143,556,2,1801092178,In > Out
Feb 2020,90,84,55,28172454,726759676,754932130,14,55,2,698587222,In > Out
Feb 2020,90,87,789,76672658,1164413670,1241086328,250,773,2,1087741012,In > Out
Feb 2020,90,90,627,193106547,9647356896,9840463443,179,596,2,9454250349,In > Out
Feb 2020,90,92,763,107810117,8568036600,8675846717,318,747,5,8460226483,In > Out
Feb 2020,90,96,859,543954415,920592602,1464547017,227,809,2,376638187,In > Out
Feb 2020,90,97,40,1033127,28815457,29848584,21,40,2,27782330,In > Out
Feb 2020,90,99,384,24482425,516730198,541212623,116,384,2,492247773,In > Out
Feb 2020,91,10,289,62714368,2759967733,2822682101,32,287,2,2697253365,In > Out
Feb 2020,91,11,120,233588080,679919051,913507131,33,119,3,446330971,In > Out
Feb 2020,91,113,134,3003064,128151585,131154649,33,132,2,125148521,In > Out
Feb 2020,91,12,156,17760483,140789756,158550239,47,156,2,123029273,In > Out
Feb 2020,91,13,202,17742249,151403368,169145617,101,200,3,133661119,In > Out
Feb 2020,91,132,4,104886,3659533,3764419,3,4,2,3554647,In > Out
Feb 2020,91,14,798,64517347,374932285,439449632,197,780,2,310414938,In > Out
Feb 2020,91,15,1958,1445985574,3027522738,4473508312,491,1799,7,1581537164,In > Out
Feb 2020,91,16,616,1738985049,736312986,2475298035,181,610,3,1002672063,Out > In
Feb 2020,91,17,68,22743295,1050635785,1073379080,23,68,2,1027892490,In > Out
Feb 2020,91,19,13,1888484,425899542,427788026,4,13,2,424011058,In > Out
Feb 2020,91,190,476,33728179,2969087669,3002815848,145,475,2,2935359490,In > Out
Feb 2020,91,20,1056,37114749,1152976161,1190090910,227,1031,3,1115861412,In > Out
Feb 2020,91,200,111,8168200,812739213,820907413,14,111,2,804571013,In > Out
Feb 2020,91,21,1271,3742664060,2512456259,6255120319,233,1213,2,1230207801,Out > In
Feb 2020,91,214,31,1528028,69666823,71194851,7,31,2,68138795,In > Out
Feb 2020,91,22,330,13026680,425507473,438534153,158,329,2,412480793,In > Out
Feb 2020,91,225,237,43819263,3377449154,3421268417,40,237,2,3333629891,In > Out
Feb 2020,91,226,422,70999008,667325479,738324487,169,421,4,596326471,In > Out
Feb 2020,91,227,35,10172571,488320117,498492688,23,35,2,478147546,In > Out
Feb 2020,91,228,30,1473820,318956654,320430474,7,30,2,317482834,In > Out
Feb 2020,91,229,1,179348,17448,196796,1,1,1,161900,Out > In
Feb 2020,91,23,114,625378918,857957270,1483336188,20,114,3,232578352,In > Out
Feb 2020,91,230,42,2927775,340318963,343246738,7,42,2,337391188,In > Out
Feb 2020,91,239,151,1986525,141676463,143662988,14,151,2,139689938,In > Out
Feb 2020,91,25,782,58477871,578029052,636506923,175,767,3,519551181,In > Out
Feb 2020,91,27,12,2663814,350914783,353578597,4,12,2,348250969,In > Out
Feb 2020,91,28,688,46346485,2669637275,2715983760,207,676,3,2623290790,In > Out
Feb 2020,91,3,288,11290874,139090149,150381023,126,288,3,127799275,In > Out
Feb 2020,91,31,182,5023440,404877710,409901150,39,181,2,399854270,In > Out
Feb 2020,91,32,816,31948147,1200053338,1232001485,239,787,3,1168105191,In > Out
Feb 2020,91,33,604,31933306,795771197,827704503,155,598,2,763837891,In > Out
Feb 2020,91,34,3054,14042182587,338652338,14380834925,116,2791,3,13703530249,Out > In
Feb 2020,91,36,302,37513312,643590399,681103711,76,302,2,606077087,In > Out
Feb 2020,91,37,601,35607929,1398922150,1434530079,119,594,2,1363314221,In > Out
Feb 2020,91,40,160,25861853,3806199181,3832061034,29,160,2,3780337328,In > Out
Feb 2020,91,41,307,18788466,1487055147,1505843613,64,290,3,1468266681,In > Out
Feb 2020,91,43,86,5520060,33506593,39026653,43,86,2,27986533,In > Out
Feb 2020,91,44,712,38153246,2631906467,2670059713,104,707,2,2593753221,In > Out
Feb 2020,91,46,441,44809732,758433849,803243581,131,438,2,713624117,In > Out
Feb 2020,91,47,940,93279826,2226796031,2320075857,311,915,23,2133516205,In > Out
Feb 2020,91,48,209,38312566,1668033860,1706346426,76,209,2,1629721294,In > Out
Feb 2020,91,49,486,30960699,796296504,827257203,134,482,2,765335805,In > Out
Feb 2020,91,50,36,1424068,32602102,34026170,25,36,2,31178034,In > Out
Feb 2020,91,52,155,4647282,230263655,234910937,25,154,2,225616373,In > Out
Feb 2020,91,53,235,25790322,252413459,278203781,21,235,2,226623137,In > Out
Feb 2020,91,57,331,25797347,739953552,765750899,111,326,2,714156205,In > Out
Feb 2020,91,58,82,4520751,45284829,49805580,54,82,3,40764078,In > Out
Feb 2020,91,59,3286,448269895,20295049610,20743319505,555,3010,6,19846779715,In > Out
Feb 2020,91,6,924,84881609,5393500755,5478382364,174,892,5,5308619146,In > Out
Feb 2020,91,60,323,28431864,479153837,507585701,83,322,3,450721973,In > Out
Feb 2020,91,61,95,12345307,585936862,598282169,30,95,2,573591555,In > Out
Feb 2020,91,62,1610,128587607,1245650586,1374238193,186,1527,2,1117062979,In > Out
Feb 2020,91,64,148,20033733,1068638919,1088672652,26,148,2,1048605186,In > Out
Feb 2020,91,69,106,4052830,179902922,183955752,31,106,2,175850092,In > Out
Feb 2020,91,71,67,2679470,82739432,85418902,36,67,3,80059962,In > Out
Feb 2020,91,77,556,35809984,380285076,416095060,247,547,2,344475092,In > Out
Feb 2020,91,8,525,16335451,555602770,571938221,111,522,3,539267319,In > Out
Feb 2020,91,83,562,27343189,802598960,829942149,215,547,3,775255771,In > Out
Feb 2020,91,84,2,271882,21380,293262,1,2,1,250502,Out > In
Feb 2020,91,87,152,10747095,914804951,925552046,40,152,2,904057856,In > Out
Feb 2020,91,90,748,43729336,2713629711,2757359047,254,731,2,2669900375,In > Out
Feb 2020,91,91,1654,172669658,6135533004,6308202662,234,1545,4,5962863346,In > Out
Feb 2020,91,94,30,2400599,579479448,581880047,7,30,2,577078849,In > Out
Feb 2020,92,10,26,2654656,109000701,111655357,9,26,2,106346045,In > Out
Feb 2020,92,11,258,4914351,659395645,664309996,26,254,2,654481294,In > Out
Feb 2020,92,12,164,63165915,223924508,287090423,32,164,2,160758593,In > Out
Feb 2020,92,14,400,55965603,1033703894,1089669497,110,397,2,977738291,In > Out
Feb 2020,92,17,350,15734318,849243301,864977619,103,344,3,833508983,In > Out
Feb 2020,92,18,301,8216546,343625857,351842403,76,300,2,335409311,In > Out
Feb 2020,92,19,253,4428402,559060944,563489346,28,252,2,554632542,In > Out
Feb 2020,92,20,210,2479471,328127233,330606704,29,209,2,325647762,In > Out
Feb 2020,92,21,225,2171620,246250504,248422124,46,222,2,244078884,In > Out
Feb 2020,92,213,12,1436441,7607006,9043447,8,12,2,6170565,In > Out
Feb 2020,92,22,145,1532929,258132431,259665360,25,144,2,256599502,In > Out
Feb 2020,92,225,7,635565,6935799,7571364,5,7,2,6300234,In > Out
Feb 2020,92,227,25,6937272,4045325,10982597,6,25,7,2891947,Out > In
Feb 2020,92,228,366,2691258920,139547575,2830806495,53,360,2,2551711345,Out > In
Feb 2020,92,23,211,6228337,389776941,396005278,45,211,2,383548604,In > Out
Feb 2020,92,24,525,12298716,309887983,322186699,92,525,2,297589267,In > Out
Feb 2020,92,25,201,4854957,475224991,480079948,45,201,2,470370034,In > Out
Feb 2020,92,250,73,5425452,177294984,182720436,28,73,2,171869532,In > Out
Feb 2020,92,26,108,3321209,149838647,153159856,20,107,2,146517438,In > Out
Feb 2020,92,28,79,2573279,269754046,272327325,47,79,2,267180767,In > Out
Feb 2020,92,30,224,3748276,391087816,394836092,59,224,2,387339540,In > Out
Feb 2020,92,32,222,1507423,334846201,336353624,26,222,2,333338778,In > Out
Feb 2020,92,33,338,9201375,789987471,799188846,32,337,2,780786096,In > Out
Feb 2020,92,34,262,8218216,235668466,243886682,62,261,2,227450250,In > Out
Feb 2020,92,35,254,3642866,465567055,469209921,25,253,2,461924189,In > Out
Feb 2020,92,37,801,587484939,2616026102,3203511041,211,788,8,2028541163,In > Out
Feb 2020,92,38,153,943957,204237238,205181195,21,153,2,203293281,In > Out
Feb 2020,92,39,264,4711333,450610763,455322096,60,263,2,445899430,In > Out
Feb 2020,92,4,3,12640,725846,738486,2,3,1,713206,In > Out
Feb 2020,92,40,604,28276637,915478938,943755575,131,585,15,887202301,In > Out
Feb 2020,92,41,190,2984216,545902355,548886571,27,187,2,542918139,In > Out
Feb 2020,92,42,126,46548283,78049754,124598037,30,126,2,31501471,In > Out
Feb 2020,92,43,94,2166783,59441648,61608431,28,94,2,57274865,In > Out
Feb 2020,92,45,457,30452940,58305276,88758216,18,442,4,27852336,In > Out
Feb 2020,92,46,101,2829920,147404221,150234141,22,101,2,144574301,In > Out
Feb 2020,92,47,147,5579958,250538953,256118911,32,147,2,244958995,In > Out
Feb 2020,92,48,208,29605066,252289870,281894936,41,208,2,222684804,In > Out
Feb 2020,92,5,243,2902110,427579025,430481135,37,242,2,424676915,In > Out
Feb 2020,92,51,1,49289,71938,121227,1,1,1,22649,In > Out
Feb 2020,92,52,238,3709509,350928096,354637605,25,238,2,347218587,In > Out
Feb 2020,92,53,266,4640976,464079279,468720255,32,262,2,459438303,In > Out
Feb 2020,92,54,170,4714275,190217040,194931315,45,170,2,185502765,In > Out
Feb 2020,92,55,346,30839361,785513073,816352434,122,346,2,754673712,In > Out
Feb 2020,92,56,259,19556898,938155276,957712174,47,257,2,918598378,In > Out
Feb 2020,92,58,117,3738894,148144561,151883455,25,117,2,144405667,In > Out
Feb 2020,92,59,118,4910303,227862558,232772861,23,118,2,222952255,In > Out
Feb 2020,92,6,1426,383870193,1286132839,1670003032,330,1370,3,902262646,In > Out
Feb 2020,92,61,169,4888195,553086675,557974870,35,169,2,548198480,In > Out
Feb 2020,92,62,80,2330098,109377281,111707379,21,80,2,107047183,In > Out
Feb 2020,92,63,96,2991526,161410000,164401526,23,96,2,158418474,In > Out
Feb 2020,92,64,461,26131613,699624031,725755644,135,447,2,673492418,In > Out
Feb 2020,92,65,281,6182837,549902073,556084910,27,281,2,543719236,In > Out
Feb 2020,92,67,143,3726872,155710444,159437316,23,143,2,151983572,In > Out
Feb 2020,92,7,68,1814850,41148720,42963570,38,68,2,39333870,In > Out
Feb 2020,92,78,132,5059788,230968254,236028042,27,131,2,225908466,In > Out
Feb 2020,92,79,187,2181451,430222285,432403736,20,187,2,428040834,In > Out
Feb 2020,92,8,236,10205151,294482906,304688057,52,236,2,284277755,In > Out
Feb 2020,92,80,172,2491516,168008590,170500106,51,171,2,165517074,In > Out
Feb 2020,92,81,372,20903870,721154545,742058415,89,363,2,700250675,In > Out
Feb 2020,92,84,181,6150103,246567955,252718058,45,180,2,240417852,In > Out
Feb 2020,92,86,386,8560941,511663542,520224483,95,374,2,503102601,In > Out
Feb 2020,92,87,261,4021199,389654273,393675472,51,261,2,385633074,In > Out
Feb 2020,92,88,178,4087162,309986590,314073752,40,178,2,305899428,In > Out
Feb 2020,92,89,304,6276619,803422633,809699252,60,298,2,797146014,In > Out
Feb 2020,92,9,217,362176729,374342141,736518870,82,215,2,12165412,In > Out
Feb 2020,92,97,134,1794617,147651393,149446010,26,133,2,145856776,In > Out
Feb 2020,92,98,331,18875952,702490526,721366478,75,331,2,683614574,In > Out
Feb 2020,94,21,422,30290723,1652005042,1682295765,250,417,1,1621714319,In > Out
Feb 2020,94,22,545,231234865,13258011,244492876,88,333,498,217976854,Out > In
Feb 2020,94,29,35726,230617423650,100549628354,331167052004,3151,16559,63,130067795296,Out > In
Feb 2020,94,51,560,575389808,12187896,587577704,1,554,553,563201912,Out > In
Feb 2020,96,125,1,177682,22367,200049,1,1,1,155315,Out > In
Feb 2020,96,60,29,586771922,246957852,833729774,24,1,29,339814070,Out > In
Feb 2020,96,78,2,13241532,157373,13398905,2,2,2,13084159,Out > In
Feb 2020,98,10,552,72007786,1538308630,1610316416,163,529,8,1466300844,In > Out
Feb 2020,98,101,794,75157037,1705355470,1780512507,201,785,6,1630198433,In > Out
Feb 2020,98,102,1408,159741725,4326937980,4486679705,288,1365,6,4167196255,In > Out
Feb 2020,98,103,650,100329688,1828712641,1929042329,250,645,6,1728382953,In > Out
Feb 2020,98,104,340,92957813,2976211767,3069169580,127,337,7,2883253954,In > Out
Feb 2020,98,107,224,47895897,1234300140,1282196037,111,223,3,1186404243,In > Out
Feb 2020,98,108,659,313015335,3600729738,3913745073,156,644,13,3287714403,In > Out
Feb 2020,98,11,925,1356432521,5623607619,6980040140,127,924,4,4267175098,In > Out
Feb 2020,98,110,541,92879080,1268689749,1361568829,125,533,5,1175810669,In > Out
Feb 2020,98,111,185,108892815,276511947,385404762,70,183,7,167619132,In > Out
Feb 2020,98,113,1360,232486504,5256330121,5488816625,316,1314,7,5023843617,In > Out
Feb 2020,98,114,761,83961828,3442544761,3526506589,217,734,7,3358582933,In > Out
Feb 2020,98,115,1328,268893987,20720276835,20989170822,255,1235,9,20451382848,In > Out
Feb 2020,98,12,364,61918830,2950729430,3012648260,136,364,4,2888810600,In > Out
Feb 2020,98,120,567,196392146,999773918,1196166064,152,563,7,803381772,In > Out
Feb 2020,98,122,1119,104335206,4212780144,4317115350,194,1108,12,4108444938,In > Out
Feb 2020,98,123,718,71988499,1684404314,1756392813,144,711,6,1612415815,In > Out
Feb 2020,98,124,316,33153621,615327698,648481319,118,312,4,582174077,In > Out
Feb 2020,98,125,715,140373433,5417237596,5557611029,166,711,6,5276864163,In > Out
Feb 2020,98,126,906,294038239,15959419694,16253457933,261,890,7,15665381455,In > Out
Feb 2020,98,128,1351,147536943,7098055281,7245592224,371,1345,4,6950518338,In > Out
Feb 2020,98,13,1610,511477741,15976320929,16487798670,358,1550,5,15464843188,In > Out
Feb 2020,98,130,619,66164082,4613271331,4679435413,141,608,2,4547107249,In > Out
Feb 2020,98,132,867,112252404,3726492307,3838744711,169,843,3,3614239903,In > Out
Feb 2020,98,133,1416,14035050728,77677621444,91712672172,350,1369,14,63642570716,In > Out
Feb 2020,98,134,625,173055984,2648631516,2821687500,140,622,5,2475575532,In > Out
Feb 2020,98,135,261,77691083,420888620,498579703,70,260,9,343197537,In > Out
Feb 2020,98,136,1229,469370954,3049050060,3518421014,263,1202,10,2579679106,In > Out
Feb 2020,98,137,266,22555730,499573949,522129679,113,266,2,477018219,In > Out
Feb 2020,98,138,1037,174142476,2096548033,2270690509,158,1021,12,1922405557,In > Out
Feb 2020,98,139,1027,289076460,1641972515,1931048975,223,1005,10,1352896055,In > Out
Feb 2020,98,14,6603,4401395752,8536873888,12938269640,155,4623,4,4135478136,In > Out
Feb 2020,98,140,614,208035886,3254619237,3462655123,124,580,20,3046583351,In > Out
Feb 2020,98,141,552,206499286,3924991489,4131490775,118,550,3,3718492203,In > Out
Feb 2020,98,142,401,362913261,1073939470,1436852731,113,401,4,711026209,In > Out
Feb 2020,98,143,862,82453583,2107984278,2190437861,276,844,6,2025530695,In > Out
Feb 2020,98,145,686,889057737,2279165382,3168223119,207,646,34,1390107645,In > Out
Feb 2020,98,146,1373,391009043,5142735395,5533744438,422,1346,6,4751726352,In > Out
Feb 2020,98,147,267,15408311,499791655,515199966,109,266,4,484383344,In > Out
Feb 2020,98,148,742,1793736488,4144417777,5938154265,146,731,10,2350681289,In > Out
Feb 2020,98,149,315,73477856,470138387,543616243,116,315,5,396660531,In > Out
Feb 2020,98,15,317,84979478,3888504518,3973483996,157,317,3,3803525040,In > Out
Feb 2020,98,150,2432,374804649,15456613481,15831418130,541,2336,11,15081808832,In > Out
Feb 2020,98,152,609,885154707,1485496884,2370651591,157,598,9,600342177,In > Out
Feb 2020,98,153,814,159666639,7547356507,7707023146,200,804,8,7387689868,In > Out
Feb 2020,98,154,336,429244639,834637399,1263882038,145,335,7,405392760,In > Out
Feb 2020,98,156,370,117068039,1966518742,2083586781,98,355,6,1849450703,In > Out
Feb 2020,98,157,292,27630771,642011401,669642172,102,275,18,614380630,In > Out
Feb 2020,98,16,463,89520156,1113954344,1203474500,201,460,12,1024434188,In > Out
Feb 2020,98,161,287,2978041663,5887081473,8865123136,119,286,6,2909039810,In > Out
Feb 2020,98,162,372,165046730,4608887195,4773933925,156,370,4,4443840465,In > Out
Feb 2020,98,163,841,128129118,2133048541,2261177659,266,826,5,2004919423,In > Out
Feb 2020,98,164,644,72794428,2241793895,2314588323,215,631,5,2168999467,In > Out
Feb 2020,98,168,480,63290996,2094966727,2158257723,141,477,5,2031675731,In > Out
Feb 2020,98,169,573,108578600,2857821692,2966400292,163,558,18,2749243092,In > Out
Feb 2020,98,17,460,590087121,1334229717,1924316838,138,452,8,744142596,In > Out
Feb 2020,98,170,175,36648106,166533560,203181666,74,173,8,129885454,In > Out
Feb 2020,98,171,1435,1496736333,6373710559,7870446892,405,1359,49,4876974226,In > Out
Feb 2020,98,172,275,49423639,1641761768,1691185407,118,275,5,1592338129,In > Out
Feb 2020,98,173,645,126092328,1183937654,1310029982,198,640,6,1057845326,In > Out
Feb 2020,98,177,585,1080841668,5886698318,6967539986,161,572,7,4805856650,In > Out
Feb 2020,98,179,517,275022869,2862495452,3137518321,222,511,11,2587472583,In > Out
Feb 2020,98,18,307,77707475,659317634,737025109,85,306,4,581610159,In > Out
Feb 2020,98,180,1719,678239339,8637262102,9315501441,357,1656,7,7959022763,In > Out
Feb 2020,98,181,124,12119047,175648976,187768023,60,123,2,163529929,In > Out
Feb 2020,98,182,522,64261942,969229242,1033491184,140,515,4,904967300,In > Out
Feb 2020,98,184,740,151902838,4524120123,4676022961,228,729,4,4372217285,In > Out
Feb 2020,98,185,1201,250217642,2585339988,2835557630,229,1172,6,2335122346,In > Out
Feb 2020,98,186,1242,171967368,4709893948,4881861316,248,1205,8,4537926580,In > Out
Feb 2020,98,188,543,81500718,2073418964,2154919682,219,541,5,1991918246,In > Out
Feb 2020,98,194,277,9975563,290950847,300926410,118,277,3,280975284,In > Out
Feb 2020,98,195,1580,3572129067,9914425529,13486554596,326,1529,16,6342296462,In > Out
Feb 2020,98,196,1200,362055635,6613269487,6975325122,311,1174,7,6251213852,In > Out
Feb 2020,98,198,861,644386980,4610637593,5255024573,262,844,7,3966250613,In > Out
Feb 2020,98,199,591,139784265,4356015054,4495799319,232,574,2,4216230789,In > Out
Feb 2020,98,20,203,27688718,326694248,354382966,70,201,3,299005530,In > Out
Feb 2020,98,200,571,177400542,2945087876,3122488418,269,557,12,2767687334,In > Out
Feb 2020,98,201,234,118651658,6187598626,6306250284,146,233,5,6068946968,In > Out
Feb 2020,98,203,428,39078963,861349381,900428344,129,428,4,822270418,In > Out
Feb 2020,98,204,543,199490060,10528815450,10728305510,202,540,6,10329325390,In > Out
Feb 2020,98,206,440,54854138,1560302963,1615157101,179,440,5,1505448825,In > Out
Feb 2020,98,208,318,261203317,562615223,823818540,97,313,7,301411906,In > Out
Feb 2020,98,210,79,16649744,375413574,392063318,44,79,4,358763830,In > Out
Feb 2020,98,211,549,940687866,2037245299,2977933165,228,539,9,1096557433,In > Out
Feb 2020,98,212,1273,423327386,3938347184,4361674570,261,1214,6,3515019798,In > Out
Feb 2020,98,216,670,280237319,2607981025,2888218344,225,650,8,2327743706,In > Out
Feb 2020,98,219,405,268102047,539080632,807182679,121,404,3,270978585,In > Out
Feb 2020,98,22,66,2670008,13122019,15792027,34,66,1,10452011,In > Out
Feb 2020,98,220,259,441138060,1753343074,2194481134,110,258,6,1312205014,In > Out
Feb 2020,98,221,587,103534761,3833569158,3937103919,229,575,8,3730034397,In > Out
Feb 2020,98,222,358,90890845,1224972760,1315863605,114,358,5,1134081915,In > Out
Feb 2020,98,223,315,97354716,1715037747,1812392463,107,315,14,1617683031,In > Out
Feb 2020,98,23,249,46631564,342260039,388891603,107,247,2,295628475,In > Out
Feb 2020,98,26,599,592173819,2289758400,2881932219,184,596,5,1697584581,In > Out
Feb 2020,98,27,430,32830204,949036428,981866632,83,424,5,916206224,In > Out
Feb 2020,98,28,628,116364480,1009556804,1125921284,164,618,21,893192324,In > Out
Feb 2020,98,29,1180,147150164,4307702850,4454853014,335,1130,25,4160552686,In > Out
Feb 2020,98,30,314,81532575,749024112,830556687,103,307,20,667491537,In > Out
Feb 2020,98,31,420,171450504,2571866816,2743317320,125,418,6,2400416312,In > Out
Feb 2020,98,33,1119,313442898,16491253204,16804696102,353,1068,5,16177810306,In > Out
Feb 2020,98,34,985,150267098,3320902206,3471169304,158,963,7,3170635108,In > Out
Feb 2020,98,35,390,29276917,574295669,603572586,149,388,2,545018752,In > Out
Feb 2020,98,37,552,64577350,2342974592,2407551942,138,542,4,2278397242,In > Out
Feb 2020,98,4,575,88455115,2296908358,2385363473,177,568,5,2208453243,In > Out
Feb 2020,98,40,591,93582689,2821304677,2914887366,175,585,5,2727721988,In > Out
Feb 2020,98,43,578,281136737,7569287134,7850423871,230,552,15,7288150397,In > Out
Feb 2020,98,44,668,180155228,6427634399,6607789627,151,658,3,6247479171,In > Out
Feb 2020,98,46,1094,429633465,2430783819,2860417284,319,1056,29,2001150354,In > Out
Feb 2020,98,49,1616,412443114,6966241131,7378684245,250,1580,15,6553798017,In > Out
Feb 2020,98,51,518,24225472,1287861797,1312087269,150,512,5,1263636325,In > Out
Feb 2020,98,54,836,825991342,4828281174,5654272516,298,821,13,4002289832,In > Out
Feb 2020,98,56,453,303124184,2801723939,3104848123,176,438,5,2498599755,In > Out
Feb 2020,98,57,884,51881147,1074698987,1126580134,145,879,9,1022817840,In > Out
Feb 2020,98,59,810,79737582,1246179197,1325916779,275,798,4,1166441615,In > Out
Feb 2020,98,60,226,23049028,594121729,617170757,106,224,7,571072701,In > Out
Feb 2020,98,61,950,26999802,2439369899,2466369701,97,941,4,2412370097,In > Out
Feb 2020,98,62,1115,305287685,3249006612,3554294297,133,1095,5,2943718927,In > Out
Feb 2020,98,64,453,109230611,5688195338,5797425949,211,446,8,5578964727,In > Out
Feb 2020,98,65,962,90145876,1617721579,1707867455,244,944,3,1527575703,In > Out
Feb 2020,98,66,1945,2247781008,2511239611,4759020619,220,1868,12,263458603,In > Out
Feb 2020,98,68,697,89570921,1456023664,1545594585,150,686,5,1366452743,In > Out
Feb 2020,98,70,1045,164264798,2464889278,2629154076,206,1022,15,2300624480,In > Out
Feb 2020,98,72,588,100171887,6113064042,6213235929,210,573,6,6012892155,In > Out
Feb 2020,98,73,1065,193731834,3897942329,4091674163,264,1039,8,3704210495,In > Out
Feb 2020,98,75,902,540651110,2277401195,2818052305,275,885,8,1736750085,In > Out
Feb 2020,98,76,196,23737142,670306800,694043942,66,196,5,646569658,In > Out
Feb 2020,98,77,1189,728607378,5487268733,6215876111,284,1171,6,4758661355,In > Out
Feb 2020,98,78,1207,372685176,12198427826,12571113002,303,1197,4,11825742650,In > Out
Feb 2020,98,79,795,169770267,8712063993,8881834260,295,775,3,8542293726,In > Out
Feb 2020,98,8,828,1302502296,2321687484,3624189780,172,822,5,1019185188,In > Out
Feb 2020,98,80,1364,405154983,9835725073,10240880056,331,1334,9,9430570090,In > Out
Feb 2020,98,81,272,70211187,3183043973,3253255160,87,270,4,3112832786,In > Out
Feb 2020,98,82,741,122155974,2831022802,2953178776,238,726,6,2708866828,In > Out
Feb 2020,98,83,541,35987909,1072893223,1108881132,113,523,6,1036905314,In > Out
Feb 2020,98,84,412,52203192,3435278584,3487481776,153,412,3,3383075392,In > Out
Feb 2020,98,86,1098,595379011,5646677952,6242056963,405,1080,92,5051298941,In > Out
Feb 2020,98,87,478,143629998,5959793263,6103423261,197,473,2,5816163265,In > Out
Feb 2020,98,90,342,128769521,1037634855,1166404376,93,341,8,908865334,In > Out
Feb 2020,98,93,671,140797250,5051026806,5191824056,176,659,4,4910229556,In > Out
Feb 2020,98,94,295,188650834,591589746,780240580,115,294,8,402938912,In > Out
Feb 2020,98,96,1029,679699821,5466846858,6146546679,304,991,6,4787147037,In > Out
Feb 2020,98,97,522,420878009,6145786873,6566664882,153,509,4,5724908864,In > Out
Feb 2020,98,98,761,555796970,2522595232,3078392202,225,748,6,1966798262,In > Out
Feb 2020,98,99,677,173834673,2822230005,2996064678,258,667,8,2648395332,In > Out
Feb 2020,99,103,65,6532081,81175115,87707196,42,65,3,74643034,In > Out
Feb 2020,99,115,883,40074038,2078594079,2118668117,264,883,5,2038520041,In > Out
Feb 2020,99,121,718,23495768,349938814,373434582,139,697,4,326443046,In > Out
Feb 2020,99,123,302,181848689,115024003,296872692,115,280,17,66824686,Out > In
Feb 2020,99,128,81,3431478,128617571,132049049,40,81,2,125186093,In > Out
Feb 2020,99,130,252,4712131,115104766,119816897,43,252,2,110392635,In > Out
Feb 2020,99,131,3,272908,30194819,30467727,1,3,1,29921911,In > Out
Feb 2020,99,153,848,89766353,725112560,814878913,196,832,2,635346207,In > Out
Feb 2020,99,154,1663,847531650,12938249635,13785781285,295,1605,2,12090717985,In > Out
Feb 2020,99,160,8,227456,49421240,49648696,3,8,1,49193784,In > Out
Feb 2020,99,162,26,2289300,128198353,130487653,15,26,2,125909053,In > Out
Feb 2020,99,167,932,56272114,2959613898,3015886012,334,897,2,2903341784,In > Out
Feb 2020,99,168,293,14205982,384407987,398613969,79,291,2,370202005,In > Out
Feb 2020,99,170,10,234972,37003686,37238658,3,10,1,36768714,In > Out
Feb 2020,99,177,129,126887021,471242811,598129832,57,129,2,344355790,In > Out
Feb 2020,99,178,784,60138673,1064621588,1124760261,167,768,2,1004482915,In > Out
Feb 2020,99,182,3,12509,610418,622927,3,3,1,597909,In > Out
Feb 2020,99,188,8,214772,49896530,50111302,3,8,1,49681758,In > Out
Feb 2020,99,207,1523,111408680,5045779536,5157188216,405,1469,5,4934370856,In > Out
Feb 2020,99,208,1364,143731574,5661744638,5805476212,361,1317,5,5518013064,In > Out
Feb 2020,99,209,8,452057,19383528,19835585,7,8,2,18931471,In > Out
Feb 2020,99,243,1,5547,98066,103613,1,1,1,92519,In > Out
Feb 2020,99,246,1677,2781599108,14472997470,17254596578,324,1607,11,11691398362,In > Out
Feb 2020,99,248,273,11189804,252707301,263897105,59,273,2,241517497,In > Out
Feb 2020,99,47,9,170168,48843301,49013469,2,9,1,48673133,In > Out
Feb 2020,99,51,1500,6289001669,1526261223,7815262892,360,1441,10,4762740446,Out > In
Feb 2020,99,55,9,68374,3923889,3992263,3,9,1,3855515,In > Out
Feb 2020,99,60,4,11730,610637,622367,2,4,1,598907,In > Out
Feb 2020,99,69,6,19723,1130651,1150374,1,6,1,1110928,In > Out
Feb 2020,99,75,905,273887955,1035411814,1309299769,137,888,8,761523859,In > Out
Feb 2020,99,76,6,17666,956506,974172,1,6,1,938840,In > Out
Feb 2020,99,77,580,41949365,487566492,529515857,183,567,3,445617127,In > Out
Feb 2020,99,92,2202,237232160,10702893201,10940125361,265,2029,3,10465661041,In > Out
Apr 2020,10,200,14,805895,181559734,182365629,1,14,1,180753839,In > Out
Apr 2020,10,4,4,38590,1851955,1890545,1,4,1,1813365,In > Out
Apr 2020,100,132,2807,548230089,447779408,996009497,111,2554,30,100450681,Out > In
Apr 2020,100,148,289,1683228253,163043337,1846271590,99,286,8,1520184916,Out > In
Apr 2020,100,161,20,3377488,158831243,162208731,10,20,2,155453755,In > Out
Apr 2020,100,181,524,156590416,2156345081,2312935497,144,512,5,1999754665,In > Out
Apr 2020,100,229,7,378187,16828962,17207149,6,7,2,16450775,In > Out
Apr 2020,100,239,82,11983247,169896081,181879328,18,82,2,157912834,In > Out
Apr 2020,100,37,196,11458650,148511427,159970077,14,194,2,137052777,In > Out
Apr 2020,100,78,26,1902236,67787974,69690210,14,26,1,65885738,In > Out
Apr 2020,101,106,178,12407608,691223838,703631446,20,177,2,678816230,In > Out
Apr 2020,101,109,105,8754211,1282095154,1290849365,46,105,2,1273340943,In > Out
Apr 2020,101,111,211,15320335,661221778,676542113,25,211,2,645901443,In > Out
Apr 2020,101,112,1437,225048581,1214603944,1439652525,181,1397,3,989555363,In > Out
Apr 2020,101,135,172,18428754,1483470494,1501899248,48,172,2,1465041740,In > Out
Apr 2020,101,137,26,1598650,54246934,55845584,5,26,1,52648284,In > Out
Apr 2020,101,139,3,497795,60782079,61279874,3,3,2,60284284,In > Out
Apr 2020,101,158,11,153326,24556669,24709995,8,11,2,24403343,In > Out
Apr 2020,101,160,16024,28657751733,35209802072,63867553805,2886,3638,3164,6552050339,In > Out
Apr 2020,101,163,226,8251934,151244724,159496658,54,226,2,142992790,In > Out
Apr 2020,101,175,11,3304933,197967214,201272147,3,11,2,194662281,In > Out
Apr 2020,101,183,219,7027695,169062289,176089984,27,219,2,162034594,In > Out
Apr 2020,101,184,18,594003,26681421,27275424,10,18,2,26087418,In > Out
Apr 2020,101,191,695,57364849,603562353,660927202,105,687,2,546197504,In > Out
Apr 2020,101,197,676,22757505,2244649676,2267407181,112,676,2,2221892171,In > Out
Apr 2020,101,201,25,1920274,76677278,78597552,14,25,2,74757004,In > Out
Apr 2020,101,203,73,1375673,81345473,82721146,23,73,2,79969800,In > Out
Apr 2020,101,207,74,7775573,633355084,641130657,38,74,2,625579511,In > Out
Apr 2020,101,209,27,1299596,60617710,61917306,10,27,1,59318114,In > Out
Apr 2020,101,213,8,825384,62832218,63657602,2,8,1,62006834,In > Out
Apr 2020,101,223,999,192310904,1688576220,1880887124,153,968,7,1496265316,In > Out
Apr 2020,101,224,708,198866675,68801353,267668028,47,708,2,130065322,Out > In
Apr 2020,101,231,962,96391845,1364322070,1460713915,163,948,2,1267930225,In > Out
Apr 2020,101,37,529,216937715,3069645895,3286583610,105,519,4,2852708180,In > Out
Apr 2020,101,49,10,3173676,330891031,334064707,4,10,2,327717355,In > Out
Apr 2020,101,76,479,130457311,2009823230,2140280541,201,459,9,1879365919,In > Out
Apr 2020,101,91,198,15243570,1606033376,1621276946,45,196,2,1590789806,In > Out
Apr 2020,101,97,590,53328161,476709082,530037243,57,577,2,423380921,In > Out
Apr 2020,101,98,155,3839366,157080698,160920064,17,153,2,153241332,In > Out
Apr 2020,102,102,85,96719423,52773110,149492533,10,76,11,43946313,Out > In
Apr 2020,103,225,1192,513962274,802888839,1316851113,144,1166,2,288926565,In > Out
Apr 2020,103,230,271,14909588,172669829,187579417,24,270,2,157760241,In > Out
Apr 2020,103,232,1201,186018872,1351688670,1537707542,141,1180,5,1165669798,In > Out
Apr 2020,103,234,214,4985377,106568691,111554068,26,213,2,101583314,In > Out
Apr 2020,103,237,404,16417215,1308211837,1324629052,117,401,3,1291794622,In > Out
Apr 2020,103,239,362,6633040,927593529,934226569,24,362,2,920960489,In > Out
Apr 2020,103,240,222,17220153,192062010,209282163,11,219,2,174841857,In > Out
Apr 2020,103,241,14,7439018,3024962,10463980,7,14,1,4414056,Out > In
Apr 2020,103,246,38,1273952,20312849,21586801,12,31,1,19038897,In > Out
Apr 2020,104,108,674,295516196,1958287529,2253803725,101,672,3,1662771333,In > Out
Apr 2020,104,120,165,8795222,134294660,143089882,81,165,2,125499438,In > Out
Apr 2020,104,127,641,74472258,316514825,390987083,97,634,2,242042567,In > Out
Apr 2020,104,150,419,292048509,6230767929,6522816438,70,419,3,5938719420,In > Out
Apr 2020,104,155,167,2152892,581569305,583722197,23,167,2,579416413,In > Out
Apr 2020,104,161,57,1191903,39501448,40693351,5,57,2,38309545,In > Out
Apr 2020,104,163,220,12242776,588249273,600492049,31,220,2,576006497,In > Out
Apr 2020,104,170,11,690284,5052959,5743243,8,11,2,4362675,In > Out
Apr 2020,104,171,1257,258601842,1976612072,2235213914,194,1222,3,1718010230,In > Out
Apr 2020,104,194,797,94785918,1396999078,1491784996,68,775,2,1302213160,In > Out
Apr 2020,104,206,342,79465095,667634872,747099967,136,341,3,588169777,In > Out
Apr 2020,104,210,47,5326064,306142405,311468469,20,47,3,300816341,In > Out
Apr 2020,104,220,1137,257154235,618554671,875708906,82,1109,3,361400436,In > Out
Apr 2020,104,227,880,334104884,698634179,1032739063,158,852,2,364529295,In > Out
Apr 2020,104,231,59,1017930,77432119,78450049,24,59,2,76414189,In > Out
Apr 2020,104,232,99,9125998,485479120,494605118,20,99,2,476353122,In > Out
Apr 2020,104,233,370,111491643,382830872,494322515,118,366,2,271339229,In > Out
Apr 2020,104,237,722,1078304782,4928430801,6006735583,134,712,7,3850126019,In > Out
Apr 2020,104,250,108,5337366,314502832,319840198,28,108,2,309165466,In > Out
Apr 2020,104,49,407,183283963,18748867211,18932151174,125,396,2,18565583248,In > Out
Apr 2020,104,56,714,102562458,821058837,923621295,142,703,2,718496379,In > Out
Apr 2020,104,59,676,145608176,2336676911,2482285087,123,669,3,2191068735,In > Out
Apr 2020,104,61,282,118050464,448738097,566788561,70,280,2,330687633,In > Out
Apr 2020,104,77,18,628090,33922264,34550354,10,18,2,33294174,In > Out
Apr 2020,104,81,1644,169809032,1287406552,1457215584,105,1579,4,1117597520,In > Out
Apr 2020,104,85,59,1558729,156660176,158218905,29,59,3,155101447,In > Out
Apr 2020,104,90,137,7808678,329946261,337754939,65,137,2,322137583,In > Out
Apr 2020,11,10,1,3264,199443,202707,1,1,1,196179,In > Out
Apr 2020,11,6,1,227323,15560,242883,1,1,1,211763,Out > In
Apr 2020,11,65,7,487071,1386407,1873478,5,7,1,899336,In > Out
Apr 2020,11,70,3,40806,286548,327354,2,3,1,245742,In > Out
Apr 2020,11,80,6,414514,9648172,10062686,5,6,2,9233658,In > Out
Apr 2020,11,88,1333,159059529,865302016,1024361545,181,1329,2,706242487,In > Out
Apr 2020,11,92,1,134821,12392899,12527720,1,1,1,12258078,In > Out
Apr 2020,110,133,105,8315366,486974425,495289791,37,90,2,478659059,In > Out
Apr 2020,110,161,178,5141163,371958013,377099176,17,176,2,366816850,In > Out
Apr 2020,110,212,171,12018181,748655754,760673935,45,171,2,736637573,In > Out
Apr 2020,110,75,254,3621683,125972348,129594031,13,252,2,122350665,In > Out
Apr 2020,111,5,59,12438875,13002657,25441532,3,6,2,563782,In > Out
Apr 2020,112,10,1745,896964846,2388282867,3285247713,223,1700,6,1491318021,In > Out
Apr 2020,112,100,398,197729110,3970954062,4168683172,144,394,12,3773224952,In > Out
Apr 2020,112,102,50,3451427,51111620,54563047,13,50,1,47660193,In > Out
Apr 2020,112,104,659,113750361,7141296718,7255047079,232,656,3,7027546357,In > Out
Apr 2020,112,105,580,243495930,3136220563,3379716493,151,568,26,2892724633,In > Out
Apr 2020,112,107,526,160307620,4511950406,4672258026,178,522,3,4351642786,In > Out
Apr 2020,112,109,56,6065996,416338928,422404924,22,56,1,410272932,In > Out
Apr 2020,112,111,409,725195579,1391083891,2116279470,142,409,8,665888312,In > Out
Apr 2020,112,112,1033,81828342,2675226443,2757054785,256,954,6,2593398101,In > Out
Apr 2020,112,114,69,8120674,393766376,401887050,23,69,1,385645702,In > Out
Apr 2020,112,115,147,21607207,176954389,198561596,70,147,1,155347182,In > Out
Apr 2020,112,117,14,121483453,249677014,371160467,10,14,3,128193561,In > Out
Apr 2020,112,119,111,110231926,5202061615,5312293541,33,111,4,5091829689,In > Out
Apr 2020,112,123,413,83454311,4673093166,4756547477,154,404,7,4589638855,In > Out
Apr 2020,112,126,6,188407,1710744,1899151,6,6,1,1522337,In > Out
Apr 2020,112,127,15,2310102,10292054,12602156,14,14,3,7981952,In > Out
Apr 2020,112,128,361,60487192,4592896613,4653383805,143,361,2,4532409421,In > Out
Apr 2020,112,129,159,27253682,352849364,380103046,51,157,4,325595682,In > Out
Apr 2020,112,130,1,271807,172131,443938,1,1,1,99676,Out > In
Apr 2020,112,131,8,623638,2156123,2779761,5,8,1,1532485,In > Out
Apr 2020,112,132,363,64086311,2824870788,2888957099,145,363,4,2760784477,In > Out
Apr 2020,112,133,123,44478190,1375060758,1419538948,39,123,2,1330582568,In > Out
Apr 2020,112,134,11,936979,4082484,5019463,10,11,2,3145505,In > Out
Apr 2020,112,135,45,7263326,267087895,274351221,25,45,2,259824569,In > Out
Apr 2020,112,136,146,148239077,3088886023,3237125100,47,146,3,2940646946,In > Out
Apr 2020,112,137,482,182076811,696606356,878683167,246,480,6,514529545,In > Out
Apr 2020,112,138,80,13151119,717426475,730577594,50,80,1,704275356,In > Out
Apr 2020,112,139,24,1253177,9463979,10717156,14,24,1,8210802,In > Out
Apr 2020,112,14,607,90461755,3163044932,3253506687,225,605,3,3072583177,In > Out
Apr 2020,112,141,246,31606349,1070362494,1101968843,99,246,3,1038756145,In > Out
Apr 2020,112,142,131,14355986,153276326,167632312,78,131,4,138920340,In > Out
Apr 2020,112,143,753,291200852,4944469830,5235670682,292,748,8,4653268978,In > Out
Apr 2020,112,144,519,96927821,3926285978,4023213799,222,514,4,3829358157,In > Out
Apr 2020,112,145,64,26804923,986112477,1012917400,29,64,3,959307554,In > Out
Apr 2020,112,146,2,403745,17538355,17942100,2,2,2,17134610,In > Out
Apr 2020,112,147,1072,136877603,1676035302,1812912905,229,994,8,1539157699,In > Out
Apr 2020,112,148,42,3383993,129822835,133206828,29,42,2,126438842,In > Out
Apr 2020,112,149,14,982122,39079813,40061935,7,14,1,38097691,In > Out
Apr 2020,112,15,457,137114984,667134630,804249614,83,447,7,530019646,In > Out
Apr 2020,112,150,152,71472509,226519871,297992380,78,151,2,155047362,In > Out
Apr 2020,112,151,872,1206192184,2085655698,3291847882,229,871,5,879463514,In > Out
Apr 2020,112,152,1657,121269448,7386333753,7507603201,214,1560,9,7265064305,In > Out
Apr 2020,112,153,4290,768277395,4760790030,5529067425,376,4021,8,3992512635,In > Out
Apr 2020,112,154,36,3102196,17178690,20280886,19,36,2,14076494,In > Out
Apr 2020,112,155,1769,586563983,10002773426,10589337409,257,1707,12,9416209443,In > Out
Apr 2020,112,156,125,27014362,106501494,133515856,63,125,8,79487132,In > Out
Apr 2020,112,157,970,124083909,12110401688,12234485597,429,967,3,11986317779,In > Out
Apr 2020,112,158,792,118438514,4132825434,4251263948,138,769,5,4014386920,In > Out
Apr 2020,112,159,84,2800940,70335115,73136055,23,84,3,67534175,In > Out
Apr 2020,112,160,346,21593276,1263322830,1284916106,118,346,4,1241729554,In > Out
Apr 2020,112,161,256,12528603,233541567,246070170,88,256,5,221012964,In > Out
Apr 2020,112,162,68,3974528,86785120,90759648,24,68,3,82810592,In > Out
Apr 2020,112,164,6,1862563,110463433,112325996,4,6,1,108600870,In > Out
Apr 2020,112,165,266,309292648,400862239,710154887,105,266,5,91569591,In > Out
Apr 2020,112,168,156,7360380,650678306,658038686,39,155,2,643317926,In > Out
Apr 2020,112,169,719,84740614,11131714890,11216455504,279,718,2,11046974276,In > Out
Apr 2020,112,170,156,16012007,670203244,686215251,52,156,2,654191237,In > Out
Apr 2020,112,173,151,11938525,86544125,98482650,72,151,3,74605600,In > Out
Apr 2020,112,174,420,468321011,2334409320,2802730331,146,419,4,1866088309,In > Out
Apr 2020,112,175,1076,544600482,7866768075,8411368557,256,1008,53,7322167593,In > Out
Apr 2020,112,176,9,409464,19010983,19420447,5,9,1,18601519,In > Out
Apr 2020,112,177,283,18988162,561825336,580813498,67,247,24,542837174,In > Out
Apr 2020,112,178,340,79116112,518820779,597936891,165,340,5,439704667,In > Out
Apr 2020,112,179,602,81277738,1353002069,1434279807,109,593,4,1271724331,In > Out
Apr 2020,112,180,38,5679196,26480566,32159762,31,38,2,20801370,In > Out
Apr 2020,112,181,24,9533221,439952773,449485994,17,24,5,430419552,In > Out
Apr 2020,112,182,339,423452014,2212678467,2636130481,146,339,3,1789226453,In > Out
Apr 2020,112,183,436,75661648,3823702302,3899363950,134,432,3,3748040654,In > Out
Apr 2020,112,184,2164,212393483,25458327579,25670721062,540,2070,5,25245934096,In > Out
Apr 2020,112,185,228,74950034,1125533053,1200483087,95,228,20,1050583019,In > Out
Apr 2020,112,186,538,432056337,2901389259,3333445596,126,474,12,2469332922,In > Out
Apr 2020,112,187,95,7764199,123337311,131101510,42,95,3,115573112,In > Out
Apr 2020,112,189,11,686231,4787851,5474082,8,11,2,4101620,In > Out
Apr 2020,112,190,2148,272851333,3196572912,3469424245,430,2077,13,2923721579,In > Out
Apr 2020,112,191,528,40420674,3810533531,3850954205,187,521,3,3770112857,In > Out
Apr 2020,112,193,197,30728196,1452356968,1483085164,58,196,6,1421628772,In > Out
Apr 2020,112,199,37,6269811,187413238,193683049,28,37,2,181143427,In > Out
Apr 2020,112,202,522,358430072,11181964329,11540394401,137,511,7,10823534257,In > Out
Apr 2020,112,203,62,3210318,74523550,77733868,20,62,3,71313232,In > Out
Apr 2020,112,204,538,152084456,10214245424,10366329880,190,536,2,10062160968,In > Out
Apr 2020,112,205,79,5729908,31888340,37618248,34,79,1,26158432,In > Out
Apr 2020,112,206,167,25165819,1024056850,1049222669,68,167,3,998891031,In > Out
Apr 2020,112,207,10,629644,3072818,3702462,6,10,2,2443174,In > Out
Apr 2020,112,208,186,20217094,974172386,994389480,49,186,5,953955292,In > Out
Apr 2020,112,209,564,112101022,5855230597,5967331619,197,564,3,5743129575,In > Out
Apr 2020,112,211,544,85876376,2632845123,2718721499,218,537,3,2546968747,In > Out
Apr 2020,112,212,79,462331735,489734340,952066075,23,79,6,27402605,In > Out
Apr 2020,112,216,439,60930784,1629440037,1690370821,71,439,4,1568509253,In > Out
Apr 2020,112,219,426,23663921,623460122,647124043,109,421,4,599796201,In > Out
Apr 2020,112,22,564,352493831,1774882119,2127375950,199,560,32,1422388288,In > Out
Apr 2020,112,220,399,62758114,5868189790,5930947904,131,391,2,5805431676,In > Out
Apr 2020,112,223,656,558055859,4725302190,5283358049,156,656,4,4167246331,In > Out
Apr 2020,112,25,1257,152341374,2188283373,2340624747,162,1215,6,2035941999,In > Out
Apr 2020,112,28,1446,618762930,4932730463,5551493393,260,1386,8,4313967533,In > Out
Apr 2020,112,31,40,5912084,99347950,105260034,26,40,3,93435866,In > Out
Apr 2020,112,32,125,13042188,302184314,315226502,36,124,3,289142126,In > Out
Apr 2020,112,33,128,2629811,495328527,497958338,18,128,2,492698716,In > Out
Apr 2020,112,36,151,15636447,184015394,199651841,58,151,2,168378947,In > Out
Apr 2020,112,38,132,27238111,1028486299,1055724410,79,132,27,1001248188,In > Out
Apr 2020,112,39,904,34741962,1998587922,2033329884,77,887,2,1963845960,In > Out
Apr 2020,112,40,57,192060911,36991433,229052344,28,57,5,155069478,Out > In
Apr 2020,112,41,942,230089311,5458720807,5688810118,290,931,3,5228631496,In > Out
Apr 2020,112,42,208,75087118,5412526233,5487613351,75,208,2,5337439115,In > Out
Apr 2020,112,45,20,421818,8891449,9313267,13,20,2,8469631,In > Out
Apr 2020,112,49,367,46906693,2645737180,2692643873,136,367,6,2598830487,In > Out
Apr 2020,112,50,1261,114403619,5401808410,5516212029,226,1223,6,5287404791,In > Out
Apr 2020,112,53,681,100374085,4710077746,4810451831,106,652,4,4609703661,In > Out
Apr 2020,112,54,655,196010996,5724581842,5920592838,166,648,6,5528570846,In > Out
Apr 2020,112,59,120,17562847,316874800,334437647,43,120,3,299311953,In > Out
Apr 2020,112,6,31,65137348,89557731,154695079,20,30,3,24420383,In > Out
Apr 2020,112,64,855,134222654,7297520182,7431742836,282,855,4,7163297528,In > Out
Apr 2020,112,67,37,1782136,58876877,60659013,23,37,2,57094741,In > Out
Apr 2020,112,68,455,216213405,2924879859,3141093264,82,443,16,2708666454,In > Out
Apr 2020,112,71,321,54328415,2762762206,2817090621,125,321,11,2708433791,In > Out
Apr 2020,112,72,89,11952526,134186504,146139030,24,89,2,122233978,In > Out
Apr 2020,112,73,1819,679450645,7038236061,7717686706,288,1753,8,6358785416,In > Out
Apr 2020,112,74,9,424848,26369030,26793878,4,9,1,25944182,In > Out
Apr 2020,112,76,508,290717434,2633479986,2924197420,129,497,9,2342762552,In > Out
Apr 2020,112,78,1097,234565181,7917438016,8152003197,226,1030,7,7682872835,In > Out
Apr 2020,112,84,238,31101346,1750758717,1781860063,53,238,3,1719657371,In > Out
Apr 2020,112,86,1144,1074203575,3873559316,4947762891,115,1128,20,2799355741,In > Out
Apr 2020,112,88,52,3710849,169908187,173619036,20,52,2,166197338,In > Out
Apr 2020,112,90,54,3147068,44101783,47248851,25,54,2,40954715,In > Out
Apr 2020,112,91,81,250747638,328743819,579491457,40,81,2,77996181,In > Out
Apr 2020,112,93,219,36782335,2011505383,2048287718,70,219,5,1974723048,In > Out
Apr 2020,112,94,224,24038888,520512611,544551499,62,224,2,496473723,In > Out
Apr 2020,112,96,18,1048244,62110659,63158903,7,18,1,61062415,In > Out
Apr 2020,112,97,60,205645816,592398418,798044234,31,60,3,386752602,In > Out
Apr 2020,114,110,86,172933273,58670768,231604041,47,84,6,114262505,Out > In
Apr 2020,115,155,37,2920775,152465129,155385904,22,37,2,149544354,In > Out
Apr 2020,115,159,112,1057106,286534179,287591285,17,112,2,285477073,In > Out
Apr 2020,115,160,66,1614214,207603827,209218041,26,66,2,205989613,In > Out
Apr 2020,115,161,177,9040938,426874966,435915904,20,177,2,417834028,In > Out
Apr 2020,115,164,64,1295201,371534542,372829743,19,64,2,370239341,In > Out
Apr 2020,115,169,16,902303,49497731,50400034,12,16,2,48595428,In > Out
Apr 2020,115,181,1,3753,193450,197203,1,1,1,189697,In > Out
Apr 2020,115,185,211,47091472,1713715956,1760807428,71,209,2,1666624484,In > Out
Apr 2020,115,189,149,7679664,433412474,441092138,20,149,2,425732810,In > Out
Apr 2020,115,193,154,41269792,317136800,358406592,53,151,2,275867008,In > Out
Apr 2020,115,195,1024,158744314,256914214,415658528,53,1015,4,98169900,In > Out
Apr 2020,115,20,122,1823170,386477273,388300443,26,122,2,384654103,In > Out
Apr 2020,115,201,1700,496925224,284661223,781586447,98,1635,2,212264001,Out > In
Apr 2020,115,211,713,42613350,1360964931,1403578281,37,701,2,1318351581,In > Out
Apr 2020,115,26,363,45062664,684706614,729769278,72,359,2,639643950,In > Out
Apr 2020,115,27,49,2719413,126065812,128785225,20,49,2,123346399,In > Out
Apr 2020,115,28,60,1507340,467178314,468685654,11,60,2,465670974,In > Out
Apr 2020,115,29,164,6699594,388748976,395448570,23,164,2,382049382,In > Out
Apr 2020,115,31,64,1206645,541054706,542261351,16,64,2,539848061,In > Out
Apr 2020,115,32,33,1450988,323130337,324581325,15,32,2,321679349,In > Out
Apr 2020,115,35,14,373406,21434837,21808243,8,14,2,21061431,In > Out
Apr 2020,115,73,179,8737818,491699456,500437274,20,179,2,482961638,In > Out
Apr 2020,115,76,107,1130313,431458038,432588351,18,107,2,430327725,In > Out
Apr 2020,115,81,64,1016157,450278441,451294598,18,64,2,449262284,In > Out
Apr 2020,115,89,96,1586803,230444969,232031772,41,96,2,228858166,In > Out
Apr 2020,115,92,236,2945622,805286691,808232313,20,236,2,802341069,In > Out
Apr 2020,115,95,254,13316638,684242257,697558895,23,254,2,670925619,In > Out
Apr 2020,117,147,857,35920434,3393736709,3429657143,274,849,2,3357816275,In > Out
Apr 2020,117,148,1017,11182379,2241387330,2252569709,310,1010,2,2230204951,In > Out
Apr 2020,117,149,75,26904789335,281054667,27185844002,32,45,3,26623734668,Out > In
Apr 2020,117,153,95,7524854,618167644,625692498,40,79,2,610642790,In > Out
Apr 2020,117,154,3,77463,3255967,3333430,1,1,1,3178504,In > Out
Apr 2020,117,158,4,436672,128545,565217,2,4,1,308127,Out > In
Apr 2020,117,16,249,23971713,631256372,655228085,63,248,2,607284659,In > Out
Apr 2020,117,177,688,47907178,992978553,1040885731,172,672,3,945071375,In > Out
Apr 2020,117,183,8,1023760,364327,1388087,2,8,1,659433,Out > In
Apr 2020,117,209,4782,6887157593,14229656616,21116814209,788,4592,8,7342499023,In > Out
Apr 2020,117,233,2,352978,75010,427988,2,2,1,277968,Out > In
Apr 2020,117,236,14,12625870,25000175,37626045,2,14,2,12374305,In > Out
Apr 2020,117,238,2718,1749052073,9185042178,10934094251,556,2508,4,7435990105,In > Out
Apr 2020,117,254,41,1419167741,49892211,1469059952,28,1,6,1369275530,Out > In
Apr 2020,117,50,223,31638265,20687451,52325716,2,222,4,10950814,Out > In
Apr 2020,117,61,363,20556494,801535725,822092219,56,358,4,780979231,In > Out
Apr 2020,117,76,27,10888164,6948660,17836824,1,1,1,3939504,Out > In
Apr 2020,117,81,7,846726,286630,1133356,2,7,1,560096,Out > In
Apr 2020,118,104,79,24440107,754616045,779056152,52,79,2,730175938,In > Out
Apr 2020,118,106,128,2499927,585856232,588356159,13,128,2,583356305,In > Out
Apr 2020,118,108,936,139458069,9638400748,9777858817,321,907,4,9498942679,In > Out
Apr 2020,118,114,236,16962159,908786171,925748330,21,236,2,891824012,In > Out
Apr 2020,118,119,77,5028437,243473754,248502191,20,77,2,238445317,In > Out
Apr 2020,118,120,23,1218582,70659351,71877933,22,23,2,69440769,In > Out
Apr 2020,118,124,580,62124792,79303321,141428113,26,575,2,17178529,In > Out
Apr 2020,118,128,292,2725200,478802542,481527742,28,292,2,476077342,In > Out
Apr 2020,118,130,1501,141924178,2405246556,2547170734,386,1455,3,2263322378,In > Out
Apr 2020,118,132,190,18339092,344357186,362696278,72,188,3,326018094,In > Out
Apr 2020,118,134,99,5911995,283713790,289625785,21,99,2,277801795,In > Out
Apr 2020,118,143,45,108284469,50491523,158775992,20,44,4,57792946,Out > In
Apr 2020,118,154,1,15893,748881,764774,1,1,1,732988,In > Out
Apr 2020,118,156,115,13964304,785668096,799632400,20,115,2,771703792,In > Out
Apr 2020,118,157,94,5217121,327686951,332904072,19,93,2,322469830,In > Out
Apr 2020,118,160,309,11998562,228930891,240929453,86,305,2,216932329,In > Out
Apr 2020,118,162,412,327280737,438076857,765357594,93,356,16,110796120,In > Out
Apr 2020,118,165,26,4570285,160827972,165398257,20,26,2,156257687,In > Out
Apr 2020,118,168,27,427120,12638892,13066012,13,27,2,12211772,In > Out
Apr 2020,118,171,11,250728,2680509,2931237,4,11,2,2429781,In > Out
Apr 2020,118,176,24,6611828,321320527,327932355,18,24,2,314708699,In > Out
Apr 2020,118,177,112,15629992,739016828,754646820,18,112,2,723386836,In > Out
Apr 2020,118,178,6,508181,13410201,13918382,3,6,2,12902020,In > Out
Apr 2020,118,179,541,60482022,4014564055,4075046077,93,540,2,3954082033,In > Out
Apr 2020,118,181,1,45126,4128978,4174104,1,1,1,4083852,In > Out
Apr 2020,118,182,9,609845,531602,1141447,4,8,2,78243,Out > In
Apr 2020,118,184,644,15375616,262531574,277907190,61,633,2,247155958,In > Out
Apr 2020,118,187,11,806389,26972691,27779080,7,11,2,26166302,In > Out
Apr 2020,118,207,275,331829730,1203533150,1535362880,97,272,2,871703420,In > Out
Apr 2020,118,210,3861,2174153661,8946110638,11120264299,140,3378,4,6771956977,In > Out
Apr 2020,118,212,109,7447176,285450842,292898018,72,109,2,278003666,In > Out
Apr 2020,118,215,3,412532,21382354,21794886,2,3,2,20969822,In > Out
Apr 2020,118,216,27,3380962,134975591,138356553,12,27,2,131594629,In > Out
Apr 2020,118,225,639,108299744,1281899944,1390199688,101,632,3,1173600200,In > Out
Apr 2020,118,226,1,6615,165090,171705,1,1,1,158475,In > Out
Apr 2020,118,229,53,15818129,272411390,288229519,14,53,2,256593261,In > Out
Apr 2020,118,230,1021,736987959,1602159665,2339147624,209,992,2,865171706,In > Out
Apr 2020,118,232,73,4260423,246771524,251031947,21,72,2,242511101,In > Out
Apr 2020,118,233,610,49917719,498764735,548682454,171,605,5,448847016,In > Out
Apr 2020,118,237,300,19998350,945709682,965708032,47,300,2,925711332,In > Out
Apr 2020,118,240,215,16616950,1709029511,1725646461,87,215,2,1692412561,In > Out
Apr 2020,118,246,114,9349864,561702250,571052114,38,93,4,552352386,In > Out
Apr 2020,118,254,464,34415549,1616476651,1650892200,35,464,2,1582061102,In > Out
Apr 2020,118,26,707,105498544,40423086,145921630,23,707,2,65075458,Out > In
Apr 2020,118,27,547,47494893,1423999238,1471494131,88,539,5,1376504345,In > Out
Apr 2020,118,34,79,3321789,201200435,204522224,20,79,2,197878646,In > Out
Apr 2020,118,40,428,51637929,368642110,420280039,35,423,2,317004181,In > Out
Apr 2020,118,46,5,676466,1876135,2552601,4,5,2,1199669,In > Out
Apr 2020,118,47,278,34429753,1409229352,1443659105,87,277,4,1374799599,In > Out
Apr 2020,118,48,68,2778601,203150424,205929025,16,68,2,200371823,In > Out
Apr 2020,118,54,10,3509738,161262880,164772618,6,10,2,157753142,In > Out
Apr 2020,118,56,28,952207,98699059,99651266,5,28,2,97746852,In > Out
Apr 2020,118,58,7,323877,11663171,11987048,6,7,2,11339294,In > Out
Apr 2020,118,59,1046,554760378,33422193505,33976953883,109,1037,500,32867433127,In > Out
Apr 2020,118,63,150,9746847,1547959367,1557706214,22,143,3,1538212520,In > Out
Apr 2020,118,65,150,8931918,813387940,822319858,49,150,2,804456022,In > Out
Apr 2020,118,70,86,5011656,320290050,325301706,35,86,2,315278394,In > Out
Apr 2020,118,71,1292,197978453,6091792388,6289770841,344,1263,2,5893813935,In > Out
Apr 2020,118,72,117,13035790,318916887,331952677,48,117,2,305881097,In > Out
Apr 2020,118,74,1,210734,19048,229782,1,1,1,191686,Out > In
Apr 2020,118,77,4,157152,4775286,4932438,3,4,2,4618134,In > Out
Apr 2020,118,79,247,7189927,417207855,424397782,50,245,2,410017928,In > Out
Apr 2020,118,80,74,40327471,135445627,175773098,13,74,3,95118156,In > Out
Apr 2020,118,81,1,511864,17950,529814,1,1,1,493914,Out > In
Apr 2020,118,82,336,187017420,3220952875,3407970295,76,336,3,3033935455,In > Out
Apr 2020,118,83,17,724966,252517156,253242122,9,17,2,251792190,In > Out
Apr 2020,118,85,246,16503794,1102906308,1119410102,40,245,5,1086402514,In > Out
Apr 2020,118,97,137,10350593,1562370810,1572721403,58,137,2,1552020217,In > Out
Apr 2020,118,99,418,6649041,1503744878,1510393919,29,418,2,1497095837,In > Out
Apr 2020,119,102,12,1446756,367783022,369229778,7,12,2,366336266,In > Out
Apr 2020,119,105,2,1637028,319593369,321230397,1,2,1,317956341,In > Out
Apr 2020,119,107,118,3784087,535902754,539686841,37,118,2,532118667,In > Out
Apr 2020,119,108,54,3309534,156333827,159643361,21,54,2,153024293,In > Out
Apr 2020,119,109,775,189371850,701912862,891284712,106,750,2,512541012,In > Out
Apr 2020,119,111,269,24537704,500319782,524857486,86,269,2,475782078,In > Out
Apr 2020,119,114,6,5224314,582723266,587947580,2,6,2,577498952,In > Out
Apr 2020,119,122,409,6354491,1410711673,1417066164,31,407,2,1404357182,In > Out
Apr 2020,119,128,955,193901397,763285046,957186443,73,934,2,569383649,In > Out
Apr 2020,119,129,136,5289756,490593010,495882766,51,135,2,485303254,In > Out
Apr 2020,119,133,257,178053690,140281480,318335170,49,256,2,37772210,Out > In
Apr 2020,119,134,55,5471856,269950532,275422388,6,55,1,264478676,In > Out
Apr 2020,119,135,61,4315860,287766455,292082315,17,61,2,283450595,In > Out
Apr 2020,119,137,100,4373996,589576662,593950658,27,100,2,585202666,In > Out
Apr 2020,119,141,113,6920646,395316120,402236766,31,113,2,388395474,In > Out
Apr 2020,119,143,218,11420265,135251940,146672205,7,216,2,123831675,In > Out
Apr 2020,119,148,71,13601993,500125073,513727066,22,71,2,486523080,In > Out
Apr 2020,119,151,42,5501190,172595049,178096239,16,42,2,167093859,In > Out
Apr 2020,119,152,2093,935817037,293642226,1229459263,116,1914,14,642174811,Out > In
Apr 2020,119,153,12,283185,9796430,10079615,4,12,2,9513245,In > Out
Apr 2020,119,154,491,141290846,104620350,245911196,83,484,2,36670496,Out > In
Apr 2020,119,159,769,124432649,349637398,474070047,114,757,2,225204749,In > Out
Apr 2020,119,16,5,240463,28754865,28995328,1,5,1,28514402,In > Out
Apr 2020,119,160,39,3514346,148568793,152083139,23,39,2,145054447,In > Out
Apr 2020,119,161,50,6660474,16494976,23155450,36,50,1,9834502,In > Out
Apr 2020,119,162,506,3685023681,83361108163,87046131844,87,500,2,79676084482,In > Out
Apr 2020,119,165,124,7493963,390658162,398152125,21,124,2,383164199,In > Out
Apr 2020,119,167,244,80227283,686192977,766420260,73,243,2,605965694,In > Out
Apr 2020,119,168,6,24581466,3849030,28430496,3,4,5,20732436,Out > In
Apr 2020,119,172,214,17919446,725202971,743122417,27,213,2,707283525,In > Out
Apr 2020,119,174,57,5585830,290860845,296446675,19,57,2,285275015,In > Out
Apr 2020,119,178,10,285854,13539087,13824941,9,10,2,13253233,In > Out
Apr 2020,119,18,11,2439625,521151828,523591453,4,11,2,518712203,In > Out
Apr 2020,119,183,365,130061904,249468618,379530522,104,360,2,119406714,In > Out
Apr 2020,119,184,30,4617552,299292397,303909949,20,30,2,294674845,In > Out
Apr 2020,119,19,142,9850671,400823762,410674433,24,142,2,390973091,In > Out
Apr 2020,119,194,572,72672813,632143154,704815967,118,567,2,559470341,In > Out
Apr 2020,119,211,13,305974,14031978,14337952,6,13,2,13726004,In > Out
Apr 2020,119,214,78,1130079566,98807600,1228887166,21,78,3,1031271966,Out > In
Apr 2020,119,38,109,8064716,296993406,305058122,40,109,2,288928690,In > Out
Apr 2020,119,57,436,40533919,211625119,252159038,49,431,2,171091200,In > Out
Apr 2020,119,58,766,38713232,1523184796,1561898028,22,745,2,1484471564,In > Out
Apr 2020,119,59,6,604693,82293503,82898196,1,6,1,81688810,In > Out
Apr 2020,119,64,72,3715028,230939150,234654178,11,72,2,227224122,In > Out
Apr 2020,119,69,56,6012685,313827072,319839757,25,56,2,307814387,In > Out
Apr 2020,119,72,90,7003727,371707908,378711635,20,90,2,364704181,In > Out
Apr 2020,119,77,530,54625095,306954240,361579335,60,523,2,252329145,In > Out
Apr 2020,119,81,105,1052950,44830433,45883383,16,105,1,43777483,In > Out
Apr 2020,119,83,162,12895468,546245387,559140855,25,162,2,533349919,In > Out
Apr 2020,119,85,169,66857605,115279295,182136900,48,168,2,48421690,In > Out
Apr 2020,119,99,97,3922343,208109895,212032238,18,95,2,204187552,In > Out
Apr 2020,120,101,68,11328947,692197283,703526230,17,68,2,680868336,In > Out
Apr 2020,120,126,113,12008288,690398458,702406746,38,113,2,678390170,In > Out
Apr 2020,120,167,403,27090371,1165893340,1192983711,32,403,2,1138802969,In > Out
Apr 2020,120,71,703,31319250,1967337357,1998656607,14,688,2,1936018107,In > Out
Apr 2020,120,85,119,7658101,471814077,479472178,22,119,2,464155976,In > Out
Apr 2020,122,103,75,4528270,327045599,331573869,29,75,2,322517329,In > Out
Apr 2020,122,119,543,6964219188,1163449244,8127668432,160,531,9,5800769944,Out > In
Apr 2020,122,151,41,4155899,224568627,228724526,16,41,2,220412728,In > Out
Apr 2020,122,160,1262,1996036101,30797911303,32793947404,242,1199,42,28801875202,In > Out
Apr 2020,122,161,61,9888000,801131,10689131,2,1,1,9086869,Out > In
Apr 2020,122,165,319,53305066,2233399754,2286704820,120,318,1,2180094688,In > Out
Apr 2020,122,176,150,13653675,480418389,494072064,54,150,2,466764714,In > Out
Apr 2020,122,205,1083,155430621,123252586,278683207,115,1043,14,32178035,Out > In
Apr 2020,122,214,4,4744372,1533292,6277664,3,1,2,3211080,Out > In
Apr 2020,122,222,1003,170732768,1692356221,1863088989,263,952,5,1521623453,In > Out
Apr 2020,122,227,295,125743947,474747262,600491209,139,280,6,349003315,In > Out
Apr 2020,122,237,16,5727900,83936660,89664560,4,13,6,78208760,In > Out
Apr 2020,123,101,73,4199929,252094950,256294879,34,73,3,247895021,In > Out
Apr 2020,123,103,194,17394352,373109814,390504166,113,192,2,355715462,In > Out
Apr 2020,123,104,103,49830460,256934300,306764760,31,103,2,207103840,In > Out
Apr 2020,123,105,303,57816371,2022877433,2080693804,123,301,4,1965061062,In > Out
Apr 2020,123,107,652,43553943,2003146909,2046700852,168,641,16,1959592966,In > Out
Apr 2020,123,11,2962,404845709,28361663754,28766509463,573,2768,16,27956818045,In > Out
Apr 2020,123,110,814,194034947,12985072311,13179107258,259,801,2,12791037364,In > Out
Apr 2020,123,111,290,21865137,569351069,591216206,101,290,7,547485932,In > Out
Apr 2020,123,112,310,54448329,4476066648,4530514977,147,310,4,4421618319,In > Out
Apr 2020,123,113,9865,2833393169,31834874641,34668267810,372,8001,18,29001481472,In > Out
Apr 2020,123,116,609,93801519,2162830884,2256632403,102,606,5,2069029365,In > Out
Apr 2020,123,117,53,7833888,338603956,346437844,27,53,3,330770068,In > Out
Apr 2020,123,119,334,206898518,1392470510,1599369028,85,332,3,1185571992,In > Out
Apr 2020,123,124,109,20567970,1105418120,1125986090,47,109,3,1084850150,In > Out
Apr 2020,123,126,183,28251901,1419897384,1448149285,48,182,2,1391645483,In > Out
Apr 2020,123,128,365,90698804,826551653,917250457,148,365,3,735852849,In > Out
Apr 2020,123,129,57,31811570,50208409,82019979,30,57,2,18396839,In > Out
Apr 2020,123,131,145,18292752,1061105222,1079397974,56,145,2,1042812470,In > Out
Apr 2020,123,132,1571,809961765,8041478352,8851440117,236,1553,11,7231516587,In > Out
Apr 2020,123,133,1067,119200328,3370812719,3490013047,110,1067,5,3251612391,In > Out
Apr 2020,123,134,85,18457191,1310129077,1328586268,42,85,2,1291671886,In > Out
Apr 2020,123,135,2053,1221318771,4892418540,6113737311,332,1982,6,3671099769,In > Out
Apr 2020,123,136,175,265045330,1493515130,1758560460,95,174,14,1228469800,In > Out
Apr 2020,123,137,156,22107002,129611208,151718210,45,156,2,107504206,In > Out
Apr 2020,123,138,27,1380202,64661693,66041895,15,27,2,63281491,In > Out
Apr 2020,123,140,201,25990225,1647132531,1673122756,72,201,3,1621142306,In > Out
Apr 2020,123,141,59,21078109,471203206,492281315,33,59,2,450125097,In > Out
Apr 2020,123,142,8,469061,9610846,10079907,7,8,2,9141785,In > Out
Apr 2020,123,143,100,9483973,64605721,74089694,46,97,4,55121748,In > Out
Apr 2020,123,144,105,11239845,527813668,539053513,35,105,1,516573823,In > Out
Apr 2020,123,145,49,33271218,3305031077,3338302295,30,49,2,3271759859,In > Out
Apr 2020,123,146,303,122503096,526127136,648630232,98,303,5,403624040,In > Out
Apr 2020,123,148,125,5555281,85225567,90780848,82,125,1,79670286,In > Out
Apr 2020,123,149,96,11166442,278512084,289678526,23,96,2,267345642,In > Out
Apr 2020,123,150,371,39332591,943806584,983139175,173,369,1,904473993,In > Out
Apr 2020,123,151,254,18066754,418018798,436085552,87,249,3,399952044,In > Out
Apr 2020,123,152,64,118395682,79811356,198207038,41,62,3,38584326,Out > In
Apr 2020,123,153,30,2569173,14933676,17502849,23,30,5,12364503,In > Out
Apr 2020,123,154,624,76731203,2128477892,2205209095,144,622,4,2051746689,In > Out
Apr 2020,123,155,92,8303690,679176459,687480149,62,92,3,670872769,In > Out
Apr 2020,123,156,46,6653189,288201083,294854272,22,46,1,281547894,In > Out
Apr 2020,123,157,276,11710913,254579272,266290185,113,276,2,242868359,In > Out
Apr 2020,123,158,130,3548978,378642610,382191588,32,130,3,375093632,In > Out
Apr 2020,123,159,424,188584225,730204770,918788995,77,418,5,541620545,In > Out
Apr 2020,123,16,791,71044299,3798151975,3869196274,131,785,2,3727107676,In > Out
Apr 2020,123,163,1350,320889193,6314903118,6635792311,158,1322,5,5994013925,In > Out
Apr 2020,123,164,344,129706762,6776134464,6905841226,129,343,3,6646427702,In > Out
Apr 2020,123,166,645,76643287,2069251443,2145894730,252,645,2,1992608156,In > Out
Apr 2020,123,167,616,119243738,6272655376,6391899114,245,615,5,6153411638,In > Out
Apr 2020,123,168,448,120788768,7139526870,7260315638,150,446,2,7018738102,In > Out
Apr 2020,123,169,1166,545558046,15373581968,15919140014,296,1150,6,14828023922,In > Out
Apr 2020,123,17,560,110478486,1412760221,1523238707,280,396,203,1302281735,In > Out
Apr 2020,123,170,7,745552,11064155,11809707,6,7,1,10318603,In > Out
Apr 2020,123,171,874,112863383,758467129,871330512,239,858,5,645603746,In > Out
Apr 2020,123,172,424,73694387,1582769372,1656463759,119,423,3,1509074985,In > Out
Apr 2020,123,173,160,15914815,437418662,453333477,91,160,3,421503847,In > Out
Apr 2020,123,174,187,13870590,243907059,257777649,91,186,2,230036469,In > Out
Apr 2020,123,177,266,76413980,3453491943,3529905923,102,266,7,3377077963,In > Out
Apr 2020,123,178,229,47346065,3684681095,3732027160,74,229,4,3637335030,In > Out
Apr 2020,123,179,128,19525686,1210893687,1230419373,63,128,2,1191368001,In > Out
Apr 2020,123,180,756,136038782,1871329992,2007368774,236,750,4,1735291210,In > Out
Apr 2020,123,183,7,215404,4549891,4765295,4,7,1,4334487,In > Out
Apr 2020,123,187,4,82899,975386,1058285,2,4,2,892487,In > Out
Apr 2020,123,189,358,34965004,578495219,613460223,139,354,5,543530215,In > Out
Apr 2020,123,190,81,6061287,115130593,121191880,62,65,19,109069306,In > Out
Apr 2020,123,191,30,1247445,56294293,57541738,17,30,2,55046848,In > Out
Apr 2020,123,192,317,149592588,2937167132,3086759720,141,303,25,2787574544,In > Out
Apr 2020,123,197,548,366891678,2173736833,2540628511,177,524,29,1806845155,In > Out
Apr 2020,123,198,918,173604153,10976798208,11150402361,356,914,5,10803194055,In > Out
Apr 2020,123,199,517,45774949,1082895772,1128670721,153,512,6,1037120823,In > Out
Apr 2020,123,20,194,133517620,1749026515,1882544135,105,194,4,1615508895,In > Out
Apr 2020,123,200,531,665487997,1463931645,2129419642,154,524,9,798443648,In > Out
Apr 2020,123,201,63,9800702,2091579369,2101380071,42,63,3,2081778667,In > Out
Apr 2020,123,203,55,8413165,299868109,308281274,25,55,2,291454944,In > Out
Apr 2020,123,204,97,56113875,587049310,643163185,37,97,6,530935435,In > Out
Apr 2020,123,206,22,9292865,50496968,59789833,19,22,3,41204103,In > Out
Apr 2020,123,208,828,185282052,2620214648,2805496700,173,808,6,2434932596,In > Out
Apr 2020,123,21,1555,1307384618,18946848624,20254233242,305,1461,29,17639464006,In > Out
Apr 2020,123,211,931,150262565,2390115102,2540377667,370,929,6,2239852537,In > Out
Apr 2020,123,212,6,86560,1441214,1527774,3,6,1,1354654,In > Out
Apr 2020,123,216,593,827287384,1805188828,2632476212,135,590,9,977901444,In > Out
Apr 2020,123,217,617,146848984,2648935526,2795784510,172,606,5,2502086542,In > Out
Apr 2020,123,219,352,89575821,2475676260,2565252081,129,346,8,2386100439,In > Out
Apr 2020,123,22,197,43385675,137659905,181045580,85,197,6,94274230,In > Out
Apr 2020,123,221,196,183198153,1344290480,1527488633,81,196,3,1161092327,In > Out
Apr 2020,123,222,1657,520952907,13429889249,13950842156,264,1636,10,12908936342,In > Out
Apr 2020,123,223,2999,560968464,29605152638,30166121102,446,2886,3,29044184174,In > Out
Apr 2020,123,23,1024,148984295,13162868394,13311852689,235,1013,5,13013884099,In > Out
Apr 2020,123,24,36,2417902,43974916,46392818,8,36,1,41557014,In > Out
Apr 2020,123,25,115,16416051,388475980,404892031,51,115,3,372059929,In > Out
Apr 2020,123,27,1403,197726674,2034904968,2232631642,268,1380,7,1837178294,In > Out
Apr 2020,123,28,367,24743656,918654432,943398088,121,363,5,893910776,In > Out
Apr 2020,123,33,82,56063764,307631759,363695523,34,82,4,251567995,In > Out
Apr 2020,123,35,25,9458152,23913033,33371185,12,25,1,14454881,In > Out
Apr 2020,123,36,888,58364730,3862485781,3920850511,235,833,2,3804121051,In > Out
Apr 2020,123,37,199,21387145,959398869,980786014,73,199,4,938011724,In > Out
Apr 2020,123,38,55,1643343,21163596,22806939,20,55,1,19520253,In > Out
Apr 2020,123,39,198,17389784,2153049617,2170439401,70,196,2,2135659833,In > Out
Apr 2020,123,4,754,312582892,4980210531,5292793423,263,748,14,4667627639,In > Out
Apr 2020,123,40,311,346351465,650998301,997349766,149,306,2,304646836,In > Out
Apr 2020,123,43,89,6307147,93574597,99881744,42,89,2,87267450,In > Out
Apr 2020,123,45,6,327974,23589240,23917214,6,6,1,23261266,In > Out
Apr 2020,123,48,2524,190013826,9258170864,9448184690,131,2483,14,9068157038,In > Out
Apr 2020,123,5,204,32770073,1225643472,1258413545,57,204,4,1192873399,In > Out
Apr 2020,123,53,85,236467941,2669436779,2905904720,61,85,5,2432968838,In > Out
Apr 2020,123,54,617,100941503,1306455676,1407397179,137,613,6,1205514173,In > Out
Apr 2020,123,55,8,449827,4596451,5046278,7,8,1,4146624,In > Out
Apr 2020,123,56,277,21564855,798132518,819697373,143,277,4,776567663,In > Out
Apr 2020,123,57,191,27700942,1083487630,1111188572,69,191,8,1055786688,In > Out
Apr 2020,123,58,1536,399295117,4834076300,5233371417,223,1511,5,4434781183,In > Out
Apr 2020,123,59,369,27191752,769291953,796483705,116,368,3,742100201,In > Out
Apr 2020,123,60,133,12609921,385642503,398252424,52,132,4,373032582,In > Out
Apr 2020,123,61,3,8172058,286587,8458645,3,3,1,7885471,Out > In
Apr 2020,123,63,21,1430668,28335473,29766141,19,21,2,26904805,In > Out
Apr 2020,123,64,266,26056076,816954867,843010943,103,266,2,790898791,In > Out
Apr 2020,123,65,51,180088920,1002521213,1182610133,33,51,2,822432293,In > Out
Apr 2020,123,66,34,2012156,91160908,93173064,11,34,2,89148752,In > Out
Apr 2020,123,68,160,163283297,689359373,852642670,41,160,5,526076076,In > Out
Apr 2020,123,70,107,6646572,175833007,182479579,41,107,2,169186435,In > Out
Apr 2020,123,72,12,618330,5397094,6015424,10,12,1,4778764,In > Out
Apr 2020,123,74,366,238974638,1924633154,2163607792,155,363,7,1685658516,In > Out
Apr 2020,123,75,699,405834440,1594646936,2000481376,151,691,5,1188812496,In > Out
Apr 2020,123,77,389,511018627,2671233519,3182252146,212,389,80,2160214892,In > Out
Apr 2020,123,79,722,156003579,1365056986,1521060565,111,714,11,1209053407,In > Out
Apr 2020,123,81,52,2479872,67187475,69667347,18,52,3,64707603,In > Out
Apr 2020,123,82,37,3328086,7902726,11230812,23,37,1,4574640,In > Out
Apr 2020,123,86,795,21590153,2227607721,2249197874,117,794,3,2206017568,In > Out
Apr 2020,123,87,129,9328114,190126050,199454164,57,129,3,180797936,In > Out
Apr 2020,123,89,269,5853183,609229556,615082739,15,269,1,603376373,In > Out
Apr 2020,123,90,11,2038291,110500667,112538958,3,11,1,108462376,In > Out
Apr 2020,123,92,231,47313177,240772384,288085561,75,230,4,193459207,In > Out
Apr 2020,123,93,2277,622377685,16393739287,17016116972,515,2164,14,15771361602,In > Out
Apr 2020,123,94,791,408359551,1998321780,2406681331,134,770,13,1589962229,In > Out
Apr 2020,123,96,268,39914985,742191874,782106859,128,268,4,702276889,In > Out
Apr 2020,123,97,91,12486244,1427466792,1439953036,44,91,2,1414980548,In > Out
Apr 2020,123,98,14,14110049,45239215,59349264,13,14,4,31129166,In > Out
Apr 2020,123,99,4351,420675929,20216642361,20637318290,401,3838,18,19795966432,In > Out
Apr 2020,124,100,156,20507497,573531501,594038998,71,156,2,553024004,In > Out
Apr 2020,124,101,355,83364050,644975802,728339852,114,352,3,561611752,In > Out
Apr 2020,124,104,18,1567217,331159996,332727213,13,18,2,329592779,In > Out
Apr 2020,124,105,27,2143754,69285713,71429467,20,27,2,67141959,In > Out
Apr 2020,124,106,82,12005854,1078725297,1090731151,30,82,2,1066719443,In > Out
Apr 2020,124,108,555,53473615,368498040,421971655,93,555,5,315024425,In > Out
Apr 2020,124,109,37,2737208,152816702,155553910,28,37,2,150079494,In > Out
Apr 2020,124,11,279,10946135,703464035,714410170,79,279,3,692517900,In > Out
Apr 2020,124,110,480,163376359,7057639394,7221015753,171,478,6,6894263035,In > Out
Apr 2020,124,112,2,599541,1099034,1698575,2,2,2,499493,In > Out
Apr 2020,124,113,1366,319893096,7263162590,7583055686,315,1343,5,6943269494,In > Out
Apr 2020,124,115,6,1884995,298625,2183620,4,6,1,1586370,Out > In
Apr 2020,124,116,348,277360890,520547675,797908565,149,348,5,243186785,In > Out
Apr 2020,124,118,20,1051647,32969070,34020717,14,20,1,31917423,In > Out
Apr 2020,124,120,12,263536,4459491,4723027,10,12,3,4195955,In > Out
Apr 2020,124,121,108,14958517,854851689,869810206,39,108,14,839893172,In > Out
Apr 2020,124,124,109,928338288,1110273208,2038611496,71,105,13,181934920,In > Out
Apr 2020,124,125,114,147364975,261913335,409278310,40,114,4,114548360,In > Out
Apr 2020,124,126,789,730029198,3126671828,3856701026,186,785,21,2396642630,In > Out
Apr 2020,124,128,366,21678215,956989103,978667318,107,360,5,935310888,In > Out
Apr 2020,124,129,462,21125308,922347943,943473251,86,456,6,901222635,In > Out
Apr 2020,124,130,112,218136381,12191600426,12409736807,50,112,2,11973464045,In > Out
Apr 2020,124,131,217,71207110,4157948228,4229155338,73,217,3,4086741118,In > Out
Apr 2020,124,132,224,38181134,175080667,213261801,114,223,3,136899533,In > Out
Apr 2020,124,133,597,157903969,4075975987,4233879956,265,587,27,3918072018,In > Out
Apr 2020,124,134,73,38794315,2857915812,2896710127,50,72,2,2819121497,In > Out
Apr 2020,124,135,185,27566070,2393475159,2421041229,70,185,4,2365909089,In > Out
Apr 2020,124,137,41,7306801,569545988,576852789,18,41,3,562239187,In > Out
Apr 2020,124,138,52,6964085,61984191,68948276,29,52,2,55020106,In > Out
Apr 2020,124,139,101,145337635,401627120,546964755,50,100,3,256289485,In > Out
Apr 2020,124,14,1432,3448320588,9797890294,13246210882,265,1388,10,6349569706,In > Out
Apr 2020,124,140,244,9900707,224337618,234238325,33,243,3,214436911,In > Out
Apr 2020,124,141,2041,1186502288,5917159127,7103661415,153,1947,5,4730656839,In > Out
Apr 2020,124,143,121,174339525,276784341,451123866,43,114,11,102444816,In > Out
Apr 2020,124,144,401,158142285,293580977,451723262,115,397,5,135438692,In > Out
Apr 2020,124,145,85,10416950,281283172,291700122,37,85,4,270866222,In > Out
Apr 2020,124,146,5383,1959216446,19765310065,21724526511,835,4498,6,17806093619,In > Out
Apr 2020,124,147,39,16764796,850627813,867392609,18,39,4,833863017,In > Out
Apr 2020,124,149,24,2031995,144483644,146515639,10,24,1,142451649,In > Out
Apr 2020,124,150,254,79216548,1079137315,1158353863,122,254,3,999920767,In > Out
Apr 2020,124,151,422,68548799,667322642,735871441,173,421,11,598773843,In > Out
Apr 2020,124,152,1760,782353230,4564908057,5347261287,297,1687,6,3782554827,In > Out
Apr 2020,124,153,11,192865,6151305,6344170,2,11,1,5958440,In > Out
Apr 2020,124,154,472,174228349,1917349247,2091577596,132,471,3,1743120898,In > Out
Apr 2020,124,155,453,50295613,1132975900,1183271513,156,444,4,1082680287,In > Out
Apr 2020,124,157,213,19207000,452867611,472074611,92,213,4,433660611,In > Out
Apr 2020,124,158,438,172043518,5734414949,5906458467,84,437,4,5562371431,In > Out
Apr 2020,124,159,6,790779,2281503,3072282,4,6,1,1490724,In > Out
Apr 2020,124,16,34,2797452,156351765,159149217,11,34,2,153554313,In > Out
Apr 2020,124,161,670,224914027,6836273101,7061187128,263,668,4,6611359074,In > Out
Apr 2020,124,162,93,12343500,310360175,322703675,21,93,2,298016675,In > Out
Apr 2020,124,163,32,1619745,37509603,39129348,15,32,3,35889858,In > Out
Apr 2020,124,164,476,51340787,725067014,776407801,180,458,22,673726227,In > Out
Apr 2020,124,165,649,8830057656,1430000509,10260058165,55,644,6,7400057147,Out > In
Apr 2020,124,166,378,32299242,1801422343,1833721585,161,376,2,1769123101,In > Out
Apr 2020,124,167,970,99268436,2718881720,2818150156,294,943,10,2619613284,In > Out
Apr 2020,124,168,869,2233788385,6402622987,8636411372,173,843,12,4168834602,In > Out
Apr 2020,124,169,77,10516387,211837841,222354228,53,77,1,201321454,In > Out
Apr 2020,124,17,130,14044057,197386971,211431028,67,130,3,183342914,In > Out
Apr 2020,124,170,142,15729843,688547537,704277380,50,142,4,672817694,In > Out
Apr 2020,124,171,138,7613830,256695411,264309241,31,138,2,249081581,In > Out
Apr 2020,124,172,1278,577832917,7307689339,7885522256,384,1257,7,6729856422,In > Out
Apr 2020,124,173,478,249372168,1311782015,1561154183,116,469,9,1062409847,In > Out
Apr 2020,124,174,1,8800,104991,113791,1,1,1,96191,In > Out
Apr 2020,124,176,148,14282821,962606155,976888976,69,148,8,948323334,In > Out
Apr 2020,124,177,498,38840881,834018216,872859097,120,496,3,795177335,In > Out
Apr 2020,124,178,46,1596589,51769127,53365716,38,46,1,50172538,In > Out
Apr 2020,124,179,27,2338359,39646868,41985227,14,27,1,37308509,In > Out
Apr 2020,124,18,229,26624306,1361832329,1388456635,117,229,2,1335208023,In > Out
Apr 2020,124,181,111,16564377,762623696,779188073,56,110,2,746059319,In > Out
Apr 2020,124,182,650,65971801,2469111674,2535083475,144,630,4,2403139873,In > Out
Apr 2020,124,183,344,253075700,3810858625,4063934325,114,307,32,3557782925,In > Out
Apr 2020,124,184,4,405519,652791,1058310,4,4,3,247272,In > Out
Apr 2020,124,185,253,36881472,888701607,925583079,60,253,2,851820135,In > Out
Apr 2020,124,186,49,7194644,59199472,66394116,26,49,2,52004828,In > Out
Apr 2020,124,187,427,29196855,587385946,616582801,123,421,4,558189091,In > Out
Apr 2020,124,188,123,8124579,377618934,385743513,66,123,4,369494355,In > Out
Apr 2020,124,189,195,98327850,951480374,1049808224,97,195,3,853152524,In > Out
Apr 2020,124,19,429,73226410,1036913180,1110139590,89,423,6,963686770,In > Out
Apr 2020,124,190,706,177351475,4902564353,5079915828,299,572,40,4725212878,In > Out
Apr 2020,124,191,319,39621985,1341592789,1381214774,91,319,3,1301970804,In > Out
Apr 2020,124,192,53,5818253,75588573,81406826,28,53,2,69770320,In > Out
Apr 2020,124,193,136,14281832,1227958050,1242239882,63,134,4,1213676218,In > Out
Apr 2020,124,195,522,73934483,9218231710,9292166193,128,521,4,9144297227,In > Out
Apr 2020,124,197,1,13617,96500,110117,1,1,1,82883,In > Out
Apr 2020,124,20,81,6138616,112567058,118705674,52,81,4,106428442,In > Out
Apr 2020,124,200,100,55673374,2356678188,2412351562,56,100,2,2301004814,In > Out
Apr 2020,124,201,1165,147282393,9977430620,10124713013,157,1145,2,9830148227,In > Out
Apr 2020,124,202,128,9472927,123940886,133413813,63,128,1,114467959,In > Out
Apr 2020,124,203,699,271914019,565157233,837071252,100,689,2,293243214,In > Out
Apr 2020,124,204,100,92376452,516499882,608876334,35,100,6,424123430,In > Out
Apr 2020,124,205,1716,274321735,19830610441,20104932176,367,1690,3,19556288706,In > Out
Apr 2020,124,206,4,72568,690650,763218,2,4,2,618082,In > Out
Apr 2020,124,207,293,60234050,918956075,979190125,58,290,1,858722025,In > Out
Apr 2020,124,21,1259,136589139,4379088263,4515677402,193,1195,8,4242499124,In > Out
Apr 2020,124,211,163,15792026,147284396,163076422,48,163,8,131492370,In > Out
Apr 2020,124,212,540,28574088,859381870,887955958,79,538,6,830807782,In > Out
Apr 2020,124,213,363,26719064,588031929,614750993,69,363,3,561312865,In > Out
Apr 2020,124,214,97,8594328,57378645,65972973,35,96,2,48784317,In > Out
Apr 2020,124,215,52,5035430,28672199,33707629,34,52,2,23636769,In > Out
Apr 2020,124,216,68,4100300,226765843,230866143,34,68,2,222665543,In > Out
Apr 2020,124,219,100,21687579,3725298393,3746985972,33,100,2,3703610814,In > Out
Apr 2020,124,22,1459,166935429,1742842598,1909778027,201,1416,4,1575907169,In > Out
Apr 2020,124,221,16,1227441,40922050,42149491,10,16,2,39694609,In > Out
Apr 2020,124,223,353,25872357,1116914048,1142786405,134,353,2,1091041691,In > Out
Apr 2020,124,23,10,875649,3369606,4245255,7,10,2,2493957,In > Out
Apr 2020,124,24,279,35497284,1306309718,1341807002,76,278,2,1270812434,In > Out
Apr 2020,124,25,477,2174729359,843552920,3018282279,143,477,3,1331176439,Out > In
Apr 2020,124,26,15,731372,3815081,4546453,7,15,1,3083709,In > Out
Apr 2020,124,27,408,48518618,1613850598,1662369216,71,402,3,1565331980,In > Out
Apr 2020,124,29,129,10853896,240408798,251262694,47,129,2,229554902,In > Out
Apr 2020,124,32,96,28979802,1027574712,1056554514,60,96,3,998594910,In > Out
Apr 2020,124,33,79,29570478,885503657,915074135,59,79,10,855933179,In > Out
Apr 2020,124,35,225,13871874,201475501,215347375,71,225,5,187603627,In > Out
Apr 2020,124,37,123,8907455,128025640,136933095,53,123,5,119118185,In > Out
Apr 2020,124,39,22,857782,11012419,11870201,16,22,3,10154637,In > Out
Apr 2020,124,40,1705,2322384968,7385028330,9707413298,345,1672,15,5062643362,In > Out
Apr 2020,124,41,133,21445611,397158213,418603824,50,133,2,375712602,In > Out
Apr 2020,124,43,370,41372915,1772410038,1813782953,152,370,3,1731037123,In > Out
Apr 2020,124,44,1135,344380131,28546869831,28891249962,245,1135,3,28202489700,In > Out
Apr 2020,124,45,30,1322364,35833081,37155445,14,29,2,34510717,In > Out
Apr 2020,124,46,1777,218726455,8254508663,8473235118,455,1682,6,8035782208,In > Out
Apr 2020,124,48,26,1121512,35766717,36888229,12,26,3,34645205,In > Out
Apr 2020,124,5,846,298248236,1651748386,1949996622,154,830,4,1353500150,In > Out
Apr 2020,124,51,3459,787616249,41780769038,42568385287,829,3263,14,40993152789,In > Out
Apr 2020,124,52,8,286145,2168975,2455120,8,8,1,1882830,In > Out
Apr 2020,124,54,878,441088144,16070032305,16511120449,214,865,7,15628944161,In > Out
Apr 2020,124,55,389,27641678,804077278,831718956,88,388,3,776435600,In > Out
Apr 2020,124,56,492,323525720,31557055973,31880581693,70,487,5,31233530253,In > Out
Apr 2020,124,58,64,6330935,74400257,80731192,25,64,2,68069322,In > Out
Apr 2020,124,59,12,1061599,57886632,58948231,11,12,1,56825033,In > Out
Apr 2020,124,60,419,31935055,1693999630,1725934685,128,410,4,1662064575,In > Out
Apr 2020,124,64,3837,469442674,22798716524,23268159198,808,3416,111,22329273850,In > Out
Apr 2020,124,65,1469,617335593,3197193673,3814529266,198,1444,17,2579858080,In > Out
Apr 2020,124,68,781,161599059,2517901428,2679500487,120,770,5,2356302369,In > Out
Apr 2020,124,69,41,1932327,18305172,20237499,17,41,4,16372845,In > Out
Apr 2020,124,70,74,9310654,821144303,830454957,30,74,2,811833649,In > Out
Apr 2020,124,71,373,232044266,711487221,943531487,124,369,9,479442955,In > Out
Apr 2020,124,73,3,89041,521299,610340,2,3,1,432258,In > Out
Apr 2020,124,74,120,17948191,1639851165,1657799356,30,120,2,1621902974,In > Out
Apr 2020,124,77,116,29563632,391087964,420651596,42,116,2,361524332,In > Out
Apr 2020,124,78,5,133289,1707409,1840698,2,5,1,1574120,In > Out
Apr 2020,124,79,4,663346,1622169,2285515,4,4,2,958823,In > Out
Apr 2020,124,8,588,84323852,4175609603,4259933455,137,588,3,4091285751,In > Out
Apr 2020,124,81,233,35362323,1011462351,1046824674,134,233,2,976100028,In > Out
Apr 2020,124,82,306,37141532,4067767700,4104909232,86,306,4,4030626168,In > Out
Apr 2020,124,85,53,4947681,149949439,154897120,36,53,3,145001758,In > Out
Apr 2020,124,9,672,60785620,1036036847,1096822467,100,671,4,975251227,In > Out
Apr 2020,124,91,55,21908350,110760483,132668833,27,47,4,88852133,In > Out
Apr 2020,124,92,796,90907734,14558493202,14649400936,200,781,4,14467585468,In > Out
Apr 2020,124,96,259,123338156,573615414,696953570,76,257,6,450277258,In > Out
Apr 2020,124,97,1,120274,13590,133864,1,1,1,106684,Out > In
Apr 2020,124,98,12,2368185,1977919,4346104,9,12,1,390266,Out > In
Apr 2020,125,153,534,83306101,835879957,919186058,86,528,2,752573856,In > Out
Apr 2020,125,154,99,2076521,345983824,348060345,19,99,2,343907303,In > Out
Apr 2020,125,167,48,2116506160,8678817942,10795324102,13,48,3,6562311782,In > Out
Apr 2020,125,185,83,15339519,899686497,915026016,37,83,2,884346978,In > Out
Apr 2020,125,210,133,13962181261,669257201,14631438462,60,132,2,13292924060,Out > In
Apr 2020,125,212,328,30719224,83348799,114068023,8,325,2,52629575,In > Out
Apr 2020,125,66,177,16399522,372751407,389150929,30,177,2,356351885,In > Out
Apr 2020,125,69,23,5002866,167328480,172331346,10,23,3,162325614,In > Out
Apr 2020,126,14,1,9092,1446790,1455882,1,1,1,1437698,In > Out
Apr 2020,126,25,6,106338,27262723,27369061,3,6,2,27156385,In > Out
Apr 2020,126,26,1,551321,124853355,125404676,1,1,1,124302034,In > Out
Apr 2020,127,10,980,139855566,6912334417,7052189983,246,974,5,6772478851,In > Out
Apr 2020,127,100,296,338207372,2328518680,2666726052,152,281,18,1990311308,In > Out
Apr 2020,127,103,11,1458280,7736150,9194430,7,11,1,6277870,In > Out
Apr 2020,127,105,814,129880149,3118213352,3248093501,81,789,19,2988333203,In > Out
Apr 2020,127,106,125,5192400,164068774,169261174,25,125,2,158876374,In > Out
Apr 2020,127,109,25,1557445,51136364,52693809,21,25,2,49578919,In > Out
Apr 2020,127,11,212,6841766,521278256,528120022,38,212,2,514436490,In > Out
Apr 2020,127,111,390,58909029,2660908302,2719817331,158,388,9,2601999273,In > Out
Apr 2020,127,114,6,6314575,5897206,12211781,5,6,3,417369,Out > In
Apr 2020,127,117,90,817172855,2972772203,3789945058,37,89,4,2155599348,In > Out
Apr 2020,127,119,236,16871702,621538790,638410492,81,235,4,604667088,In > Out
Apr 2020,127,121,170,35314739,3155467034,3190781773,60,170,3,3120152295,In > Out
Apr 2020,127,122,429,214192761,822419188,1036611949,98,419,4,608226427,In > Out
Apr 2020,127,123,357,29514584,1022709128,1052223712,115,353,4,993194544,In > Out
Apr 2020,127,124,63,1139660,122618466,123758126,13,63,1,121478806,In > Out
Apr 2020,127,126,224,49566793,952484799,1002051592,87,224,5,902918006,In > Out
Apr 2020,127,128,453,57706521,5028708842,5086415363,63,453,3,4971002321,In > Out
Apr 2020,127,129,291,59338665,2251170446,2310509111,162,291,5,2191831781,In > Out
Apr 2020,127,13,4,211349,1116794,1328143,2,4,2,905445,In > Out
Apr 2020,127,130,19,1350788,2245250,3596038,7,19,2,894462,In > Out
Apr 2020,127,131,843,141526392,14631769775,14773296167,238,834,3,14490243383,In > Out
Apr 2020,127,132,836,538642651,49753293380,50291936031,183,811,3,49214650729,In > Out
Apr 2020,127,133,167,33311607,1677446743,1710758350,62,167,2,1644135136,In > Out
Apr 2020,127,134,197,33480882,2702377079,2735857961,37,197,1,2668896197,In > Out
Apr 2020,127,135,625,94188167,2360558777,2454746944,209,619,5,2266370610,In > Out
Apr 2020,127,136,84,15900285,83107645,99007930,37,84,1,67207360,In > Out
Apr 2020,127,137,714,158134794,8981964346,9140099140,217,704,3,8823829552,In > Out
Apr 2020,127,139,184,50357434,298201240,348558674,30,184,4,247843806,In > Out
Apr 2020,127,14,136,473957473,337861524,811818997,62,136,3,136095949,Out > In
Apr 2020,127,140,3,209373,1678050,1887423,3,3,1,1468677,In > Out
Apr 2020,127,141,60,21783441,111236569,133020010,26,60,1,89453128,In > Out
Apr 2020,127,142,165,54853591,4954180673,5009034264,58,165,4,4899327082,In > Out
Apr 2020,127,143,19,38621707,548871245,587492952,14,19,2,510249538,In > Out
Apr 2020,127,144,114,27950014,74627371,102577385,57,113,5,46677357,In > Out
Apr 2020,127,145,54,4888539,158937944,163826483,17,53,1,154049405,In > Out
Apr 2020,127,147,402,11937323,693580502,705517825,121,401,4,681643179,In > Out
Apr 2020,127,148,558,170815282,9905844698,10076659980,206,555,8,9735029416,In > Out
Apr 2020,127,149,253,143022003,2289593047,2432615050,104,252,4,2146571044,In > Out
Apr 2020,127,150,77,6246925,109030982,115277907,26,77,3,102784057,In > Out
Apr 2020,127,151,174,57575999,375462520,433038519,74,174,4,317886521,In > Out
Apr 2020,127,152,815,6624536464,1619547541,8244084005,450,586,324,5004988923,Out > In
Apr 2020,127,154,143,19288950,441728521,461017471,30,143,4,422439571,In > Out
Apr 2020,127,155,201,28729180,1251801282,1280530462,66,200,6,1223072102,In > Out
Apr 2020,127,156,721,636681475,6876661563,7513343038,310,710,6,6239980088,In > Out
Apr 2020,127,157,1547,1785809195,7782849779,9568658974,253,1518,7,5997040584,In > Out
Apr 2020,127,158,1311,712954304,4160134504,4873088808,218,1301,12,3447180200,In > Out
Apr 2020,127,159,364,120323977,1477052361,1597376338,275,207,33,1356728384,In > Out
Apr 2020,127,160,58,88285619,120739802,209025421,35,58,4,32454183,In > Out
Apr 2020,127,161,72,4015047,93858134,97873181,43,72,3,89843087,In > Out
Apr 2020,127,162,50,7210702,179540043,186750745,23,50,1,172329341,In > Out
Apr 2020,127,163,150,20907865,520243684,541151549,67,149,4,499335819,In > Out
Apr 2020,127,164,1,149124,149790,298914,1,1,1,666,In > Out
Apr 2020,127,165,70,261572832,709289912,970862744,38,70,4,447717080,In > Out
Apr 2020,127,166,15,1914041,122957485,124871526,7,15,2,121043444,In > Out
Apr 2020,127,167,1352,750057260,3425722397,4175779657,253,1321,7,2675665137,In > Out
Apr 2020,127,168,153,48041249,82403763,130445012,73,153,6,34362514,In > Out
Apr 2020,127,169,450,107004901,7735996896,7843001797,131,445,6,7628991995,In > Out
Apr 2020,127,17,625,80535538,1153027188,1233562726,171,618,4,1072491650,In > Out
Apr 2020,127,170,129,10429750,108972909,119402659,71,129,9,98543159,In > Out
Apr 2020,127,173,139,11111845,130048823,141160668,37,139,3,118936978,In > Out
Apr 2020,127,174,465,89107236,7024624964,7113732200,113,461,6,6935517728,In > Out
Apr 2020,127,175,445,43198894,1903599792,1946798686,186,443,4,1860400898,In > Out
Apr 2020,127,176,89,71768517,436166960,507935477,43,89,5,364398443,In > Out
Apr 2020,127,177,31,2881518,45106784,47988302,10,31,3,42225266,In > Out
Apr 2020,127,179,1134,112063561,5840743309,5952806870,86,1134,3,5728679748,In > Out
Apr 2020,127,180,106,36680015,228125742,264805757,38,105,4,191445727,In > Out
Apr 2020,127,181,40,1998969,38810826,40809795,24,40,2,36811857,In > Out
Apr 2020,127,182,376,26825229,2656325521,2683150750,74,368,2,2629500292,In > Out
Apr 2020,127,183,4,220897,475133,696030,4,4,1,254236,In > Out
Apr 2020,127,184,205,11795138,284816634,296611772,68,203,2,273021496,In > Out
Apr 2020,127,186,16,706948890,665706369,1372655259,7,16,1,41242521,Out > In
Apr 2020,127,187,728,1256140409,35173737691,36429878100,169,725,26,33917597282,In > Out
Apr 2020,127,188,1317,77209316,15213862465,15291071781,181,1291,21,15136653149,In > Out
Apr 2020,127,189,119,5577688,229408336,234986024,37,119,3,223830648,In > Out
Apr 2020,127,190,195,327700525,2283548955,2611249480,80,195,6,1955848430,In > Out
Apr 2020,127,191,271,314055864,1635014996,1949070860,104,271,3,1320959132,In > Out
Apr 2020,127,192,1147,242009352,1996440688,2238450040,234,1127,7,1754431336,In > Out
Apr 2020,127,193,1321,380951663,7495504293,7876455956,217,1317,25,7114552630,In > Out
Apr 2020,127,194,30,90228449,785091543,875319992,19,30,2,694863094,In > Out
Apr 2020,127,195,1,7941,100221,108162,1,1,1,92280,In > Out
Apr 2020,127,196,929,203040714,2495313189,2698353903,166,916,2,2292272475,In > Out
Apr 2020,127,197,861,87386418,2899087739,2986474157,149,838,5,2811701321,In > Out
Apr 2020,127,198,25,6127063,266216198,272343261,16,25,2,260089135,In > Out
Apr 2020,127,199,203,59206231,3928725831,3987932062,117,203,3,3869519600,In > Out
Apr 2020,127,200,630,670422476,1799652264,2470074740,172,623,4,1129229788,In > Out
Apr 2020,127,201,11,2972078,7514356,10486434,6,11,3,4542278,In > Out
Apr 2020,127,202,613,48734192,4233109156,4281843348,240,613,2,4184374964,In > Out
Apr 2020,127,203,150,237822405,1679746728,1917569133,88,100,40,1441924323,In > Out
Apr 2020,127,204,143,38796947,538629078,577426025,50,143,3,499832131,In > Out
Apr 2020,127,205,914,223163487,11512346319,11735509806,231,906,17,11289182832,In > Out
Apr 2020,127,206,2666,3255276899,21777433684,25032710583,436,2520,16,18522156785,In > Out
Apr 2020,127,207,145,19754788,478466136,498220924,60,145,2,458711348,In > Out
Apr 2020,127,208,192,11791963,387178269,398970232,42,192,2,375386306,In > Out
Apr 2020,127,209,2128,228353243,6360778213,6589131456,370,1976,40,6132424970,In > Out
Apr 2020,127,21,454,92229218,613191683,705420901,191,453,2,520962465,In > Out
Apr 2020,127,210,95,228962432,787413089,1016375521,33,95,5,558450657,In > Out
Apr 2020,127,211,29,808356,18849399,19657755,25,29,1,18041043,In > Out
Apr 2020,127,212,24,2964917,41499645,44464562,15,24,1,38534728,In > Out
Apr 2020,127,213,203,17444067,1675622682,1693066749,65,202,1,1658178615,In > Out
Apr 2020,127,214,16,28524376,55465384,83989760,12,16,1,26941008,In > Out
Apr 2020,127,215,413,40559808,5131694671,5172254479,154,408,3,5091134863,In > Out
Apr 2020,127,216,130,8987299,322263661,331250960,64,130,1,313276362,In > Out
Apr 2020,127,217,8,148345,2170213,2318558,8,8,1,2021868,In > Out
Apr 2020,127,218,121,10969022,686644779,697613801,28,121,2,675675757,In > Out
Apr 2020,127,219,487,54020121,5261652109,5315672230,231,479,23,5207631988,In > Out
Apr 2020,127,220,758,81806666,3519839154,3601645820,180,751,4,3438032488,In > Out
Apr 2020,127,221,2683,677607404,12879202484,13556809888,565,2540,11,12201595080,In > Out
Apr 2020,127,222,116,17403514,407754300,425157814,74,116,4,390350786,In > Out
Apr 2020,127,223,707,827208299,4210601922,5037810221,114,700,21,3383393623,In > Out
Apr 2020,127,23,515,46862482,856514387,903376869,147,513,4,809651905,In > Out
Apr 2020,127,24,526,37463839,1756302051,1793765890,171,520,3,1718838212,In > Out
Apr 2020,127,26,128,21406528,1385542140,1406948668,70,128,3,1364135612,In > Out
Apr 2020,127,27,341,424460501,995949527,1420410028,35,339,2,571489026,In > Out
Apr 2020,127,28,1825,270233591,2308431473,2578665064,207,1705,5,2038197882,In > Out
Apr 2020,127,29,1386,81928862,2333512744,2415441606,335,1342,7,2251583882,In > Out
Apr 2020,127,31,661,104238567,1659397635,1763636202,193,646,3,1555159068,In > Out
Apr 2020,127,32,4,165761,508998,674759,4,4,2,343237,In > Out
Apr 2020,127,35,1287,317731649,2893204771,3210936420,148,1256,7,2575473122,In > Out
Apr 2020,127,36,752,668099793,2195369770,2863469563,149,751,4,1527269977,In > Out
Apr 2020,127,37,342,958933230,2077880337,3036813567,101,342,8,1118947107,In > Out
Apr 2020,127,39,151,12119979,339081279,351201258,77,149,2,326961300,In > Out
Apr 2020,127,40,86,4692841,176304245,180997086,60,86,2,171611404,In > Out
Apr 2020,127,41,670,131552889,2720150164,2851703053,260,656,4,2588597275,In > Out
Apr 2020,127,42,12023,3359641671,33990091014,37349732685,672,9182,19,30630449343,In > Out
Apr 2020,127,44,6,214045,1726070,1940115,6,6,1,1512025,In > Out
Apr 2020,127,45,101,24352805,77825477,102178282,38,101,3,53472672,In > Out
Apr 2020,127,48,75,7441841,322443198,329885039,12,74,1,315001357,In > Out
Apr 2020,127,5,1147,924695393,2957315628,3882011021,198,1130,16,2032620235,In > Out
Apr 2020,127,50,211,66988487,358580412,425568899,78,210,4,291591925,In > Out
Apr 2020,127,52,662,76356643,3198362633,3274719276,178,660,4,3122005990,In > Out
Apr 2020,127,54,29,2082978,12370544,14453522,17,29,3,10287566,In > Out
Apr 2020,127,55,1848,3615224530,7091020896,10706245426,348,1591,73,3475796366,In > Out
Apr 2020,127,56,2208,594136027,5632884374,6227020401,207,2047,11,5038748347,In > Out
Apr 2020,127,59,517,206441072,1613812687,1820253759,112,502,18,1407371615,In > Out
Apr 2020,127,63,40,54249318,9766633,64015951,30,40,2,44482685,Out > In
Apr 2020,127,64,162,61956044,895022923,956978967,54,162,2,833066879,In > Out
Apr 2020,127,65,488,35707351,1574527496,1610234847,130,484,4,1538820145,In > Out
Apr 2020,127,66,208,40662488,397679938,438342426,107,208,5,357017450,In > Out
Apr 2020,127,67,19,755170,4649051,5404221,8,19,1,3893881,In > Out
Apr 2020,127,7,1634,504333992,2399705756,2904039748,466,1592,5,1895371764,In > Out
Apr 2020,127,71,1542,66057159,3053893861,3119951020,59,1496,5,2987836702,In > Out
Apr 2020,127,73,2944,294829830,7975034465,8269864295,261,2724,8,7680204635,In > Out
Apr 2020,127,74,205,30665571,1747304256,1777969827,85,201,10,1716638685,In > Out
Apr 2020,127,76,34,1204422,10447835,11652257,17,34,3,9243413,In > Out
Apr 2020,127,77,214,12162483,808513380,820675863,37,214,2,796350897,In > Out
Apr 2020,127,8,55,4143136,27673841,31816977,43,55,2,23530705,In > Out
Apr 2020,127,80,912,140409831,7184504245,7324914076,313,912,2,7044094414,In > Out
Apr 2020,127,81,437,55997751,1221960971,1277958722,119,437,4,1165963220,In > Out
Apr 2020,127,82,796,1481616817,4753890809,6235507626,205,780,23,3272273992,In > Out
Apr 2020,127,83,193,355385071,1393364666,1748749737,82,193,4,1037979595,In > Out
Apr 2020,127,84,70,8379961,694663023,703042984,29,70,1,686283062,In > Out
Apr 2020,127,88,42,6563131,38177963,44741094,27,42,3,31614832,In > Out
Apr 2020,127,89,2129,581330809,5279608331,5860939140,503,2034,11,4698277522,In > Out
Apr 2020,127,90,484,56044662,2759719373,2815764035,164,480,4,2703674711,In > Out
Apr 2020,127,92,1585,1667636524,15796713363,17464349887,436,1511,52,14129076839,In > Out
Apr 2020,127,93,368,41933333,2471662764,2513596097,124,367,6,2429729431,In > Out
Apr 2020,127,94,2162,195428641,6050509346,6245937987,316,2057,9,5855080705,In > Out
Apr 2020,127,95,114,11118754,295218018,306336772,21,113,2,284099264,In > Out
Apr 2020,127,98,423,39585861,1857747728,1897333589,145,417,3,1818161867,In > Out
Apr 2020,127,99,113,20608005,1247919055,1268527060,34,113,2,1227311050,In > Out
Apr 2020,128,101,622,530020680,2089032339,2619053019,223,616,8,1559011659,In > Out
Apr 2020,128,102,46,3282741,131269584,134552325,29,46,4,127986843,In > Out
Apr 2020,128,103,523,52780412,3010017831,3062798243,106,516,3,2957237419,In > Out
Apr 2020,128,105,100,77058280,348337431,425395711,54,100,4,271279151,In > Out
Apr 2020,128,107,1607,118023550,2734146963,2852170513,401,1587,9,2616123413,In > Out
Apr 2020,128,110,282,34173083,676551031,710724114,132,282,2,642377948,In > Out
Apr 2020,128,111,1511,985941083,3097381847,4083322930,218,1491,10,2111440764,In > Out
Apr 2020,128,112,758,204879840,7683813821,7888693661,196,724,27,7478933981,In > Out
Apr 2020,128,116,370,38403955,765704121,804108076,165,366,5,727300166,In > Out
Apr 2020,128,118,80,6995431,837157060,844152491,52,80,2,830161629,In > Out
Apr 2020,128,12,181,20527221,552199561,572726782,56,181,3,531672340,In > Out
Apr 2020,128,120,84,6402386,135940883,142343269,25,84,2,129538497,In > Out
Apr 2020,128,121,2244,177482427,8100097251,8277579678,216,2131,7,7922614824,In > Out
Apr 2020,128,124,540,64663379,1601156111,1665819490,170,534,5,1536492732,In > Out
Apr 2020,128,125,1316,1834496118,14264736689,16099232807,271,1311,20,12430240571,In > Out
Apr 2020,128,126,318,32114624,1570635738,1602750362,102,317,3,1538521114,In > Out
Apr 2020,128,127,84,5540345,57562204,63102549,40,84,3,52021859,In > Out
Apr 2020,128,129,2362,17204761684,23086914373,40291676057,368,2362,3,5882152689,In > Out
Apr 2020,128,13,158,4298990,102665167,106964157,51,158,3,98366177,In > Out
Apr 2020,128,130,1510,540378112,15038567503,15578945615,485,1475,8,14498189391,In > Out
Apr 2020,128,132,116,15164791,108714016,123878807,49,116,5,93549225,In > Out
Apr 2020,128,135,8,366609,8157241,8523850,6,8,2,7790632,In > Out
Apr 2020,128,138,275,73055358,5635265635,5708320993,106,275,2,5562210277,In > Out
Apr 2020,128,139,136,321685202,685525164,1007210366,60,136,3,363839962,In > Out
Apr 2020,128,14,548,82424242,2219411181,2301835423,154,545,8,2136986939,In > Out
Apr 2020,128,141,294,41342061,2258008266,2299350327,123,294,3,2216666205,In > Out
Apr 2020,128,142,1261,1200374311,5528207112,6728581423,192,1219,7,4327832801,In > Out
Apr 2020,128,146,600,1308315182,1847019644,3155334826,171,588,17,538704462,In > Out
Apr 2020,128,147,1144,350735756,28139719335,28490455091,400,1057,3,27788983579,In > Out
Apr 2020,128,149,197,6184828,251994531,258179359,71,197,3,245809703,In > Out
Apr 2020,128,151,163,28408501,311490329,339898830,37,163,2,283081828,In > Out
Apr 2020,128,152,200,30919580,4814070082,4844989662,63,198,3,4783150502,In > Out
Apr 2020,128,153,347,280516462,8281222745,8561739207,58,347,3,8000706283,In > Out
Apr 2020,128,154,621,135356694,5763680080,5899036774,227,606,5,5628323386,In > Out
Apr 2020,128,155,234,274202833,753086220,1027289053,112,234,10,478883387,In > Out
Apr 2020,128,156,419,35794002,1085157154,1120951156,65,419,4,1049363152,In > Out
Apr 2020,128,157,2,147986,1054149,1202135,2,2,1,906163,In > Out
Apr 2020,128,159,608,389110187,3480599365,3869709552,210,608,4,3091489178,In > Out
Apr 2020,128,16,170,315017403,563102299,878119702,56,170,2,248084896,In > Out
Apr 2020,128,162,686,103391309,3374058632,3477449941,176,675,6,3270667323,In > Out
Apr 2020,128,163,703,2785979817,4608769279,7394749096,171,689,17,1822789462,In > Out
Apr 2020,128,165,286,403462461,6167312214,6570774675,153,284,10,5763849753,In > Out
Apr 2020,128,171,433,135692433,6432727876,6568420309,151,432,2,6297035443,In > Out
Apr 2020,128,177,810,69679142,2145017009,2214696151,319,806,4,2075337867,In > Out
Apr 2020,128,178,175,18819724,1184576809,1203396533,35,175,4,1165757085,In > Out
Apr 2020,128,18,298,109678286,1083316631,1192994917,103,298,2,973638345,In > Out
Apr 2020,128,181,1339,589707251,16265766135,16855473386,223,1294,9,15676058884,In > Out
Apr 2020,128,182,193,87185270,707674866,794860136,150,115,13,620489596,In > Out
Apr 2020,128,186,159,119025320,1094348965,1213374285,110,155,8,975323645,In > Out
Apr 2020,128,187,501,394059119,1583022610,1977081729,141,499,16,1188963491,In > Out
Apr 2020,128,189,187,165261473,395725199,560986672,52,185,2,230463726,In > Out
Apr 2020,128,19,1038,287958391,3590883307,3878841698,162,1030,8,3302924916,In > Out
Apr 2020,128,191,346,37717121,958417959,996135080,116,338,4,920700838,In > Out
Apr 2020,128,192,3390,292510152,4944809665,5237319817,447,3300,10,4652299513,In > Out
Apr 2020,128,193,172,19466451,846773234,866239685,96,172,4,827306783,In > Out
Apr 2020,128,194,53,6812070,389886425,396698495,27,53,3,383074355,In > Out
Apr 2020,128,195,1110,623444470,9828529029,10451973499,284,1060,13,9205084559,In > Out
Apr 2020,128,197,65,957006356,114342326,1071348682,39,65,3,842664030,Out > In
Apr 2020,128,198,182,12654687,413424162,426078849,64,177,3,400769475,In > Out
Apr 2020,128,199,1521,2587665413,5457776613,8045442026,325,1501,23,2870111200,In > Out
Apr 2020,128,200,291,56305064,706258148,762563212,110,289,4,649953084,In > Out
Apr 2020,128,202,240,38465310,942109951,980575261,77,240,3,903644641,In > Out
Apr 2020,128,204,27,1632512,31590379,33222891,20,27,1,29957867,In > Out
Apr 2020,128,206,39,16743523,56036196,72779719,28,39,4,39292673,In > Out
Apr 2020,128,207,679,98186829,1684394216,1782581045,184,673,5,1586207387,In > Out
Apr 2020,128,21,1843,170683065,8203610464,8374293529,127,1770,7,8032927399,In > Out
Apr 2020,128,210,169,55739799,175844081,231583880,79,167,3,120104282,In > Out
Apr 2020,128,211,365,161331428,10009929784,10171261212,91,365,3,9848598356,In > Out
Apr 2020,128,212,686,53178497,2428118798,2481297295,146,664,4,2374940301,In > Out
Apr 2020,128,214,3050,667356658,4873951982,5541308640,394,2677,77,4206595324,In > Out
Apr 2020,128,215,48,3229693,51682315,54912008,28,48,4,48452622,In > Out
Apr 2020,128,216,392,366812775,1980846137,2347658912,159,383,4,1614033362,In > Out
Apr 2020,128,219,630,552642930,2016506971,2569149901,108,620,10,1463864041,In > Out
Apr 2020,128,22,124,11070572,774660518,785731090,44,124,2,763589946,In > Out
Apr 2020,128,220,414,29900154,503943188,533843342,110,414,7,474043034,In > Out
Apr 2020,128,223,1,13368,218768,232136,1,1,1,205400,In > Out
Apr 2020,128,23,272,58615842,1356758038,1415373880,118,271,5,1298142196,In > Out
Apr 2020,128,25,205,13711016,240816830,254527846,91,205,10,227105814,In > Out
Apr 2020,128,27,453,95097726,4390302052,4485399778,166,448,7,4295204326,In > Out
Apr 2020,128,29,90,16320011,413988407,430308418,46,89,3,397668396,In > Out
Apr 2020,128,31,242,26485138,1426936361,1453421499,57,241,2,1400451223,In > Out
Apr 2020,128,36,6,164330,7133670,7298000,5,6,2,6969340,In > Out
Apr 2020,128,37,115,26272516,357123725,383396241,73,115,2,330851209,In > Out
Apr 2020,128,38,920,67100354,3284039957,3351140311,209,905,3,3216939603,In > Out
Apr 2020,128,4,373,26520141,1247088619,1273608760,123,370,2,1220568478,In > Out
Apr 2020,128,44,460,451172757,2572126955,3023299712,135,455,8,2120954198,In > Out
Apr 2020,128,45,41,2015283,86711387,88726670,20,41,2,84696104,In > Out
Apr 2020,128,46,666,104987893,3698117018,3803104911,217,664,2,3593129125,In > Out
Apr 2020,128,48,95,8225565,540668839,548894404,42,95,2,532443274,In > Out
Apr 2020,128,50,36,52220073,119573879,171793952,23,36,3,67353806,In > Out
Apr 2020,128,51,80,11093450,219730511,230823961,56,80,5,208637061,In > Out
Apr 2020,128,54,353,38585673,1327210839,1365796512,194,350,4,1288625166,In > Out
Apr 2020,128,57,271,120611565,2138226212,2258837777,114,270,5,2017614647,In > Out
Apr 2020,128,60,25,105915299,373400100,479315399,11,24,7,267484801,In > Out
Apr 2020,128,62,141,18709014,417799203,436508217,50,140,5,399090189,In > Out
Apr 2020,128,65,394,62990231,1149767763,1212757994,179,391,15,1086777532,In > Out
Apr 2020,128,68,2424,2828817917,8392674314,11221492231,529,2254,23,5563856397,In > Out
Apr 2020,128,69,293,15203872,363399055,378602927,138,292,3,348195183,In > Out
Apr 2020,128,70,357,73532624,1484041193,1557573817,158,353,5,1410508569,In > Out
Apr 2020,128,71,114,5276469,224807296,230083765,52,114,3,219530827,In > Out
Apr 2020,128,72,52,6579282,208783037,215362319,22,52,1,202203755,In > Out
Apr 2020,128,76,1044,618576041,7418020632,8036596673,327,1026,5,6799444591,In > Out
Apr 2020,128,77,1995,726832398,26019995963,26746828361,278,1916,9,25293163565,In > Out
Apr 2020,128,79,738,691989752,3491078224,4183067976,200,729,13,2799088472,In > Out
Apr 2020,128,8,29,3122889,13631925,16754814,19,29,2,10509036,In > Out
Apr 2020,128,80,304,56014876,1502561204,1558576080,121,304,3,1446546328,In > Out
Apr 2020,128,84,397,447284278,2577859276,3025143554,120,394,10,2130574998,In > Out
Apr 2020,128,87,427,111982771,667525909,779508680,125,416,4,555543138,In > Out
Apr 2020,128,89,3239,612959839,24298518047,24911477886,965,3043,3,23685558208,In > Out
Apr 2020,128,94,1143,1233264089,56995733998,58228998087,225,1130,8,55762469909,In > Out
Apr 2020,128,96,230,32400350,655224065,687624415,118,228,8,622823715,In > Out
Apr 2020,128,99,477,85231899,2033356595,2118588494,90,470,6,1948124696,In > Out
Apr 2020,129,120,3,268748,20451884,20720632,3,3,2,20183136,In > Out
Apr 2020,129,128,34,16263985,2149034644,2165298629,7,34,2,2132770659,In > Out
Apr 2020,129,130,53,773397,17383770,18157167,8,53,1,16610373,In > Out
Apr 2020,129,139,8,102753,1506099,1608852,5,8,1,1403346,In > Out
Apr 2020,129,147,99,14228560,11325881,25554441,2,99,2,2902679,Out > In
Apr 2020,129,155,7,5576777,181676,5758453,1,7,1,5395101,Out > In
Apr 2020,129,161,350,111500992,445858757,557359749,121,345,2,334357765,In > Out
Apr 2020,129,168,27,9342100,1227479606,1236821706,9,27,2,1218137506,In > Out
Apr 2020,129,171,1041,22140838,166044200,188185038,3,1041,2,143903362,In > Out
Apr 2020,129,174,60,1169031,13182242,14351273,11,60,1,12013211,In > Out
Apr 2020,129,176,1318,152674259,1422903454,1575577713,423,1285,2,1270229195,In > Out
Apr 2020,129,177,798,421337718,2324039098,2745376816,190,787,2,1902701380,In > Out
Apr 2020,129,193,57,23431090,1174595358,1198026448,23,57,2,1151164268,In > Out
Apr 2020,129,201,5,104167,2271221,2375388,2,5,1,2167054,In > Out
Apr 2020,129,203,160,47536055,58786715,106322770,1,1,2,11250660,In > Out
Apr 2020,129,207,24,9755696,1279381856,1289137552,8,24,2,1269626160,In > Out
Apr 2020,129,21,24,226794857,19622970,246417827,1,24,1,207171887,Out > In
Apr 2020,129,22,27,950745,51757075,52707820,10,27,1,50806330,In > Out
Apr 2020,129,224,11,4505371,306400451,310905822,5,11,1,301895080,In > Out
Apr 2020,129,225,42,2867186,67901429,70768615,21,42,2,65034243,In > Out
Apr 2020,129,229,4,825468,804912,1630380,2,1,1,20556,Out > In
Apr 2020,129,230,9,2672125,415575833,418247958,4,9,4,412903708,In > Out
Apr 2020,129,234,3,118136,7834756,7952892,1,3,1,7716620,In > Out
Apr 2020,129,236,10,21923,2393952,2415875,4,10,1,2372029,In > Out
Apr 2020,129,242,19,1097618,2210240,3307858,9,13,2,1112622,In > Out
Apr 2020,129,25,1,74922,5160822,5235744,1,1,1,5085900,In > Out
Apr 2020,129,31,291,34619168,2673862258,2708481426,100,288,2,2639243090,In > Out
Apr 2020,129,36,14,333389,19657029,19990418,4,14,2,19323640,In > Out
Apr 2020,129,38,184,51861159,3066844408,3118705567,54,184,2,3014983249,In > Out
Apr 2020,129,46,268,11928089,934824417,946752506,60,266,2,922896328,In > Out
Apr 2020,129,51,1,2174,107154,109328,1,1,1,104980,In > Out
Apr 2020,129,52,2,268463,102564,371027,2,1,1,165899,Out > In
Apr 2020,129,58,36,13820217,1715055482,1728875699,9,36,2,1701235265,In > Out
Apr 2020,129,63,232,26690775,310110456,336801231,94,229,3,283419681,In > Out
Apr 2020,129,64,2014,311286519,8755495344,9066781863,166,1922,3,8444208825,In > Out
Apr 2020,129,72,36,8417929,528776328,537194257,19,36,2,520358399,In > Out
Apr 2020,129,87,1096,146614551,752388574,899003125,213,1060,5,605774023,In > Out
Apr 2020,129,9,680,39306876,1418729925,1458036801,27,669,2,1379423049,In > Out
Apr 2020,129,97,3445,510465089,6208016678,6718481767,137,3079,2,5697551589,In > Out
Apr 2020,13,16,13,9289263,2966060686,2975349949,6,13,2,2956771423,In > Out
Apr 2020,13,17,86,11166289,3426365826,3437532115,3,86,1,3415199537,In > Out
Apr 2020,130,101,809,83627108,279322563,362949671,165,779,3,195695455,In > Out
Apr 2020,130,103,1127,209895595,1849568894,2059464489,152,1104,2,1639673299,In > Out
Apr 2020,130,104,1475,552637521,1730222122,2282859643,436,1438,5,1177584601,In > Out
Apr 2020,130,109,236,17789738,889856847,907646585,31,236,2,872067109,In > Out
Apr 2020,130,113,41,8173077,316070857,324243934,15,41,2,307897780,In > Out
Apr 2020,130,114,4,213184,215872,429056,1,4,1,2688,In > Out
Apr 2020,130,116,207,11326097,652878859,664204956,20,207,2,641552762,In > Out
Apr 2020,130,119,4,3878000,517023298,520901298,1,4,4,513145298,In > Out
Apr 2020,130,121,136,7999585,428703107,436702692,20,136,2,420703522,In > Out
Apr 2020,130,123,309,17374243,879876943,897251186,29,308,2,862502700,In > Out
Apr 2020,130,138,184,16132237,630150705,646282942,41,184,2,614018468,In > Out
Apr 2020,130,139,200,28014437,1017696319,1045710756,36,200,2,989681882,In > Out
Apr 2020,130,174,1081,146808784,684051008,830859792,229,1051,2,537242224,In > Out
Apr 2020,130,190,30,8346951,35685325,44032276,17,30,2,27338374,In > Out
Apr 2020,130,3,47,3099581,92802206,95901787,17,47,2,89702625,In > Out
Apr 2020,130,52,680,45286395,2054332114,2099618509,36,680,2,2009045719,In > Out
Apr 2020,130,53,99,4595770,255084261,259680031,21,99,2,250488491,In > Out
Apr 2020,130,54,174,23481866,742936937,766418803,39,173,2,719455071,In > Out
Apr 2020,130,55,594,48778174,557334481,606112655,138,590,2,508556307,In > Out
Apr 2020,130,57,17,128630,5934869,6063499,15,17,2,5806239,In > Out
Apr 2020,130,61,122,7496353,360574351,368070704,24,122,2,353077998,In > Out
Apr 2020,130,62,833,137248660,128102952,265351612,29,829,3,9145708,Out > In
Apr 2020,130,65,2937,78131782,1734190716,1812322498,276,2730,2,1656058934,In > Out
Apr 2020,130,69,62,5571798,298602276,304174074,11,62,2,293030478,In > Out
Apr 2020,130,71,6892,43561715,1320155478,1363717193,10,5601,2,1276593763,In > Out
Apr 2020,130,74,455,37443636,1765932807,1803376443,47,455,2,1728489171,In > Out
Apr 2020,130,76,12,50494,3166632,3217126,5,12,1,3116138,In > Out
Apr 2020,130,77,122,7630095,366183588,373813683,22,121,2,358553493,In > Out
Apr 2020,130,78,322,30384457,1633431005,1663815462,37,322,2,1603046548,In > Out
Apr 2020,130,79,3735,12092925484,4760237492,16853162976,663,3346,3,7332687992,Out > In
Apr 2020,130,81,3,337399,288266,625665,3,3,2,49133,Out > In
Apr 2020,130,86,1302,540427679,1615417975,2155845654,204,1263,5,1074990296,In > Out
Apr 2020,130,90,42,5079937,112122812,117202749,18,42,2,107042875,In > Out
Apr 2020,130,96,21,765505,22345462,23110967,15,21,2,21579957,In > Out
Apr 2020,131,100,298,16671851,544698281,561370132,56,298,4,528026430,In > Out
Apr 2020,131,102,123,16051580,667023973,683075553,42,122,2,650972393,In > Out
Apr 2020,131,104,12,538137,5526212,6064349,11,12,2,4988075,In > Out
Apr 2020,131,105,2329,436343060,11764144377,12200487437,742,2205,7,11327801317,In > Out
Apr 2020,131,108,91,22866557,1304617622,1327484179,54,91,2,1281751065,In > Out
Apr 2020,131,110,153,20304722,177899707,198204429,67,153,2,157594985,In > Out
Apr 2020,131,111,15,685290,5781431,6466721,12,15,2,5096141,In > Out
Apr 2020,131,112,29,22548651,1029559589,1052108240,13,29,2,1007010938,In > Out
Apr 2020,131,113,678,387347080,3507793418,3895140498,227,629,29,3120446338,In > Out
Apr 2020,131,114,88,24609404,1298953294,1323562698,33,88,1,1274343890,In > Out
Apr 2020,131,115,983,256266774,15005023761,15261290535,216,978,3,14748756987,In > Out
Apr 2020,131,118,383,96618724,411346854,507965578,167,378,10,314728130,In > Out
Apr 2020,131,12,418,37472570,1801154254,1838626824,163,416,5,1763681684,In > Out
Apr 2020,131,121,702,175386698,1099255453,1274642151,252,697,8,923868755,In > Out
Apr 2020,131,122,276,56834740,2720534976,2777369716,123,276,3,2663700236,In > Out
Apr 2020,131,124,357,59581236,4133752704,4193333940,160,357,6,4074171468,In > Out
Apr 2020,131,125,1975,337816525,12582852686,12920669211,228,1880,27,12245036161,In > Out
Apr 2020,131,127,73,4839811,137377692,142217503,44,73,3,132537881,In > Out
Apr 2020,131,128,2041,547757491,7857663833,8405421324,249,1930,9,7309906342,In > Out
Apr 2020,131,129,144,15601061,999771611,1015372672,62,144,4,984170550,In > Out
Apr 2020,131,130,72,13974760,971482765,985457525,51,72,3,957508005,In > Out
Apr 2020,131,131,1511,1090379433,8985832606,10076212039,284,1431,40,7895453173,In > Out
Apr 2020,131,132,690,463132767,3623078044,4086210811,172,688,8,3159945277,In > Out
Apr 2020,131,133,2,160588,55950,216538,2,2,1,104638,Out > In
Apr 2020,131,134,82,14227706,662793834,677021540,34,82,2,648566128,In > Out
Apr 2020,131,136,291,49065527,1614112760,1663178287,116,291,3,1565047233,In > Out
Apr 2020,131,137,174,180463807,529873555,710337362,62,171,3,349409748,In > Out
Apr 2020,131,138,481,76257351,1979198038,2055455389,94,472,6,1902940687,In > Out
Apr 2020,131,139,239,151440895,4452893797,4604334692,51,239,3,4301452902,In > Out
Apr 2020,131,14,1247,638440343,4487411162,5125851505,223,1202,20,3848970819,In > Out
Apr 2020,131,140,45,15311070,304415828,319726898,22,45,2,289104758,In > Out
Apr 2020,131,141,661,216237680,1851688349,2067926029,240,629,32,1635450669,In > Out
Apr 2020,131,142,62,2577723,60646673,63224396,20,62,2,58068950,In > Out
Apr 2020,131,143,2150,732515485,10994951584,11727467069,372,2068,2,10262436099,In > Out
Apr 2020,131,145,391,55869886,1318975703,1374845589,37,391,4,1263105817,In > Out
Apr 2020,131,147,2589,708638464,6941978832,7650617296,256,2481,8,6233340368,In > Out
Apr 2020,131,150,379,59269526,2469503047,2528772573,77,372,3,2410233521,In > Out
Apr 2020,131,151,254,23275557,1224509131,1247784688,61,254,3,1201233574,In > Out
Apr 2020,131,152,27,1861358,97112200,98973558,18,27,1,95250842,In > Out
Apr 2020,131,154,82,7874122,110697324,118571446,44,81,3,102823202,In > Out
Apr 2020,131,155,154,25553938,1899883280,1925437218,72,154,3,1874329342,In > Out
Apr 2020,131,156,7,528514,16660394,17188908,3,7,1,16131880,In > Out
Apr 2020,131,159,186,40892528,1747286631,1788179159,59,186,3,1706394103,In > Out
Apr 2020,131,162,774,77782566,6648019315,6725801881,167,774,4,6570236749,In > Out
Apr 2020,131,163,670,173827068,5591919151,5765746219,290,666,2,5418092083,In > Out
Apr 2020,131,167,2211,1716854123,9904838392,11621692515,437,2069,24,8187984269,In > Out
Apr 2020,131,171,1058,535758747,9284402378,9820161125,240,1035,11,8748643631,In > Out
Apr 2020,131,172,67,14619174,815157787,829776961,29,67,2,800538613,In > Out
Apr 2020,131,175,401,36481384,1459646178,1496127562,127,399,5,1423164794,In > Out
Apr 2020,131,176,329,18329649,542568516,560898165,105,326,3,524238867,In > Out
Apr 2020,131,177,617,71023115,3462770127,3533793242,218,610,4,3391747012,In > Out
Apr 2020,131,178,732,71384811,1703980751,1775365562,314,726,4,1632595940,In > Out
Apr 2020,131,179,883,44491775,1516692831,1561184606,164,857,2,1472201056,In > Out
Apr 2020,131,18,102,24074718,272496558,296571276,61,102,11,248421840,In > Out
Apr 2020,131,180,92,76659122,50486047,127145169,34,91,3,26173075,Out > In
Apr 2020,131,181,1227,13107362179,6599570144,19706932323,208,1018,112,6507792035,Out > In
Apr 2020,131,183,126,149759273,1799153545,1948912818,76,126,4,1649394272,In > Out
Apr 2020,131,184,218,654347048,839269337,1493616385,102,217,2,184922289,In > Out
Apr 2020,131,185,424,30557842,875525184,906083026,126,418,3,844967342,In > Out
Apr 2020,131,186,294,15540966,379764055,395305021,98,294,8,364223089,In > Out
Apr 2020,131,188,218,203130284,1185019521,1388149805,79,216,5,981889237,In > Out
Apr 2020,131,189,1,11404,106581,117985,1,1,1,95177,In > Out
Apr 2020,131,192,234,17025931,524589429,541615360,86,233,4,507563498,In > Out
Apr 2020,131,193,32,33097510,1940905798,1974003308,23,32,5,1907808288,In > Out
Apr 2020,131,194,450,70607002,2389348435,2459955437,62,448,3,2318741433,In > Out
Apr 2020,131,196,1,19340,736084,755424,1,1,1,716744,In > Out
Apr 2020,131,197,4,1427254,624247,2051501,3,4,1,803007,Out > In
Apr 2020,131,198,2223,91755982,3792784738,3884540720,196,2203,6,3701028756,In > Out
Apr 2020,131,199,1,61004,3201186,3262190,1,1,1,3140182,In > Out
Apr 2020,131,20,124,265970923,563810618,829781541,44,124,2,297839695,In > Out
Apr 2020,131,200,47,2471044,50431392,52902436,35,47,1,47960348,In > Out
Apr 2020,131,201,1151,108543261,3714319911,3822863172,393,1088,3,3605776650,In > Out
Apr 2020,131,203,510,22187884,1352062585,1374250469,53,510,2,1329874701,In > Out
Apr 2020,131,204,39,2738778,37295308,40034086,26,39,2,34556530,In > Out
Apr 2020,131,205,3079,727282391,6892070470,7619352861,293,2954,8,6164788079,In > Out
Apr 2020,131,206,243,366155391,1681020165,2047175556,76,243,3,1314864774,In > Out
Apr 2020,131,207,501,130325642,2399220139,2529545781,131,493,7,2268894497,In > Out
Apr 2020,131,208,192,6529328,217414614,223943942,63,184,2,210885286,In > Out
Apr 2020,131,21,351,75448665,4828308864,4903757529,78,349,3,4752860199,In > Out
Apr 2020,131,210,4300,259366803,10886613535,11145980338,263,3899,5,10627246732,In > Out
Apr 2020,131,211,41,2801068,139449515,142250583,20,41,3,136648447,In > Out
Apr 2020,131,212,544,629546159,7521124927,8150671086,136,543,6,6891578768,In > Out
Apr 2020,131,214,10,591680,3329407,3921087,6,10,2,2737727,In > Out
Apr 2020,131,217,56,4061008,50890374,54951382,37,54,3,46829366,In > Out
Apr 2020,131,218,17,422869,15696573,16119442,6,17,2,15273704,In > Out
Apr 2020,131,219,815,283757386,14527621880,14811379266,162,802,4,14243864494,In > Out
Apr 2020,131,220,962,336802569,6391938826,6728741395,322,949,6,6055136257,In > Out
Apr 2020,131,222,366,32615099,944458539,977073638,89,362,3,911843440,In > Out
Apr 2020,131,23,47,2536842,23004908,25541750,25,47,3,20468066,In > Out
Apr 2020,131,24,962,848834480,21608260848,22457095328,351,938,20,20759426368,In > Out
Apr 2020,131,27,447,84945582,1234402906,1319348488,224,446,3,1149457324,In > Out
Apr 2020,131,28,2,35876,1270089,1305965,1,2,1,1234213,In > Out
Apr 2020,131,29,252,35081058,1268504669,1303585727,101,250,5,1233423611,In > Out
Apr 2020,131,30,576,169414825,1966542924,2135957749,129,571,8,1797128099,In > Out
Apr 2020,131,32,45,31551321,200667020,232218341,25,44,4,169115699,In > Out
Apr 2020,131,33,304,78231580,1015253698,1093485278,17,300,3,937022118,In > Out
Apr 2020,131,34,1757,382379443,14018390826,14400770269,310,1693,4,13636011383,In > Out
Apr 2020,131,35,62,27506361,1116678472,1144184833,34,62,4,1089172111,In > Out
Apr 2020,131,36,416,38428929,3950480170,3988909099,152,416,3,3912051241,In > Out
Apr 2020,131,37,238,285880418,506624231,792504649,132,238,6,220743813,In > Out
Apr 2020,131,39,1061,113644831,2785723991,2899368822,155,1060,26,2672079160,In > Out
Apr 2020,131,40,264,30489302,684903609,715392911,63,242,7,654414307,In > Out
Apr 2020,131,41,566,110330550,2613790444,2724120994,158,566,15,2503459894,In > Out
Apr 2020,131,42,376,211569747,486737052,698306799,116,374,14,275167305,In > Out
Apr 2020,131,45,2035,575436375,8982951671,9558388046,293,1967,11,8407515296,In > Out
Apr 2020,131,46,332,50309981,1682941030,1733251011,118,326,6,1632631049,In > Out
Apr 2020,131,48,90,4996037,65963813,70959850,46,90,3,60967776,In > Out
Apr 2020,131,49,407,67613256,1804502088,1872115344,77,401,4,1736888832,In > Out
Apr 2020,131,52,391,29950182,691070917,721021099,170,390,2,661120735,In > Out
Apr 2020,131,53,843,150128842,2654757751,2804886593,161,843,9,2504628909,In > Out
Apr 2020,131,54,1886,780475971,46084849419,46865325390,379,1785,22,45304373448,In > Out
Apr 2020,131,55,49,1501875,75617896,77119771,12,49,3,74116021,In > Out
Apr 2020,131,56,114,6386569,139854604,146241173,24,114,3,133468035,In > Out
Apr 2020,131,57,421,42942728,897818595,940761323,106,421,24,854875867,In > Out
Apr 2020,131,59,361,2634382333,2687680110,5322062443,82,354,6,53297777,In > Out
Apr 2020,131,61,242,71222390,3922455611,3993678001,95,242,3,3851233221,In > Out
Apr 2020,131,62,91,11910758,561935051,573845809,30,91,2,550024293,In > Out
Apr 2020,131,64,153,70195014,1298552131,1368747145,55,153,3,1228357117,In > Out
Apr 2020,131,66,112,12361026,710815861,723176887,45,111,4,698454835,In > Out
Apr 2020,131,67,55,11187487,170114503,181301990,21,55,2,158927016,In > Out
Apr 2020,131,72,172,15024902,1014928769,1029953671,82,172,2,999903867,In > Out
Apr 2020,131,73,260,87982280,3526748559,3614730839,107,259,4,3438766279,In > Out
Apr 2020,131,74,406,151863871,3081516598,3233380469,129,406,2,2929652727,In > Out
Apr 2020,131,75,7,6015773,697981,6713754,5,7,2,5317792,Out > In
Apr 2020,131,76,537,129617875,2448942358,2578560233,123,524,3,2319324483,In > Out
Apr 2020,131,77,187,15934631,108499707,124434338,84,186,4,92565076,In > Out
Apr 2020,131,78,91,4210471,50021582,54232053,28,91,3,45811111,In > Out
Apr 2020,131,79,49,2338552,37009696,39348248,27,49,2,34671144,In > Out
Apr 2020,131,8,255,275043691,934013201,1209056892,120,254,3,658969510,In > Out
Apr 2020,131,83,149,10767578,264313673,275081251,105,148,2,253546095,In > Out
Apr 2020,131,85,24,1073575,16622506,17696081,24,24,2,15548931,In > Out
Apr 2020,131,86,4668,121843702,9316834169,9438677871,379,4594,3,9194990467,In > Out
Apr 2020,131,87,457,726564727,2163027099,2889591826,89,434,10,1436462372,In > Out
Apr 2020,131,90,5,219588,742825,962413,5,5,2,523237,In > Out
Apr 2020,131,91,403,63868348,1272311537,1336179885,115,401,3,1208443189,In > Out
Apr 2020,131,92,262,200621356,11358167122,11558788478,109,261,2,11157545766,In > Out
Apr 2020,131,94,45,30987324,583485908,614473232,16,45,2,552498584,In > Out
Apr 2020,131,97,633,101658052,8175909198,8277567250,222,633,5,8074251146,In > Out
Apr 2020,131,98,829,225159474,3389356267,3614515741,195,820,10,3164196793,In > Out
Apr 2020,132,10,130,20852189,111562471,132414660,54,130,1,90710282,In > Out
Apr 2020,132,100,180,11679279,187307562,198986841,95,178,5,175628283,In > Out
Apr 2020,132,101,82,5085669,639800170,644885839,10,82,4,634714501,In > Out
Apr 2020,132,102,36,39216258,31685691,70901949,18,36,3,7530567,Out > In
Apr 2020,132,105,808,1993106152,3827979809,5821085961,171,786,9,1834873657,In > Out
Apr 2020,132,106,972,54702786,1431969690,1486672476,169,955,16,1377266904,In > Out
Apr 2020,132,108,31,2484532,231215543,233700075,18,31,2,228731011,In > Out
Apr 2020,132,11,3,523036,6854523,7377559,3,3,2,6331487,In > Out
Apr 2020,132,110,272,68368968,3093234233,3161603201,137,271,3,3024865265,In > Out
Apr 2020,132,112,784,166712912,1986516405,2153229317,88,773,6,1819803493,In > Out
Apr 2020,132,113,1151,1919457934,5158225459,7077683393,272,1151,5,3238767525,In > Out
Apr 2020,132,115,6,130094,911599,1041693,3,6,1,781505,In > Out
Apr 2020,132,116,882,672038721,4065203876,4737242597,161,857,7,3393165155,In > Out
Apr 2020,132,117,155,15266152,173705377,188971529,67,155,2,158439225,In > Out
Apr 2020,132,118,452,39541382,1550988848,1590530230,141,449,4,1511447466,In > Out
Apr 2020,132,119,560,86078123,2088561359,2174639482,152,544,7,2002483236,In > Out
Apr 2020,132,12,296,28536323,1467361245,1495897568,142,293,3,1438824922,In > Out
Apr 2020,132,120,74,2227440,60864378,63091818,22,74,3,58636938,In > Out
Apr 2020,132,121,593,95631527,1359084032,1454715559,127,593,5,1263452505,In > Out
Apr 2020,132,122,2389,1769300639,38046533636,39815834275,769,2265,4,36277232997,In > Out
Apr 2020,132,123,78,11119739,378980298,390100037,19,78,4,367860559,In > Out
Apr 2020,132,124,125,777968722,202150935,980119657,69,124,4,575817787,Out > In
Apr 2020,132,127,597,64163796,2634720696,2698884492,124,582,3,2570556900,In > Out
Apr 2020,132,128,795,63779130,2253343542,2317122672,239,748,3,2189564412,In > Out
Apr 2020,132,129,442,51805151,505833256,557638407,148,442,3,454028105,In > Out
Apr 2020,132,132,135,24551342,169911415,194462757,27,135,2,145360073,In > Out
Apr 2020,132,134,1,11730,135695,147425,1,1,1,123965,In > Out
Apr 2020,132,137,25,6283380,255004205,261287585,10,25,1,248720825,In > Out
Apr 2020,132,139,283,33282144,481036080,514318224,67,283,5,447753936,In > Out
Apr 2020,132,14,1,13990,247833,261823,1,1,1,233843,In > Out
Apr 2020,132,140,16,808513,5677244,6485757,11,16,2,4868731,In > Out
Apr 2020,132,141,738,124970078,3480808466,3605778544,188,717,2,3355838388,In > Out
Apr 2020,132,143,133,12536514,793094138,805630652,69,133,2,780557624,In > Out
Apr 2020,132,145,738,554843502,1710228314,2265071816,198,736,4,1155384812,In > Out
Apr 2020,132,147,950,247814151,7605811252,7853625403,383,950,3,7357997101,In > Out
Apr 2020,132,148,387,68156381,419498008,487654389,129,386,3,351341627,In > Out
Apr 2020,132,150,184,6367128,359181215,365548343,23,184,2,352814087,In > Out
Apr 2020,132,151,7,1529208,924135,2453343,7,7,1,605073,Out > In
Apr 2020,132,152,495,70554832,2634058983,2704613815,144,494,4,2563504151,In > Out
Apr 2020,132,153,44,6537939,191919042,198456981,30,44,1,185381103,In > Out
Apr 2020,132,154,44,3461460,15111040,18572500,31,43,3,11649580,In > Out
Apr 2020,132,155,645,66363331,637734766,704098097,108,645,3,571371435,In > Out
Apr 2020,132,157,283,28001112,1248203845,1276204957,134,283,4,1220202733,In > Out
Apr 2020,132,158,1052,151383803,3823876577,3975260380,267,1033,8,3672492774,In > Out
Apr 2020,132,162,121,26512044,128353701,154865745,81,121,3,101841657,In > Out
Apr 2020,132,164,881,67147422,1863728142,1930875564,164,860,2,1796580720,In > Out
Apr 2020,132,165,950,162186989,2003120952,2165307941,169,935,23,1840933963,In > Out
Apr 2020,132,166,215,14523219,1431831708,1446354927,76,215,2,1417308489,In > Out
Apr 2020,132,168,39,14305438,57328707,71634145,24,39,1,43023269,In > Out
Apr 2020,132,169,2621,419122977,32431894109,32851017086,224,2467,4,32012771132,In > Out
Apr 2020,132,17,99,10019171,87030352,97049523,69,99,2,77011181,In > Out
Apr 2020,132,170,845,562040724,2082728446,2644769170,200,842,10,1520687722,In > Out
Apr 2020,132,171,134,11633631,215799439,227433070,60,134,2,204165808,In > Out
Apr 2020,132,173,396,44086248,803845441,847931689,48,394,5,759759193,In > Out
Apr 2020,132,174,392,118938547,165999763,284938310,151,391,3,47061216,In > Out
Apr 2020,132,175,320,218822916,704703126,923526042,132,317,7,485880210,In > Out
Apr 2020,132,176,440,197128040,2041839919,2238967959,205,440,10,1844711879,In > Out
Apr 2020,132,178,290,209597070,701462858,911059928,103,280,30,491865788,In > Out
Apr 2020,132,179,424,174540017,2576482263,2751022280,107,420,10,2401942246,In > Out
Apr 2020,132,18,447,38238475,2578141874,2616380349,88,442,3,2539903399,In > Out
Apr 2020,132,181,819,107497063,2197112001,2304609064,251,810,8,2089614938,In > Out
Apr 2020,132,182,833,320947208,7047492419,7368439627,210,813,6,6726545211,In > Out
Apr 2020,132,183,373,1285527734,3129204997,4414732731,102,367,9,1843677263,In > Out
Apr 2020,132,184,455,238831600,2481476607,2720308207,187,450,53,2242645007,In > Out
Apr 2020,132,185,107,15110971,95272256,110383227,56,107,2,80161285,In > Out
Apr 2020,132,186,252,342255047,5476063895,5818318942,75,249,8,5133808848,In > Out
Apr 2020,132,19,374,72884529,999644747,1072529276,60,374,3,926760218,In > Out
Apr 2020,132,191,221,82354221,774602134,856956355,94,221,30,692247913,In > Out
Apr 2020,132,193,245,27351602,377557369,404908971,64,243,3,350205767,In > Out
Apr 2020,132,194,244,193519354,3226470902,3419990256,85,241,24,3032951548,In > Out
Apr 2020,132,196,112,19800926,364092366,383893292,38,112,3,344291440,In > Out
Apr 2020,132,197,745,1058033727,11288918972,12346952699,229,724,7,10230885245,In > Out
Apr 2020,132,20,1,13386,285257,298643,1,1,1,271871,In > Out
Apr 2020,132,200,189,13240800,541021286,554262086,90,188,3,527780486,In > Out
Apr 2020,132,201,488,59071891,1598824142,1657896033,106,488,23,1539752251,In > Out
Apr 2020,132,202,6,777233,460667,1237900,5,6,1,316566,Out > In
Apr 2020,132,203,137,18177221,254530360,272707581,63,137,3,236353139,In > Out
Apr 2020,132,204,164,56910077,5377174693,5434084770,88,164,3,5320264616,In > Out
Apr 2020,132,205,185,18389254,222807475,241196729,99,185,3,204418221,In > Out
Apr 2020,132,206,22,1899982,74926712,76826694,13,22,1,73026730,In > Out
Apr 2020,132,21,645,68799938,720821591,789621529,152,638,5,652021653,In > Out
Apr 2020,132,214,596,950898803,2848443121,3799341924,171,583,5,1897544318,In > Out
Apr 2020,132,215,40,4155316,370545364,374700680,31,40,2,366390048,In > Out
Apr 2020,132,216,437,88035770,635927786,723963556,111,437,5,547892016,In > Out
Apr 2020,132,219,18,3070651,356458393,359529044,10,18,1,353387742,In > Out
Apr 2020,132,22,45,5904742,65704513,71609255,15,45,1,59799771,In > Out
Apr 2020,132,220,75,23986855,79945164,103932019,47,75,1,55958309,In > Out
Apr 2020,132,221,96,13939368,575712154,589651522,65,96,1,561772786,In > Out
Apr 2020,132,222,53,9031763,353733340,362765103,26,53,3,344701577,In > Out
Apr 2020,132,223,2957,3067508450,9752311464,12819819914,219,2601,58,6684803014,In > Out
Apr 2020,132,23,30,2292274,44141423,46433697,21,29,3,41849149,In > Out
Apr 2020,132,26,8,739775,4222510,4962285,6,8,2,3482735,In > Out
Apr 2020,132,27,23,1766071,12875381,14641452,19,23,2,11109310,In > Out
Apr 2020,132,28,453,127891951,1179237234,1307129185,132,432,4,1051345283,In > Out
Apr 2020,132,29,1186,441381813,4163507779,4604889592,214,1098,8,3722125966,In > Out
Apr 2020,132,30,347,57267319,167129381,224396700,135,347,3,109862062,In > Out
Apr 2020,132,31,3323,600113953,5974050615,6574164568,377,3097,7,5373936662,In > Out
Apr 2020,132,32,126,8746873,103028343,111775216,31,125,3,94281470,In > Out
Apr 2020,132,34,13,576379,20342535,20918914,6,13,1,19766156,In > Out
Apr 2020,132,35,87,6841733,1519842412,1526684145,43,87,2,1513000679,In > Out
Apr 2020,132,36,206,35900610,359643503,395544113,101,206,3,323742893,In > Out
Apr 2020,132,4,708,77616194,3831336526,3908952720,149,679,1,3753720332,In > Out
Apr 2020,132,40,321,412501793,2703339062,3115840855,130,321,3,2290837269,In > Out
Apr 2020,132,41,215,18807067,695444039,714251106,82,214,1,676636972,In > Out
Apr 2020,132,42,158,77286996,586064530,663351526,46,157,2,508777534,In > Out
Apr 2020,132,43,3252,536420382,22876775719,23413196101,734,3113,4,22340355337,In > Out
Apr 2020,132,44,169,16662966,788599686,805262652,46,169,5,771936720,In > Out
Apr 2020,132,46,217,27610824,617598131,645208955,97,217,3,589987307,In > Out
Apr 2020,132,48,21,2985382,226080149,229065531,17,21,2,223094767,In > Out
Apr 2020,132,49,480,48078903,3074269434,3122348337,127,480,3,3026190531,In > Out
Apr 2020,132,5,6,1655651,219506852,221162503,6,6,2,217851201,In > Out
Apr 2020,132,50,124,524262597,610205528,1134468125,50,122,6,85942931,In > Out
Apr 2020,132,51,115,12016857,91906432,103923289,64,115,3,79889575,In > Out
Apr 2020,132,54,123,40093646,574058090,614151736,61,123,3,533964444,In > Out
Apr 2020,132,55,443,16215400,1297758952,1313974352,55,443,1,1281543552,In > Out
Apr 2020,132,56,177,41511314,1162816413,1204327727,103,174,20,1121305099,In > Out
Apr 2020,132,58,127,9244003,338493053,347737056,40,127,3,329249050,In > Out
Apr 2020,132,59,2,20129,335760,355889,2,2,1,315631,In > Out
Apr 2020,132,6,978,71953958,2394336369,2466290327,100,972,5,2322382411,In > Out
Apr 2020,132,60,477,53464504,1244707946,1298172450,168,477,2,1191243442,In > Out
Apr 2020,132,61,101,9808361,244369903,254178264,43,101,5,234561542,In > Out
Apr 2020,132,62,175,16143555,266770384,282913939,49,175,2,250626829,In > Out
Apr 2020,132,63,1,33375,1361043,1394418,1,1,1,1327668,In > Out
Apr 2020,132,65,43,10409644,311353897,321763541,15,43,1,300944253,In > Out
Apr 2020,132,66,453,127121896,6458530368,6585652264,171,453,4,6331408472,In > Out
Apr 2020,132,67,104,27354683,2010908786,2038263469,41,103,4,1983554103,In > Out
Apr 2020,132,68,2,160522,104633,265155,2,2,1,55889,Out > In
Apr 2020,132,7,1289,962499450,4828704656,5791204106,244,1239,19,3866205206,In > Out
Apr 2020,132,70,82,1038624614,1631905140,2670529754,44,80,6,593280526,In > Out
Apr 2020,132,71,5761,1353784804,38596814713,39950599517,1247,5099,53,37243029909,In > Out
Apr 2020,132,72,48,8823142,136406426,145229568,27,48,1,127583284,In > Out
Apr 2020,132,73,1,7456,115720,123176,1,1,1,108264,In > Out
Apr 2020,132,74,145,153909751,613575487,767485238,40,144,2,459665736,In > Out
Apr 2020,132,75,1,10410,164427,174837,1,1,1,154017,In > Out
Apr 2020,132,76,381,89235784,1388899578,1478135362,67,379,6,1299663794,In > Out
Apr 2020,132,77,335,28170358,613557748,641728106,116,328,3,585387390,In > Out
Apr 2020,132,78,292,426430828,879905920,1306336748,107,292,4,453475092,In > Out
Apr 2020,132,79,101,11069200,304259387,315328587,37,101,3,293190187,In > Out
Apr 2020,132,80,1125,162451895,3023286700,3185738595,121,1108,5,2860834805,In > Out
Apr 2020,132,82,489,91784661,4140741547,4232526208,176,489,2,4048956886,In > Out
Apr 2020,132,83,181,11845379,1297810394,1309655773,69,181,3,1285965015,In > Out
Apr 2020,132,85,192,26850665,496498990,523349655,73,191,16,469648325,In > Out
Apr 2020,132,87,317,4645118,242866026,247511144,95,317,2,238220908,In > Out
Apr 2020,132,88,14,715444,4319383,5034827,6,14,1,3603939,In > Out
Apr 2020,132,89,1905,185024427,11572220382,11757244809,272,1899,5,11387195955,In > Out
Apr 2020,132,9,2,18547,457378,475925,2,2,1,438831,In > Out
Apr 2020,132,93,259,27845001,763332729,791177730,77,257,3,735487728,In > Out
Apr 2020,132,95,140,12452278,621355627,633807905,63,140,2,608903349,In > Out
Apr 2020,132,96,192,22421384,381358135,403779519,37,191,7,358936751,In > Out
Apr 2020,132,97,69,3952344,15834439,19786783,22,69,3,11882095,In > Out
Apr 2020,132,98,260,62919068,4381114919,4444033987,85,259,3,4318195851,In > Out
Apr 2020,132,99,105,31118917,1293100113,1324219030,54,105,1,1261981196,In > Out
Apr 2020,133,100,340,114551573,909595519,1024147092,140,337,8,795043946,In > Out
Apr 2020,133,103,121,1919006788,2162336195,4081342983,65,120,11,243329407,In > Out
Apr 2020,133,104,200,61772345,1102023782,1163796127,85,176,28,1040251437,In > Out
Apr 2020,133,106,1278,129514181,1294079798,1423593979,229,1261,6,1164565617,In > Out
Apr 2020,133,107,658,12145576,1049283654,1061429230,109,658,2,1037138078,In > Out
Apr 2020,133,11,551,59356504,1310988023,1370344527,171,540,4,1251631519,In > Out
Apr 2020,133,112,18,7591805,222999302,230591107,11,18,1,215407497,In > Out
Apr 2020,133,113,277,37063369,2134164698,2171228067,80,276,4,2097101329,In > Out
Apr 2020,133,114,201,61530675,2705905451,2767436126,84,198,4,2644374776,In > Out
Apr 2020,133,116,428,81318139,1793807193,1875125332,114,414,8,1712489054,In > Out
Apr 2020,133,118,1741,1046052876,4840061852,5886114728,342,1684,7,3794008976,In > Out
Apr 2020,133,119,557,71780214,3043225263,3115005477,213,542,3,2971445049,In > Out
Apr 2020,133,120,889,527234760,2109073879,2636308639,235,857,4,1581839119,In > Out
Apr 2020,133,121,722,406670757,6549840488,6956511245,103,666,6,6143169731,In > Out
Apr 2020,133,123,250,11337766,228987985,240325751,100,245,4,217650219,In > Out
Apr 2020,133,125,124,211677781,912956317,1124634098,44,122,4,701278536,In > Out
Apr 2020,133,126,73,6033495,62704195,68737690,38,73,4,56670700,In > Out
Apr 2020,133,127,559,273677555,256718802,530396357,213,542,4,16958753,Out > In
Apr 2020,133,128,147,7114803,179299218,186414021,70,147,4,172184415,In > Out
Apr 2020,133,129,259,20353416,723333395,743686811,150,258,1,702979979,In > Out
Apr 2020,133,130,103,6117899,167784646,173902545,53,102,4,161666747,In > Out
Apr 2020,133,131,946,110241427,5872899319,5983140746,174,918,4,5762657892,In > Out
Apr 2020,133,132,290,37670048,872916932,910586980,99,290,4,835246884,In > Out
Apr 2020,133,135,858,160901507,3263392873,3424294380,148,839,11,3102491366,In > Out
Apr 2020,133,136,444,55343938,1054102123,1109446061,171,433,2,998758185,In > Out
Apr 2020,133,137,954,117476658,6415725273,6533201931,241,911,3,6298248615,In > Out
Apr 2020,133,138,228,50010622,3627491077,3677501699,93,226,2,3577480455,In > Out
Apr 2020,133,139,2885,53925311,6793185007,6847110318,105,2885,4,6739259696,In > Out
Apr 2020,133,14,14,268394,23902312,24170706,5,14,1,23633918,In > Out
Apr 2020,133,140,1457,112257841,6244526992,6356784833,162,1457,2,6132269151,In > Out
Apr 2020,133,142,504,90995746,3072433109,3163428855,173,495,7,2981437363,In > Out
Apr 2020,133,147,1266,204817707,11981950581,12186768288,273,1249,15,11777132874,In > Out
Apr 2020,133,149,338,82250713,1429363400,1511614113,100,334,4,1347112687,In > Out
Apr 2020,133,15,534,341767313,2064028688,2405796001,107,530,6,1722261375,In > Out
Apr 2020,133,150,419,196781333,1999612246,2196393579,134,414,12,1802830913,In > Out
Apr 2020,133,152,68,18271088,226532157,244803245,47,68,2,208261069,In > Out
Apr 2020,133,153,562,101438786,1321314351,1422753137,104,562,8,1219875565,In > Out
Apr 2020,133,155,275,23427444,560015063,583442507,104,265,3,536587619,In > Out
Apr 2020,133,156,2273,347473811,12917923392,13265397203,332,2187,19,12570449581,In > Out
Apr 2020,133,157,56,2830848,78162973,80993821,19,56,3,75332125,In > Out
Apr 2020,133,159,78,8183748,359696379,367880127,39,78,2,351512631,In > Out
Apr 2020,133,16,3,114917,283897,398814,3,3,1,168980,In > Out
Apr 2020,133,160,22,277008,4651146,4928154,6,22,2,4374138,In > Out
Apr 2020,133,163,129,22249951,254947347,277197298,72,129,15,232697396,In > Out
Apr 2020,133,164,238,18179149,681928612,700107761,76,234,3,663749463,In > Out
Apr 2020,133,165,217,81796833,918626532,1000423365,100,215,3,836829699,In > Out
Apr 2020,133,168,399,273938262,5849644944,6123583206,156,397,5,5575706682,In > Out
Apr 2020,133,169,377,135879139,1407175993,1543055132,175,377,6,1271296854,In > Out
Apr 2020,133,17,11423,1151197241,20023970630,21175167871,627,8552,13,18872773389,In > Out
Apr 2020,133,171,864,284478160,3606034353,3890512513,241,863,5,3321556193,In > Out
Apr 2020,133,172,235,91256540,7091949686,7183206226,118,235,2,7000693146,In > Out
Apr 2020,133,175,177,24271161,226634302,250905463,34,176,1,202363141,In > Out
Apr 2020,133,176,31,4248014,111823800,116071814,23,31,4,107575786,In > Out
Apr 2020,133,177,17,3702849,12232031,15934880,12,17,2,8529182,In > Out
Apr 2020,133,178,141,14249455,478570919,492820374,78,141,3,464321464,In > Out
Apr 2020,133,179,473,25920173,1521285062,1547205235,96,473,6,1495364889,In > Out
Apr 2020,133,18,94,18663662,1112565134,1131228796,39,94,1,1093901472,In > Out
Apr 2020,133,183,125,29292719,147448295,176741014,51,125,2,118155576,In > Out
Apr 2020,133,186,477,61195788,5175385509,5236581297,147,467,5,5114189721,In > Out
Apr 2020,133,188,53,11337201,44035983,55373184,28,53,3,32698782,In > Out
Apr 2020,133,189,107,12873988,420153114,433027102,47,107,3,407279126,In > Out
Apr 2020,133,19,642,132420437,2550112278,2682532715,182,625,3,2417691841,In > Out
Apr 2020,133,191,96,11396795,1189946114,1201342909,35,96,2,1178549319,In > Out
Apr 2020,133,192,536,41512643,993751953,1035264596,213,515,25,952239310,In > Out
Apr 2020,133,193,12,4353461,110249471,114602932,10,12,4,105896010,In > Out
Apr 2020,133,194,763,63480591,2569474961,2632955552,148,752,3,2505994370,In > Out
Apr 2020,133,195,370,38781378,860500670,899282048,125,360,3,821719292,In > Out
Apr 2020,133,198,968,28290600,3642387493,3670678093,75,963,2,3614096893,In > Out
Apr 2020,133,199,11,689447,3056091,3745538,8,11,1,2366644,In > Out
Apr 2020,133,201,1501,793480256,8512344879,9305825135,400,1434,8,7718864623,In > Out
Apr 2020,133,203,20,2246729,122332899,124579628,9,20,2,120086170,In > Out
Apr 2020,133,204,206,135182304,834280230,969462534,87,206,16,699097926,In > Out
Apr 2020,133,206,113,8456902,212260067,220716969,58,113,2,203803165,In > Out
Apr 2020,133,207,657,51785465,3046513278,3098298743,149,596,17,2994727813,In > Out
Apr 2020,133,208,2011,1144757158,50868622098,52013379256,356,1871,4,49723864940,In > Out
Apr 2020,133,21,59,9972464,1172024414,1181996878,30,59,2,1162051950,In > Out
Apr 2020,133,211,3561,6664558947,28293424060,34957983007,1097,3231,14,21628865113,In > Out
Apr 2020,133,213,43,1685018,51608853,53293871,18,43,1,49923835,In > Out
Apr 2020,133,215,7,179378,4223883,4403261,5,7,2,4044505,In > Out
Apr 2020,133,216,676,148535835,7529353818,7677889653,213,671,4,7380817983,In > Out
Apr 2020,133,217,725,98764082,5488123643,5586887725,216,722,5,5389359561,In > Out
Apr 2020,133,218,161,35046833,219811128,254857961,87,161,4,184764295,In > Out
Apr 2020,133,220,785,62356379,1471438585,1533794964,205,730,8,1409082206,In > Out
Apr 2020,133,221,10,6826178,420686008,427512186,7,10,2,413859830,In > Out
Apr 2020,133,222,429,18684393,1025171783,1043856176,80,429,2,1006487390,In > Out
Apr 2020,133,223,1144,882617325,2881291544,3763908869,279,1106,4,1998674219,In > Out
Apr 2020,133,25,693,176915091,9857400998,10034316089,291,690,4,9680485907,In > Out
Apr 2020,133,26,190,23893004,560370488,584263492,105,189,2,536477484,In > Out
Apr 2020,133,27,302,29073275,669401506,698474781,125,296,5,640328231,In > Out
Apr 2020,133,28,34,6975968,396166712,403142680,17,34,1,389190744,In > Out
Apr 2020,133,30,13,659821,7970718,8630539,7,13,2,7310897,In > Out
Apr 2020,133,31,669,64800904,2364282784,2429083688,160,662,7,2299481880,In > Out
Apr 2020,133,32,238,38177874,1617206040,1655383914,91,237,2,1579028166,In > Out
Apr 2020,133,33,522,35229784,1766169588,1801399372,189,521,2,1730939804,In > Out
Apr 2020,133,36,50,7733610,118257777,125991387,29,50,3,110524167,In > Out
Apr 2020,133,37,1794,771839247,9702946638,10474785885,441,1669,72,8931107391,In > Out
Apr 2020,133,4,30,4409694,38127096,42536790,23,30,2,33717402,In > Out
Apr 2020,133,40,1003,59216523,2005998760,2065215283,145,972,2,1946782237,In > Out
Apr 2020,133,44,492,839551425,2761670314,3601221739,186,490,8,1922118889,In > Out
Apr 2020,133,45,7051,7586042848,15825172471,23411215319,740,5791,31,8239129623,In > Out
Apr 2020,133,46,822,392398510,6208207195,6600605705,298,811,5,5815808685,In > Out
Apr 2020,133,47,847,54354289,715858772,770213061,272,835,4,661504483,In > Out
Apr 2020,133,48,80,7401798,390187796,397589594,15,79,2,382785998,In > Out
Apr 2020,133,54,950,10009324950,6620052327,16629377277,78,910,29,3389272623,Out > In
Apr 2020,133,55,938,3800728985,2506658232,6307387217,207,924,4,1294070753,Out > In
Apr 2020,133,56,101,10800294,404675549,415475843,35,101,2,393875255,In > Out
Apr 2020,133,57,111,93855815,342153452,436009267,67,110,4,248297637,In > Out
Apr 2020,133,59,407,44262903,405235267,449498170,122,403,2,360972364,In > Out
Apr 2020,133,60,266,88965769,7940912301,8029878070,61,266,3,7851946532,In > Out
Apr 2020,133,61,292,232723420,487363402,720086822,119,291,4,254639982,In > Out
Apr 2020,133,62,844,261330839,3210932775,3472263614,232,835,7,2949601936,In > Out
Apr 2020,133,63,471,272751793,1280003788,1552755581,72,469,7,1007251995,In > Out
Apr 2020,133,64,343,79609511,2372969433,2452578944,86,339,3,2293359922,In > Out
Apr 2020,133,65,430,21446922,1704643039,1726089961,137,429,2,1683196117,In > Out
Apr 2020,133,69,50,5522204,71235680,76757884,28,50,8,65713476,In > Out
Apr 2020,133,70,556,72343487,2461024323,2533367810,111,549,6,2388680836,In > Out
Apr 2020,133,74,32,2168911,36986550,39155461,13,32,1,34817639,In > Out
Apr 2020,133,75,86,6196212,215726445,221922657,55,86,3,209530233,In > Out
Apr 2020,133,77,310,17454863,1153032677,1170487540,84,310,2,1135577814,In > Out
Apr 2020,133,81,60,86156700,84596620,170753320,23,60,2,1560080,Out > In
Apr 2020,133,84,448,209548240,3618805999,3828354239,108,445,11,3409257759,In > Out
Apr 2020,133,86,75,59695232,2216150402,2275845634,33,75,2,2156455170,In > Out
Apr 2020,133,87,163,22426998,178650565,201077563,55,163,4,156223567,In > Out
Apr 2020,133,92,478,231353436,1101032365,1332385801,166,472,4,869678929,In > Out
Apr 2020,133,93,820,90499748,3602624846,3693124594,281,804,4,3512125098,In > Out
Apr 2020,133,95,1475,3275750181,1938154398,5213904579,1000,932,879,1337595783,Out > In
Apr 2020,133,98,159,54836727,1026234747,1081071474,87,159,4,971398020,In > Out
Apr 2020,134,102,700,58685060,1386682357,1445367417,174,692,3,1327997297,In > Out
Apr 2020,134,103,83,50905002,1554454445,1605359447,42,83,3,1503549443,In > Out
Apr 2020,134,107,199,20174306,589678369,609852675,75,199,2,569504063,In > Out
Apr 2020,134,109,30,1576968,48039158,49616126,25,30,3,46462190,In > Out
Apr 2020,134,11,216,25324507,3417267362,3442591869,52,215,2,3391942855,In > Out
Apr 2020,134,110,4534,893066946,31421514814,32314581760,887,4005,6,30528447868,In > Out
Apr 2020,134,113,89,12332762,732625404,744958166,40,89,3,720292642,In > Out
Apr 2020,134,114,363,138063368,6049243415,6187306783,94,350,2,5911180047,In > Out
Apr 2020,134,115,2158,536371471,16257946368,16794317839,371,2057,6,15721574897,In > Out
Apr 2020,134,116,3,402626,604964,1007590,3,3,1,202338,In > Out
Apr 2020,134,117,84,7969744,706328667,714298411,50,84,3,698358923,In > Out
Apr 2020,134,12,390,88849274,2126355961,2215205235,122,389,7,2037506687,In > Out
Apr 2020,134,120,22,1034252,13731093,14765345,15,22,2,12696841,In > Out
Apr 2020,134,122,359,23832487,1173280692,1197113179,128,359,2,1149448205,In > Out
Apr 2020,134,123,230,22853412,778651726,801505138,72,230,2,755798314,In > Out
Apr 2020,134,124,21,1495401,54938930,56434331,14,21,2,53443529,In > Out
Apr 2020,134,126,44,4778364,674472749,679251113,30,44,1,669694385,In > Out
Apr 2020,134,127,636,596680392,7793737646,8390418038,161,629,7,7197057254,In > Out
Apr 2020,134,128,2,94296,204888,299184,2,2,1,110592,In > Out
Apr 2020,134,129,485,35538347,1235793372,1271331719,51,485,2,1200255025,In > Out
Apr 2020,134,13,110,19789287,998878569,1018667856,62,110,4,979089282,In > Out
Apr 2020,134,130,134,83724595,1479179358,1562903953,37,134,5,1395454763,In > Out
Apr 2020,134,131,169,41714481,1556674034,1598388515,75,169,2,1514959553,In > Out
Apr 2020,134,132,65,9338352,51286603,60624955,51,65,2,41948251,In > Out
Apr 2020,134,133,190,17385733,507765769,525151502,61,190,5,490380036,In > Out
Apr 2020,134,134,446,92930803,1215663146,1308593949,89,443,2,1122732343,In > Out
Apr 2020,134,135,38,4046158,185851614,189897772,20,38,2,181805456,In > Out
Apr 2020,134,136,773,143943757,3133841561,3277785318,174,766,9,2989897804,In > Out
Apr 2020,134,137,89,5298936,55770604,61069540,24,89,2,50471668,In > Out
Apr 2020,134,138,162,24259729,130829196,155088925,80,162,5,106569467,In > Out
Apr 2020,134,139,7,1569990,117168740,118738730,5,7,2,115598750,In > Out
Apr 2020,134,140,248,35095387,1588434395,1623529782,92,245,4,1553339008,In > Out
Apr 2020,134,142,173,16142898,468341601,484484499,59,172,13,452198703,In > Out
Apr 2020,134,143,29,25807407,195589096,221396503,14,29,3,169781689,In > Out
Apr 2020,134,144,141,19026664,978934647,997961311,52,141,3,959907983,In > Out
Apr 2020,134,145,15,963126,16681188,17644314,9,15,1,15718062,In > Out
Apr 2020,134,146,214,23604834,874889379,898494213,91,214,4,851284545,In > Out
Apr 2020,134,147,1350,714842461,4563994131,5278836592,274,1314,8,3849151670,In > Out
Apr 2020,134,150,228,59273722,1606688801,1665962523,124,228,5,1547415079,In > Out
Apr 2020,134,153,142,27618999,2160742623,2188361622,51,142,3,2133123624,In > Out
Apr 2020,134,154,2236,109618788,5225198757,5334817545,196,2206,5,5115579969,In > Out
Apr 2020,134,155,77,4363702,170476564,174840266,40,77,4,166112862,In > Out
Apr 2020,134,156,113,3836793,134395655,138232448,26,113,4,130558862,In > Out
Apr 2020,134,157,2565,226320734,3860196085,4086516819,310,2506,3,3633875351,In > Out
Apr 2020,134,158,148,89232015,483645327,572877342,65,148,2,394413312,In > Out
Apr 2020,134,159,108,33898016,3569904827,3603802843,63,108,2,3536006811,In > Out
Apr 2020,134,162,4272,3186764281,18737850951,21924615232,441,3819,25,15551086670,In > Out
Apr 2020,134,163,57,6214680,87749763,93964443,54,57,2,81535083,In > Out
Apr 2020,134,164,1459,256156390,5970754972,6226911362,364,1420,3,5714598582,In > Out
Apr 2020,134,167,55,5031115,215134130,220165245,25,55,5,210103015,In > Out
Apr 2020,134,168,11,3523038,150280731,153803769,6,11,1,146757693,In > Out
Apr 2020,134,174,49,2929926,101220110,104150036,37,49,1,98290184,In > Out
Apr 2020,134,175,57,12799247,197930785,210730032,28,57,2,185131538,In > Out
Apr 2020,134,176,6,200567,3657436,3858003,6,6,1,3456869,In > Out
Apr 2020,134,178,73,19489115,486544573,506033688,27,73,4,467055458,In > Out
Apr 2020,134,179,129,27356018,1919409717,1946765735,71,129,2,1892053699,In > Out
Apr 2020,134,180,2571,1295989807,8702227716,9998217523,331,2478,11,7406237909,In > Out
Apr 2020,134,181,28,2491058,7009375,9500433,21,28,4,4518317,In > Out
Apr 2020,134,182,410,196560949,1555471653,1752032602,165,408,8,1358910704,In > Out
Apr 2020,134,185,57,230577312,290083105,520660417,36,55,4,59505793,In > Out
Apr 2020,134,187,156,33931442,1818609935,1852541377,78,156,2,1784678493,In > Out
Apr 2020,134,188,127,13331250,192270475,205601725,78,127,3,178939225,In > Out
Apr 2020,134,19,3,51277,400014,451291,2,3,1,348737,In > Out
Apr 2020,134,190,1744,91160309,4981691331,5072851640,1118,1186,829,4890531022,In > Out
Apr 2020,134,192,365,155691997,1921471451,2077163448,132,357,11,1765779454,In > Out
Apr 2020,134,194,89,39817084,113496118,153313202,38,89,4,73679034,In > Out
Apr 2020,134,196,763,66920205,1057223942,1124144147,336,762,3,990303737,In > Out
Apr 2020,134,198,751,112356366,1538796598,1651152964,221,750,2,1426440232,In > Out
Apr 2020,134,20,241,28080620,1332899856,1360980476,79,240,4,1304819236,In > Out
Apr 2020,134,201,559,46441097,1090277072,1136718169,171,552,2,1043835975,In > Out
Apr 2020,134,202,145,17635264,714736906,732372170,64,145,5,697101642,In > Out
Apr 2020,134,204,290,180162699,915629324,1095792023,89,286,7,735466625,In > Out
Apr 2020,134,205,15,2184133,4248059,6432192,12,15,2,2063926,In > Out
Apr 2020,134,206,123,18842244,2964649214,2983491458,51,123,16,2945806970,In > Out
Apr 2020,134,209,1875,96105525,3760192251,3856297776,1022,1391,812,3664086726,In > Out
Apr 2020,134,212,169,18816389,1124768839,1143585228,62,169,3,1105952450,In > Out
Apr 2020,134,213,739,70571782,613360890,683932672,101,731,3,542789108,In > Out
Apr 2020,134,214,35,2570396,22888120,25458516,25,35,2,20317724,In > Out
Apr 2020,134,215,46,3987530,156772995,160760525,29,46,3,152785465,In > Out
Apr 2020,134,216,13,357467,7733558,8091025,10,13,1,7376091,In > Out
Apr 2020,134,217,3169,1707653555,11255223147,12962876702,762,2881,170,9547569592,In > Out
Apr 2020,134,218,41,1804757,29959621,31764378,19,41,2,28154864,In > Out
Apr 2020,134,220,2,15183,264624,279807,2,2,1,249441,In > Out
Apr 2020,134,222,281,88266557,1035505343,1123771900,86,280,7,947238786,In > Out
Apr 2020,134,223,265,29146271,906533423,935679694,128,263,4,877387152,In > Out
Apr 2020,134,23,570,2576582970,5477522119,8054105089,151,555,17,2900939149,In > Out
Apr 2020,134,24,577,20352791,1281633923,1301986714,89,577,3,1261281132,In > Out
Apr 2020,134,26,180,32473248,1655712878,1688186126,63,175,4,1623239630,In > Out
Apr 2020,134,28,38,7711948,186886162,194598110,30,38,3,179174214,In > Out
Apr 2020,134,29,129,10583271,472176245,482759516,45,129,2,461592974,In > Out
Apr 2020,134,30,1087,95147259,3721998536,3817145795,345,1016,69,3626851277,In > Out
Apr 2020,134,32,181,32435083,1466377330,1498812413,76,181,3,1433942247,In > Out
Apr 2020,134,33,1,7125,126352,133477,1,1,1,119227,In > Out
Apr 2020,134,34,24,94039534,66942837,160982371,16,24,3,27096697,Out > In
Apr 2020,134,38,1,55196,176944,232140,1,1,1,121748,In > Out
Apr 2020,134,39,1,21311,153642,174953,1,1,1,132331,In > Out
Apr 2020,134,4,897,62821882,1312978364,1375800246,145,897,4,1250156482,In > Out
Apr 2020,134,40,591,716517165,6783649994,7500167159,164,586,7,6067132829,In > Out
Apr 2020,134,42,1176,488715662,1488269541,1976985203,155,1071,7,999553879,In > Out
Apr 2020,134,43,157,23771230,767025170,790796400,77,155,4,743253940,In > Out
Apr 2020,134,44,45,4376749,82882375,87259124,28,45,3,78505626,In > Out
Apr 2020,134,45,123,23928451,1302628061,1326556512,72,123,2,1278699610,In > Out
Apr 2020,134,47,327,137817127,987727311,1125544438,125,326,7,849910184,In > Out
Apr 2020,134,48,1111,1013736676,5642298072,6656034748,336,1094,5,4628561396,In > Out
Apr 2020,134,5,2,56520,1487188,1543708,2,2,1,1430668,In > Out
Apr 2020,134,50,451,48181084,1518458083,1566639167,202,451,1,1470276999,In > Out
Apr 2020,134,52,695,82680434,5268279277,5350959711,183,684,4,5185598843,In > Out
Apr 2020,134,53,115,423274245,29524012,452798257,58,115,2,393750233,Out > In
Apr 2020,134,54,25,2464394,48268848,50733242,19,25,2,45804454,In > Out
Apr 2020,134,55,402,90492904,3113878092,3204370996,123,399,10,3023385188,In > Out
Apr 2020,134,56,307,59123856,465703475,524827331,126,307,1,406579619,In > Out
Apr 2020,134,60,273,99065634,197305537,296371171,87,271,4,98239903,In > Out
Apr 2020,134,61,109,29588734,1277709479,1307298213,64,109,2,1248120745,In > Out
Apr 2020,134,62,768,110994093,6058984719,6169978812,269,754,2,5947990626,In > Out
Apr 2020,134,63,13,2157664,8134480,10292144,5,13,2,5976816,In > Out
Apr 2020,134,64,2747,153356271,4704095377,4857451648,239,2509,8,4550739106,In > Out
Apr 2020,134,66,658,159705621,2658180444,2817886065,313,418,267,2498474823,In > Out
Apr 2020,134,67,302,37827336,1363000050,1400827386,100,301,4,1325172714,In > Out
Apr 2020,134,69,17,1868268,33241487,35109755,10,17,1,31373219,In > Out
Apr 2020,134,7,493,214112569,1444705081,1658817650,189,486,18,1230592512,In > Out
Apr 2020,134,71,1009,1133544466,3845276578,4978821044,129,999,5,2711732112,In > Out
Apr 2020,134,72,981,174803251,6891777124,7066580375,141,978,3,6716973873,In > Out
Apr 2020,134,73,979,29173521,2430048662,2459222183,146,979,2,2400875141,In > Out
Apr 2020,134,74,152,10467493,561057273,571524766,58,151,6,550589780,In > Out
Apr 2020,134,75,122,23071829,218003755,241075584,6,122,4,194931926,In > Out
Apr 2020,134,76,524,170450917,4695478677,4865929594,186,520,26,4525027760,In > Out
Apr 2020,134,77,222,13615326,739872057,753487383,58,221,3,726256731,In > Out
Apr 2020,134,78,157,22971033,927258405,950229438,53,157,3,904287372,In > Out
Apr 2020,134,80,88,13520983,472827475,486348458,58,88,3,459306492,In > Out
Apr 2020,134,81,2518,136321199,6872659784,7008980983,410,2317,73,6736338585,In > Out
Apr 2020,134,82,792,141827385,7402588747,7544416132,269,783,1,7260761362,In > Out
Apr 2020,134,84,1070,489114309,12367558423,12856672732,248,1034,7,11878444114,In > Out
Apr 2020,134,86,816,84567447,6347660073,6432227520,81,815,9,6263092626,In > Out
Apr 2020,134,88,790,334508654,3936012770,4270521424,193,771,5,3601504116,In > Out
Apr 2020,134,89,32,4537280,195705489,200242769,22,32,2,191168209,In > Out
Apr 2020,134,90,321,121883587,3797962020,3919845607,134,321,3,3676078433,In > Out
Apr 2020,134,91,1313,450508296,5822341133,6272849429,183,1298,3,5371832837,In > Out
Apr 2020,134,92,3,200148,2453011,2653159,2,3,1,2252863,In > Out
Apr 2020,134,94,150,8594747,191603299,200198046,34,150,4,183008552,In > Out
Apr 2020,134,95,228,47114782,2146914862,2194029644,77,227,3,2099800080,In > Out
Apr 2020,134,97,1273,637165010,6364751195,7001916205,229,1220,4,5727586185,In > Out
Apr 2020,134,98,1416,175451063,5036737280,5212188343,281,1361,20,4861286217,In > Out
Apr 2020,134,99,25,553738,4661145,5214883,19,25,2,4107407,In > Out
Apr 2020,138,133,700,47338543,1556420897,1603759440,116,700,2,1509082354,In > Out
Apr 2020,138,135,919,192936171,12982456200,13175392371,71,854,2,12789520029,In > Out
Apr 2020,138,62,741,176764155,10806995817,10983759972,67,700,2,10630231662,In > Out
Apr 2020,138,71,877,182912607,9523909985,9706822592,87,850,2,9340997378,In > Out
Apr 2020,14,10,239,2801490,225722441,228523931,53,238,2,222920951,In > Out
Apr 2020,14,111,82,1545658,294341330,295886988,15,82,2,292795672,In > Out
Apr 2020,14,12,16,860687,67813070,68673757,3,16,1,66952383,In > Out
Apr 2020,14,16,1146,86575546,1733789530,1820365076,142,1114,11,1647213984,In > Out
Apr 2020,14,18,49,7524859,230457455,237982314,22,49,2,222932596,In > Out
Apr 2020,14,20,8,583947,20949761,21533708,6,8,2,20365814,In > Out
Apr 2020,14,42,18,767368,61098039,61865407,6,18,2,60330671,In > Out
Apr 2020,14,57,166,8838010,465831961,474669971,29,162,2,456993951,In > Out
Apr 2020,141,109,274,9796770,761569587,771366357,48,273,2,751772817,In > Out
Apr 2020,141,114,183,54182778,2945656542,2999839320,55,183,2,2891473764,In > Out
Apr 2020,141,130,809,43572987,2543710261,2587283248,45,793,2,2500137274,In > Out
Apr 2020,141,136,27,6366209,232372656,238738865,11,27,1,226006447,In > Out
Apr 2020,141,165,24,833888,50704589,51538477,6,24,1,49870701,In > Out
Apr 2020,141,170,263,13624768,772842498,786467266,31,262,2,759217730,In > Out
Apr 2020,141,194,245,7570735,614602146,622172881,37,244,2,607031411,In > Out
Apr 2020,141,195,148,18480868,597827360,616308228,55,148,2,579346492,In > Out
Apr 2020,141,28,1014,157446459,390529755,547976214,93,991,3,233083296,In > Out
Apr 2020,141,36,138,8256740,663741901,671998641,27,138,2,655485161,In > Out
Apr 2020,141,38,1,15166,425116,440282,1,1,1,409950,In > Out
Apr 2020,141,40,67,9119067,661691649,670810716,20,67,2,652572582,In > Out
Apr 2020,141,91,234,8221307,640536208,648757515,29,234,2,632314901,In > Out
Apr 2020,141,94,5,601259,3421353,4022612,4,5,1,2820094,In > Out
Apr 2020,142,11,11,916575,33682466,34599041,4,11,1,32765891,In > Out
Apr 2020,142,121,2,1446372,815000317,816446689,2,2,2,813553945,In > Out
Apr 2020,142,122,10,506777,121718071,122224848,5,10,1,121211294,In > Out
Apr 2020,142,13,15,1538681,56193222,57731903,4,15,1,54654541,In > Out
Apr 2020,142,14,506,4643000,681248511,685891511,4,499,494,676605511,In > Out
Apr 2020,142,16,8,1026223,159168504,160194727,2,8,1,158142281,In > Out
Apr 2020,142,17,64,115848,12037855,12153703,2,1,64,11922007,In > Out
Apr 2020,142,18,4,189242,39053552,39242794,3,4,2,38864310,In > Out
Apr 2020,142,19,3,192536,21634589,21827125,3,3,1,21442053,In > Out
Apr 2020,142,21,3,307127,44352411,44659538,2,3,2,44045284,In > Out
Apr 2020,142,22,23,31704,2673906,2705610,1,1,23,2642202,In > Out
Apr 2020,142,24,3,1595126,792064928,793660054,3,3,2,790469802,In > Out
Apr 2020,142,27,5,285879,121070038,121355917,2,5,1,120784159,In > Out
Apr 2020,142,28,157,688778,155662575,156351353,2,5,144,154973797,In > Out
Apr 2020,142,30,14,2918877,87655485,90574362,4,14,2,84736608,In > Out
Apr 2020,142,32,6,358308,131615226,131973534,3,6,1,131256918,In > Out
Apr 2020,142,35,16,3078503,251737104,254815607,5,16,2,248658601,In > Out
Apr 2020,142,36,40,8460750,106593355,115054105,7,40,29,98132605,In > Out
Apr 2020,142,4,12,1873649,61681395,63555044,3,12,1,59807746,In > Out
Apr 2020,142,41,12,1651951,61661874,63313825,4,12,1,60009923,In > Out
Apr 2020,142,46,12,554904,18939096,19494000,3,12,1,18384192,In > Out
Apr 2020,142,47,12,1509965,50971314,52481279,4,12,1,49461349,In > Out
Apr 2020,142,5,13,1884062,53494859,55378921,3,13,1,51610797,In > Out
Apr 2020,142,50,2,129710,24258106,24387816,1,2,1,24128396,In > Out
Apr 2020,142,54,2,6613522,110344,6723866,2,2,2,6503178,Out > In
Apr 2020,142,55,4,257267,86963766,87221033,1,4,1,86706499,In > Out
Apr 2020,142,56,229,93416004,866636,94282640,2,228,216,92549368,Out > In
Apr 2020,142,57,500,209255214,2605356,211860570,9,497,395,206649858,Out > In
Apr 2020,142,58,24,22663738,802176,23465914,5,23,24,21861562,Out > In
Apr 2020,142,59,362,134532764,1224364,135757128,1,362,304,133308400,Out > In
Apr 2020,142,60,6,717994,147888604,148606598,4,6,2,147170610,In > Out
Apr 2020,142,61,5,467614,122059328,122526942,2,5,1,121591714,In > Out
Apr 2020,142,63,9,1744930,168083523,169828453,4,9,1,166338593,In > Out
Apr 2020,142,67,3,336292,80775825,81112117,3,3,1,80439533,In > Out
Apr 2020,142,68,210,2168876,55432172,57601048,4,210,1,53263296,In > Out
Apr 2020,142,69,121,7505723,310650313,318156036,6,121,2,303144590,In > Out
Apr 2020,142,70,2370,14469490,310157083,324626573,2,2268,1,295687593,In > Out
Apr 2020,142,71,21117,233392124,7255682496,7489074620,6,10952,8,7022290372,In > Out
Apr 2020,142,72,5,420096,125305670,125725766,2,5,1,124885574,In > Out
Apr 2020,142,74,902,383193576,17890128097,18273321673,3,902,2,17506934521,In > Out
Apr 2020,142,75,5,257764,111364898,111622662,2,5,1,111107134,In > Out
Apr 2020,142,77,2,161858,28975634,29137492,2,2,2,28813776,In > Out
Apr 2020,142,79,1198,26950315,955829093,982779408,13,1159,2,928878778,In > Out
Apr 2020,142,80,8,855853,152789704,153645557,2,8,1,151933851,In > Out
Apr 2020,142,81,9,1253453,40556564,41810017,3,9,1,39303111,In > Out
Apr 2020,142,84,8,1533940,50788085,52322025,4,8,1,49254145,In > Out
Apr 2020,142,86,8,448213,101544099,101992312,5,4,6,101095886,In > Out
Apr 2020,142,87,6,396616,125552492,125949108,3,6,1,125155876,In > Out
Apr 2020,142,88,4,519363,117446719,117966082,3,4,1,116927356,In > Out
Apr 2020,142,89,4,561079,122093152,122654231,4,4,1,121532073,In > Out
Apr 2020,142,9,15,1773539,59621184,61394723,4,15,1,57847645,In > Out
Apr 2020,142,90,5,381715,108770748,109152463,2,5,1,108389033,In > Out
Apr 2020,142,91,3,125546,64414836,64540382,1,3,1,64289290,In > Out
Apr 2020,142,92,4,436196,108919823,109356019,4,4,1,108483627,In > Out
Apr 2020,142,93,8,572369,119605841,120178210,2,8,1,119033472,In > Out
Apr 2020,142,94,14,2170070,67707681,69877751,3,14,1,65537611,In > Out
Apr 2020,142,96,12,1308758,48832131,50140889,3,12,1,47523373,In > Out
Apr 2020,142,97,21,1808409,66684917,68493326,4,21,1,64876508,In > Out
Apr 2020,142,98,5,165887,87143331,87309218,2,5,1,86977444,In > Out
Apr 2020,142,99,644,15041927,158683021,173724948,47,634,1,143641094,In > Out
Apr 2020,143,128,8020,9006471051,160680850944,169687321995,955,6862,30,151674379893,In > Out
Apr 2020,143,148,152,13039713,486294396,499334109,16,152,1,473254683,In > Out
Apr 2020,143,151,980,51736685,3511384602,3563121287,25,980,2,3459647917,In > Out
Apr 2020,143,152,15443,20151322958,116648295478,136799618436,2315,10969,25,96496972520,In > Out
Apr 2020,143,156,351,29085889,2623108887,2652194776,128,351,2,2594022998,In > Out
Apr 2020,143,157,318,10781051,626477138,637258189,13,318,1,615696087,In > Out
Apr 2020,143,168,768,126770389,18389682923,18516453312,101,714,3,18262912534,In > Out
Apr 2020,143,186,3277,417774000,21294540090,21712314090,786,3026,3,20876766090,In > Out
Apr 2020,143,20,8562,4544150074,258029512071,262573662145,872,6706,77,253485361997,In > Out
Apr 2020,143,205,8004,3784749853,156864790520,160649540373,1302,6476,10,153080040667,In > Out
Apr 2020,143,212,254,39438313,4845139780,4884578093,14,254,2,4805701467,In > Out
Apr 2020,143,216,302,11239998,418220545,429460543,17,302,1,406980547,In > Out
Apr 2020,143,22,128,2879761,130686763,133566524,16,128,2,127807002,In > Out
Apr 2020,143,25,959,69180355,4153006445,4222186800,21,959,1,4083826090,In > Out
Apr 2020,143,27,2343,87614796,5204262468,5291877264,34,2129,2,5116647672,In > Out
Apr 2020,143,28,6577,1063449172,68898313880,69961763052,1116,5199,13,67834864708,In > Out
Apr 2020,143,32,3278,935195078,30328915210,31264110288,706,3050,5,29393720132,In > Out
Apr 2020,143,34,45780,3979409725,211171439941,215150849666,335,15386,2,207192030216,In > Out
Apr 2020,143,42,418,24179185,1574596352,1598775537,17,418,1,1550417167,In > Out
Apr 2020,144,147,5,73998,2289444,2363442,2,5,1,2215446,In > Out
Apr 2020,144,210,53,11119653,583336341,594455994,24,53,2,572216688,In > Out
Apr 2020,144,29,2,337936,146462,484398,1,2,1,191474,Out > In
Apr 2020,144,79,144,15049748,1328504425,1343554173,30,143,2,1313454677,In > Out
Apr 2020,145,105,2,39878,2586603,2626481,2,2,1,2546725,In > Out
Apr 2020,145,163,17,1234244,43252194,44486438,11,17,2,42017950,In > Out
Apr 2020,145,170,1084,265828988,16011756770,16277585758,85,1079,2,15745927782,In > Out
Apr 2020,145,186,254,7120618,458769353,465889971,21,254,2,451648735,In > Out
Apr 2020,145,29,25,1504298,18369950,19874248,8,25,2,16865652,In > Out
Apr 2020,145,52,11,196867,11418184,11615051,8,11,2,11221317,In > Out
Apr 2020,145,53,39,981559,56518107,57499666,17,39,2,55536548,In > Out
Apr 2020,145,64,11,210785,15745957,15956742,6,11,2,15535172,In > Out
Apr 2020,145,65,46,1382869,95112577,96495446,25,46,2,93729708,In > Out
Apr 2020,145,68,166,5901708,469506119,475407827,20,166,2,463604411,In > Out
Apr 2020,145,71,110,2728781,193797544,196526325,23,110,2,191068763,In > Out
Apr 2020,145,74,347,12140898,845799718,857940616,24,347,2,833658820,In > Out
Apr 2020,145,79,13,269908,20697434,20967342,6,13,2,20427526,In > Out
Apr 2020,145,89,16,994274,62499575,63493849,12,16,2,61505301,In > Out
Apr 2020,145,9,335,15447836,1277493879,1292941715,47,286,2,1262046043,In > Out
Apr 2020,145,90,14,289966,18804497,19094463,9,14,2,18514531,In > Out
Apr 2020,145,94,276,8560271,570689945,579250216,24,276,2,562129674,In > Out
Apr 2020,145,95,616,30395973,2069445648,2099841621,48,544,2,2039049675,In > Out
Apr 2020,146,119,468,60329143,1091589080,1151918223,130,464,8,1031259937,In > Out
Apr 2020,146,127,74,5037629,295148671,300186300,23,74,2,290111042,In > Out
Apr 2020,146,128,130,11666046,642116679,653782725,31,130,2,630450633,In > Out
Apr 2020,146,148,209,24533427,218640805,243174232,91,207,2,194107378,In > Out
Apr 2020,146,152,692,164689444,672160331,836849775,151,675,3,507470887,In > Out
Apr 2020,146,157,139,25602961,952545055,978148016,60,138,3,926942094,In > Out
Apr 2020,146,159,220,13112253,732056983,745169236,21,220,2,718944730,In > Out
Apr 2020,146,163,37,1315004,68431092,69746096,21,37,2,67116088,In > Out
Apr 2020,146,166,1,6981,162363,169344,1,1,1,155382,In > Out
Apr 2020,146,175,134,8370080,506558233,514928313,19,134,2,498188153,In > Out
Apr 2020,146,185,995,90655720,361184671,451840391,159,964,3,270528951,In > Out
Apr 2020,146,24,24,1415071,17892017,19307088,8,24,2,16476946,In > Out
Apr 2020,146,57,75,3256839,185796330,189053169,18,75,2,182539491,In > Out
Apr 2020,146,8,5,4497252,251257176,255754428,4,5,2,246759924,In > Out
Apr 2020,149,116,192,23839437,487877703,511717140,44,191,2,464038266,In > Out
Apr 2020,149,135,225,29801023,2902895269,2932696292,51,225,2,2873094246,In > Out
Apr 2020,149,140,39,2783674,98459512,101243186,12,39,2,95675838,In > Out
Apr 2020,149,160,103,229854162,79921763,309775925,65,10,16,149932399,Out > In
Apr 2020,149,162,134,6177950,344157873,350335823,22,134,2,337979923,In > Out
Apr 2020,149,189,39,2666190,143318071,145984261,20,39,2,140651881,In > Out
Apr 2020,149,197,248,17340280,972855578,990195858,34,248,2,955515298,In > Out
Apr 2020,149,218,14,2789093,501377039,504166132,10,14,2,498587946,In > Out
Apr 2020,149,222,44,9889866,338892041,348781907,12,44,2,329002175,In > Out
Apr 2020,149,228,98,3544609,605539609,609084218,19,98,2,601995000,In > Out
Apr 2020,149,229,964,69912439,1981907757,2051820196,222,947,2,1911995318,In > Out
Apr 2020,149,36,124,890558,27888131,28778689,4,124,1,26997573,In > Out
Apr 2020,149,50,710,124815869,1103764386,1228580255,196,697,2,978948517,In > Out
Apr 2020,149,63,4089,3309334284,1561743355,4871077639,231,3389,240,1747590929,Out > In
Apr 2020,149,73,523,11897741,1558611661,1570509402,47,514,2,1546713920,In > Out
Apr 2020,149,8,16,20139397,1185227394,1205366791,12,16,2,1165087997,In > Out
Apr 2020,149,86,136,45766463,2507932135,2553698598,28,136,2,2462165672,In > Out
Apr 2020,149,88,11,313009,12498925,12811934,5,11,2,12185916,In > Out
Apr 2020,149,91,13,375213,5933858,6309071,5,13,2,5558645,In > Out
Apr 2020,149,95,261,15967231,906337001,922304232,22,252,2,890369770,In > Out
Apr 2020,150,115,8772,1498393177,3673487608,5171880785,423,7143,7,2175094431,In > Out
Apr 2020,150,125,8,3991107,766263380,770254487,6,8,1,762272273,In > Out
Apr 2020,150,143,1332,96884708,828555734,925440442,420,1294,3,731671026,In > Out
Apr 2020,150,15,250,14111602,403707553,417819155,12,248,3,389595951,In > Out
Apr 2020,150,165,128,8361792,423026612,431388404,50,128,2,414664820,In > Out
Apr 2020,150,182,501,8581756876,390533043,8972289919,235,1,401,8191223833,Out > In
Apr 2020,150,193,627,116812858,2370775385,2487588243,213,616,2,2253962527,In > Out
Apr 2020,150,195,45,3946517,78683760,82630277,33,45,2,74737243,In > Out
Apr 2020,150,200,28,2953452,122857995,125811447,19,28,2,119904543,In > Out
Apr 2020,150,207,71,5383474,309953851,315337325,19,70,2,304570377,In > Out
Apr 2020,150,214,60,9148847,129705232,138854079,45,60,2,120556385,In > Out
Apr 2020,150,215,26,1801966,58823362,60625328,20,26,2,57021396,In > Out
Apr 2020,150,216,13,307538,2002291,2309829,10,13,2,1694753,In > Out
Apr 2020,150,219,1127,329964902,1293964315,1623929217,48,1089,2,963999413,In > Out
Apr 2020,150,220,173,4984010,356842128,361826138,20,173,2,351858118,In > Out
Apr 2020,150,222,26,3116073,81118489,84234562,15,26,2,78002416,In > Out
Apr 2020,150,226,129,20944237,2863626928,2884571165,68,129,2,2842682691,In > Out
Apr 2020,150,240,304,44683535,225077603,269761138,96,300,2,180394068,In > Out
Apr 2020,150,243,188,11019321,1824620110,1835639431,43,188,2,1813600789,In > Out
Apr 2020,150,250,13,1160145,53909163,55069308,10,13,2,52749018,In > Out
Apr 2020,150,70,331,53290117,4352994471,4406284588,88,329,3,4299704354,In > Out
Apr 2020,150,71,62,8644200,341705100,350349300,18,62,2,333060900,In > Out
Apr 2020,151,51,1,97284,54686,151970,1,1,1,42598,Out > In
Apr 2020,151,96,835,236404271,22664803,259069074,35,824,2,213739468,Out > In
Apr 2020,153,78,64,2375428,134848754,137224182,17,64,2,132473326,In > Out
Apr 2020,154,104,23,1560389,28278341,29838730,14,23,2,26717952,In > Out
Apr 2020,154,131,27,2380183,75551754,77931937,18,26,2,73171571,In > Out
Apr 2020,154,141,118,17381086,862133922,879515008,23,118,2,844752836,In > Out
Apr 2020,154,143,21,2337231,124578277,126915508,16,21,2,122241046,In > Out
Apr 2020,154,148,30,1997596,38286219,40283815,18,29,2,36288623,In > Out
Apr 2020,154,151,19,1331553,79431047,80762600,13,19,2,78099494,In > Out
Apr 2020,154,160,26,2963894,115456207,118420101,19,25,2,112492313,In > Out
Apr 2020,154,172,18,1780950,86673549,88454499,14,17,2,84892599,In > Out
Apr 2020,154,173,48,3531602,110324672,113856274,22,47,2,106793070,In > Out
Apr 2020,154,187,30,2620763,104890626,107511389,18,30,2,102269863,In > Out
Apr 2020,154,192,17,592472,24602727,25195199,13,17,2,24010255,In > Out
Apr 2020,154,204,37,5332594,152619789,157952383,23,37,2,147287195,In > Out
Apr 2020,154,206,25,1711791,81867468,83579259,18,25,2,80155677,In > Out
Apr 2020,154,217,19,646750,31864927,32511677,13,19,2,31218177,In > Out
Apr 2020,154,222,780,49908027,1637699595,1687607622,103,756,2,1587791568,In > Out
Apr 2020,154,25,449,26385420,1392170185,1418555605,26,449,2,1365784765,In > Out
Apr 2020,154,26,100,8426264,518314703,526740967,20,100,2,509888439,In > Out
Apr 2020,154,43,15,2014409,107823879,109838288,11,15,2,105809470,In > Out
Apr 2020,154,45,217,22503925,410382326,432886251,101,215,2,387878401,In > Out
Apr 2020,154,50,122,6668822,359947694,366616516,19,119,2,353278872,In > Out
Apr 2020,154,51,24,2612460,126044314,128656774,17,24,2,123431854,In > Out
Apr 2020,154,57,13,2568298,50029537,52597835,10,13,2,47461239,In > Out
Apr 2020,154,6,41,5688419,102059906,107748325,33,41,2,96371487,In > Out
Apr 2020,154,61,129,9109427,456438430,465547857,16,129,2,447329003,In > Out
Apr 2020,154,66,27,2962724,84815600,87778324,19,27,2,81852876,In > Out
Apr 2020,154,78,3760,275871431,2077511310,2353382741,109,3638,2,1801639879,In > Out
Apr 2020,154,79,16,1239777,46814548,48054325,12,16,2,45574771,In > Out
Apr 2020,155,106,6,494832,582248,1077080,5,3,2,87416,In > Out
Apr 2020,155,126,3,193254,41469008,41662262,2,3,1,41275754,In > Out
Apr 2020,155,132,3,283244,64696479,64979723,1,3,1,64413235,In > Out
Apr 2020,155,135,7,3695308,69495102,73190410,5,7,4,65799794,In > Out
Apr 2020,155,136,3,236930,43038957,43275887,3,3,1,42802027,In > Out
Apr 2020,155,137,7,2624750,43218734,45843484,5,7,2,40593984,In > Out
Apr 2020,155,142,335,180286169,42417163,222703332,63,4,331,137869006,Out > In
Apr 2020,155,143,6,381584,52898759,53280343,2,6,1,52517175,In > Out
Apr 2020,155,145,4689,27315104,3199767077,3227082181,10,4091,9,3172451973,In > Out
Apr 2020,155,146,31,37396692,11798761317,11836158009,13,30,6,11761364625,In > Out
Apr 2020,155,149,347,173775830,70026612,243802442,76,6,343,103749218,Out > In
Apr 2020,155,150,2,216508,44283874,44500382,1,2,1,44067366,In > Out
Apr 2020,155,151,60,27943946,495570688,523514634,22,60,9,467626742,In > Out
Apr 2020,155,152,5,331504,63557353,63888857,2,5,2,63225849,In > Out
Apr 2020,155,154,3,192920,42830020,43022940,1,3,1,42637100,In > Out
Apr 2020,155,166,3,76914,15804682,15881596,3,3,1,15727768,In > Out
Apr 2020,155,167,23,161720,2689093,2850813,2,23,1,2527373,In > Out
Apr 2020,155,169,148,224902756,196393396,421296152,78,52,19,28509360,Out > In
Apr 2020,155,170,157,295574342,163786054,459360396,88,44,25,131788288,Out > In
Apr 2020,155,198,2,121032,30425187,30546219,1,2,1,30304155,In > Out
Apr 2020,155,199,22,1474898,91249068,92723966,14,22,2,89774170,In > Out
Apr 2020,155,200,17,510055,108658717,109168772,2,17,2,108148662,In > Out
Apr 2020,155,201,4,356952,82058512,82415464,1,4,1,81701560,In > Out
Apr 2020,155,202,2,163876,35689732,35853608,1,2,1,35525856,In > Out
Apr 2020,155,204,4,373674,79423781,79797455,1,4,1,79050107,In > Out
Apr 2020,155,205,5,326408,78490925,78817333,2,5,1,78164517,In > Out
Apr 2020,155,206,5,366748,83197887,83564635,2,5,2,82831139,In > Out
Apr 2020,155,220,28,637320,119682520,120319840,7,28,2,119045200,In > Out
Apr 2020,156,133,244,25014891,767941006,792955897,61,241,2,742926115,In > Out
Apr 2020,156,136,693,101490071,271016013,372506084,150,679,2,169525942,In > Out
Apr 2020,156,142,505,64498519,472618431,537116950,91,498,2,408119912,In > Out
Apr 2020,156,171,112,18969544,333320543,352290087,24,112,2,314350999,In > Out
Apr 2020,156,175,192,35144777,908734096,943878873,41,192,2,873589319,In > Out
Apr 2020,156,178,413,29528603,828614161,858142764,96,407,2,799085558,In > Out
Apr 2020,156,180,981,144218454,6869978511,7014196965,148,950,2,6725760057,In > Out
Apr 2020,156,187,15,312687,15735336,16048023,12,15,2,15422649,In > Out
Apr 2020,156,188,287,14172164,772524390,786696554,24,287,2,758352226,In > Out
Apr 2020,156,189,1527,7559621392,5003438903,12563060295,459,1477,4,2556182489,Out > In
Apr 2020,156,216,150,10448365,399681089,410129454,71,150,2,389232724,In > Out
Apr 2020,156,218,667,99667313,560825571,660492884,182,660,2,461158258,In > Out
Apr 2020,156,233,129,7555092,465695746,473250838,33,129,2,458140654,In > Out
Apr 2020,156,238,112,8717859,506443804,515161663,22,112,2,497725945,In > Out
Apr 2020,156,243,48,4917157,259315027,264232184,21,48,2,254397870,In > Out
Apr 2020,159,128,38,4013776,213621008,217634784,19,38,2,209607232,In > Out
Apr 2020,159,136,40,1145744,119258747,120404491,20,40,2,118113003,In > Out
Apr 2020,159,145,1127,318801341,2741104572,3059905913,238,1118,3,2422303231,In > Out
Apr 2020,159,161,225,9869994,519313688,529183682,25,225,2,509443694,In > Out
Apr 2020,159,171,72,6234745,315720154,321954899,18,72,2,309485409,In > Out
Apr 2020,159,192,112,20627169,215353352,235980521,77,112,2,194726183,In > Out
Apr 2020,159,201,115,339923597,926245796,1266169393,58,115,3,586322199,In > Out
Apr 2020,159,203,117,11888626,608396631,620285257,19,117,2,596508005,In > Out
Apr 2020,159,217,231,37041642,961123940,998165582,100,230,2,924082298,In > Out
Apr 2020,159,229,149,7711125,434887406,442598531,20,149,2,427176281,In > Out
Apr 2020,159,248,768,483018263,19264712583,19747730846,140,768,3,18781694320,In > Out
Apr 2020,159,30,243,11597863,647181385,658779248,20,243,2,635583522,In > Out
Apr 2020,159,34,100,10330871,469447982,479778853,22,100,2,459117111,In > Out
Apr 2020,159,67,980,124011383,377484881,501496264,162,959,3,253473498,In > Out
Apr 2020,159,70,110,9180462,1542201298,1551381760,43,110,2,1533020836,In > Out
Apr 2020,16,10,325,319656707,4677593724,4997250431,65,322,5,4357937017,In > Out
Apr 2020,16,12,2022,147543919,12126653193,12274197112,163,1944,2,11979109274,In > Out
Apr 2020,16,14,21403,3386019596,44767757210,48153776806,811,12551,16,41381737614,In > Out
Apr 2020,16,16,7206,284724660,46161313076,46446037736,169,5651,2,45876588416,In > Out
Apr 2020,16,19,511,66449863,134374009,200823872,25,504,2,67924146,In > Out
Apr 2020,16,2,752,86581338,6120070630,6206651968,42,737,2,6033489292,In > Out
Apr 2020,16,20,14830,1070375458,48487934908,49558310366,567,11401,11,47417559450,In > Out
Apr 2020,16,240,594,33165653,3402737833,3435903486,105,581,2,3369572180,In > Out
Apr 2020,16,4,396,37868217,1256431075,1294299292,65,391,3,1218562858,In > Out
Apr 2020,16,7,7023,258095299,14872581994,15130677293,188,5636,2,14614486695,In > Out
Apr 2020,160,10,402,22850828,922431665,945282493,95,395,3,899580837,In > Out
Apr 2020,160,105,51517,1394341599,39056594143,40450935742,208,34195,4,37662252544,In > Out
Apr 2020,160,106,3608,2703680076,58240556873,60944236949,225,3278,2,55536876797,In > Out
Apr 2020,160,107,8227,483970286,22394222987,22878193273,188,7654,3,21910252701,In > Out
Apr 2020,160,108,1358,728809758,184529838994,185258648752,230,1290,2,183801029236,In > Out
Apr 2020,160,109,2027,2966662283,95725696928,98692359211,226,1911,18,92759034645,In > Out
Apr 2020,160,11,309,35050967,644566520,679617487,140,305,4,609515553,In > Out
Apr 2020,160,110,2691,1533748235,28976997305,30510745540,304,2485,4,27443249070,In > Out
Apr 2020,160,111,2223,14797167427,228400080872,243197248299,284,2109,2,213602913445,In > Out
Apr 2020,160,112,38060,523011133,30244941881,30767953014,156,28061,3,29721930748,In > Out
Apr 2020,160,12,158,5370061,530708249,536078310,62,150,3,525338188,In > Out
Apr 2020,160,121,125542,46186348302,345450890062,391637238364,4178,18023,67,299264541760,In > Out
Apr 2020,160,122,128329,31377020846,315434357081,346811377927,3878,17581,57,284057336235,In > Out
Apr 2020,160,123,131919,45125682186,369437572269,414563254455,4275,17778,149,324311890083,In > Out
Apr 2020,160,124,148927,71448064837,355359476363,426807541200,4683,23286,38,283911411526,In > Out
Apr 2020,160,125,125452,28762326314,398480149861,427242476175,3801,16830,46,369717823547,In > Out
Apr 2020,160,126,114321,19630952538,282706107421,302337059959,3975,16658,68,263075154883,In > Out
Apr 2020,160,127,129882,22879480915,365900735214,388780216129,4820,17680,59,343021254299,In > Out
Apr 2020,160,128,31912,3928938371,68505597270,72434535641,1716,15543,13,64576658899,In > Out
Apr 2020,160,13,1402,313410306,39728912,353139218,13,1322,2,273681394,Out > In
Apr 2020,160,130,514,21447724,1729488136,1750935860,73,486,2,1708040412,In > Out
Apr 2020,160,132,66048,4542283425,192052960542,196595243967,767,16169,3,187510677117,In > Out
Apr 2020,160,14,127,11001064,24008406,35009470,15,127,1,13007342,In > Out
Apr 2020,160,144,135,4680773704,446316076899,450996850603,64,134,3,441635303195,In > Out
Apr 2020,160,15,21,263364,16152442,16415806,9,21,2,15889078,In > Out
Apr 2020,160,152,406,1571275268,4982333368,6553608636,133,396,129,3411058100,In > Out
Apr 2020,160,153,604,2278929142,7101717562,9380646704,168,584,169,4822788420,In > Out
Apr 2020,160,154,413,1805379168,5363738723,7169117891,130,406,147,3558359555,In > Out
Apr 2020,160,155,440,1894754193,5663741590,7558495783,140,428,146,3768987397,In > Out
Apr 2020,160,156,439,2254384954,6683649359,8938034313,149,425,178,4429264405,In > Out
Apr 2020,160,157,476,1875517366,9322964117,11198481483,134,471,131,7447446751,In > Out
Apr 2020,160,16,138,58973661,658101633,717075294,39,133,5,599127972,In > Out
Apr 2020,160,196,409402,294498669504,1311314909540,1605813579044,20474,23059,927,1016816240036,In > Out
Apr 2020,160,197,433525,303451481603,1375143492013,1678594973616,21596,29671,1177,1071692010410,In > Out
Apr 2020,160,198,416772,300785158333,1378445300800,1679230459133,20582,21883,487,1077660142467,In > Out
Apr 2020,160,199,392553,251796586147,1294707244807,1546503830954,20372,22898,563,1042910658660,In > Out
Apr 2020,160,200,130748,59372500310,332947280546,392319780856,8683,17769,282,273574780236,In > Out
Apr 2020,160,201,135499,67576648499,353416169227,420992817726,8647,17790,292,285839520728,In > Out
Apr 2020,160,202,140555,71460901194,348269271484,419730172678,9421,17365,328,276808370290,In > Out
Apr 2020,160,203,139261,69666438975,418730968778,488397407753,9099,18862,391,349064529803,In > Out
Apr 2020,160,216,32664,17919467877,22019633212,39939101089,51,24974,3,4100165335,In > Out
Apr 2020,160,227,203,31231919,614413709,645645628,34,202,2,583181790,In > Out
Apr 2020,160,236,19,15057752,1053826870,1068884622,9,19,3,1038769118,In > Out
Apr 2020,160,237,149,4129337,423578672,427708009,24,149,2,419449335,In > Out
Apr 2020,160,238,7180,4455943319,15972572822,20428516141,390,5808,13,11516629503,In > Out
Apr 2020,160,239,8014,5847791403,89457481944,95305273347,1861,6763,316,83609690541,In > Out
Apr 2020,160,240,4713,7727945831,84241058111,91969003942,1098,4232,69,76513112280,In > Out
Apr 2020,160,241,3464,2385673590,32655222339,35040895929,943,3165,16,30269548749,In > Out
Apr 2020,160,242,15367,25899589809,85564644910,111464234719,2348,10966,137,59665055101,In > Out
Apr 2020,160,243,2290,825426457,19074304768,19899731225,634,2210,15,18248878311,In > Out
Apr 2020,160,244,9502,6136764099,89793066662,95929830761,2129,7210,303,83656302563,In > Out
Apr 2020,160,245,5876,2520100454,26704151092,29224251546,989,5240,26,24184050638,In > Out
Apr 2020,160,246,6564,4224074101,41263368103,45487442204,1245,5272,129,37039294002,In > Out
Apr 2020,160,247,2361,1184683763,10200082988,11384766751,698,2251,14,9015399225,In > Out
Apr 2020,160,249,28,1951883,76249473,78201356,16,28,2,74297590,In > Out
Apr 2020,160,33,1135,229573698,9655296297,9884869995,240,1107,9,9425722599,In > Out
Apr 2020,160,34,2617,505259176,33745408881,34250668057,427,2464,3,33240149705,In > Out
Apr 2020,160,35,333,134265157,8143953113,8278218270,104,327,2,8009687956,In > Out
Apr 2020,160,36,3404,1807913257,20512397366,22320310623,229,1840,3,18704484109,In > Out
Apr 2020,160,37,3066,344479986,12749194114,13093674100,256,2957,4,12404714128,In > Out
Apr 2020,160,38,1089,777107652,24019882661,24796990313,261,1054,3,23242775009,In > Out
Apr 2020,160,39,3220,3731893248,6300809946,10032703194,151,1151,3,2568916698,In > Out
Apr 2020,160,40,514,3784493819,11885558126,15670051945,120,512,27,8101064307,In > Out
Apr 2020,160,57,4499,158802020920,17438875075,176240895995,381,3951,14,141363145845,Out > In
Apr 2020,160,58,3831,3317510523,9480872608,12798383131,667,3533,15,6163362085,In > Out
Apr 2020,160,59,5853,3048000702,6751889540,9799890242,639,5125,23,3703888838,In > Out
Apr 2020,160,60,1833,1857368968,6148462072,8005831040,349,1745,6,4291093104,In > Out
Apr 2020,160,61,3076,459666364,8398592617,8858258981,324,2826,6,7938926253,In > Out
Apr 2020,160,62,5703,1311990549,11213785322,12525775871,449,5019,9,9901794773,In > Out
Apr 2020,160,63,5432,49532600613,122202195763,171734796376,742,4884,21,72669595150,In > Out
Apr 2020,160,65,19492,14647836350,114530404106,129178240456,1262,11585,11,99882567756,In > Out
Apr 2020,160,66,21402,6901432020,66321732796,73223164816,1442,12240,30,59420300776,In > Out
Apr 2020,160,67,20633,6046071758,69444372293,75490444051,1277,12496,18,63398300535,In > Out
Apr 2020,160,68,22935,7206417524,53073399638,60279817162,1567,14000,44,45866982114,In > Out
Apr 2020,160,69,26062,17639063521,80627197670,98266261191,1125,14539,23,62988134149,In > Out
Apr 2020,160,70,23610,51913212086,75880441126,127793653212,1752,13639,16,23967229040,In > Out
Apr 2020,160,71,17563,2397414538,62068572076,64465986614,1228,10705,13,59671157538,In > Out
Apr 2020,160,72,35472,11762899699,77845232290,89608131989,1747,17069,115,66082332591,In > Out
Apr 2020,160,73,14075,1505581124,59051908966,60557490090,315,9556,2,57546327842,In > Out
Apr 2020,160,74,7803,628426258,36210601326,36839027584,242,6034,2,35582175068,In > Out
Apr 2020,160,75,8765,593476573,35698840528,36292317101,416,6537,2,35105363955,In > Out
Apr 2020,160,76,7388,729944537,38567608398,39297552935,241,5662,2,37837663861,In > Out
Apr 2020,160,77,7949,876154401,43292271454,44168425855,412,6255,3,42416117053,In > Out
Apr 2020,160,78,35298,2228859106,62462064740,64690923846,233,16018,2,60233205634,In > Out
Apr 2020,160,79,10503,1096746317,66094241147,67190987464,284,5304,2,64997494830,In > Out
Apr 2020,160,80,13572,1222926310,81254229211,82477155521,335,7532,2,80031302901,In > Out
Apr 2020,160,82,712,105068739,1310596375,1415665114,167,687,2,1205527636,In > Out
Apr 2020,160,84,62,3600089,146058359,149658448,23,62,2,142458270,In > Out
Apr 2020,160,86,230,19282132,662017344,681299476,49,227,2,642735212,In > Out
Apr 2020,160,88,66,5941718,586771049,592712767,22,66,2,580829331,In > Out
Apr 2020,160,9,154,6707665,35439074,42146739,12,154,1,28731409,In > Out
Apr 2020,161,10,171,31770081,695594988,727365069,43,170,4,663824907,In > Out
Apr 2020,161,100,213,13113901,1363557388,1376671289,115,209,2,1350443487,In > Out
Apr 2020,161,102,320,74528253,597926309,672454562,94,320,8,523398056,In > Out
Apr 2020,161,103,188,26447238,294303098,320750336,85,188,2,267855860,In > Out
Apr 2020,161,105,1903,265481115,9712069277,9977550392,264,1849,6,9446588162,In > Out
Apr 2020,161,107,530,243766788,4412728946,4656495734,118,528,24,4168962158,In > Out
Apr 2020,161,109,48,8952225,71720121,80672346,31,48,4,62767896,In > Out
Apr 2020,161,11,476,71330364,3075689524,3147019888,141,469,4,3004359160,In > Out
Apr 2020,161,110,506,53376814,8502597020,8555973834,196,505,3,8449220206,In > Out
Apr 2020,161,111,18,1039060,10214303,11253363,10,18,2,9175243,In > Out
Apr 2020,161,112,74,39479081,192634977,232114058,34,74,2,153155896,In > Out
Apr 2020,161,113,361,38357798,3066270890,3104628688,185,361,3,3027913092,In > Out
Apr 2020,161,115,12,1142944,92582349,93725293,10,12,2,91439405,In > Out
Apr 2020,161,116,111,10191233,595263666,605454899,46,111,1,585072433,In > Out
Apr 2020,161,117,84,5130821,114705729,119836550,50,84,2,109574908,In > Out
Apr 2020,161,118,73,5483078,184390571,189873649,33,73,3,178907493,In > Out
Apr 2020,161,119,1964,290053315,8608842580,8898895895,418,1776,6,8318789265,In > Out
Apr 2020,161,121,186,23789454,586114943,609904397,84,185,5,562325489,In > Out
Apr 2020,161,124,397,33860833,2918425404,2952286237,136,392,5,2884564571,In > Out
Apr 2020,161,127,37,2176628,48111372,50288000,22,37,2,45934744,In > Out
Apr 2020,161,129,174,7419703,299515029,306934732,51,174,2,292095326,In > Out
Apr 2020,161,13,27,4794497,105479718,110274215,19,27,1,100685221,In > Out
Apr 2020,161,130,593,95668338,2165769080,2261437418,105,587,3,2070100742,In > Out
Apr 2020,161,132,9,523306,14232053,14755359,3,9,1,13708747,In > Out
Apr 2020,161,133,817,351848332,7766123694,8117972026,216,805,12,7414275362,In > Out
Apr 2020,161,135,800,130147516,2792576314,2922723830,213,782,27,2662428798,In > Out
Apr 2020,161,138,49,14681133,272790148,287471281,36,48,3,258109015,In > Out
Apr 2020,161,139,242,122754806,1626023336,1748778142,84,241,6,1503268530,In > Out
Apr 2020,161,14,41,1176941,19626937,20803878,20,41,2,18449996,In > Out
Apr 2020,161,141,1,14825,530509,545334,1,1,1,515684,In > Out
Apr 2020,161,142,122,6683757791,63386490,6747144281,48,122,2,6620371301,Out > In
Apr 2020,161,144,723,338795115,5045029135,5383824250,189,714,12,4706234020,In > Out
Apr 2020,161,145,178,11342839,686141176,697484015,79,178,4,674798337,In > Out
Apr 2020,161,147,472,252281752,3613391904,3865673656,110,467,4,3361110152,In > Out
Apr 2020,161,148,2722,207696884,9548705944,9756402828,172,2582,20,9341009060,In > Out
Apr 2020,161,151,783,31574205,960736222,992310427,133,776,5,929162017,In > Out
Apr 2020,161,152,307,215859594,506495330,722354924,111,307,7,290635736,In > Out
Apr 2020,161,153,866,1337159299,3206851377,4544010676,298,864,5,1869692078,In > Out
Apr 2020,161,157,210,10759145,138748491,149507636,28,210,2,127989346,In > Out
Apr 2020,161,159,955,51451318,2743866636,2795317954,122,955,2,2692415318,In > Out
Apr 2020,161,16,1245,1692020601,67538524382,69230544983,199,1226,11,65846503781,In > Out
Apr 2020,161,160,3995,148794410,4699780174,4848574584,324,3510,3,4550985764,In > Out
Apr 2020,161,161,240,46898307,2305010990,2351909297,129,240,3,2258112683,In > Out
Apr 2020,161,162,167,7359257,269218722,276577979,39,167,3,261859465,In > Out
Apr 2020,161,165,535,341772305,7100310431,7442082736,179,532,8,6758538126,In > Out
Apr 2020,161,166,1175,41596569,1806346847,1847943416,169,1172,4,1764750278,In > Out
Apr 2020,161,167,1586,3199572097,7596983606,10796555703,368,1530,7,4397411509,In > Out
Apr 2020,161,168,206,206802000,1761151099,1967953099,94,206,8,1554349099,In > Out
Apr 2020,161,169,257,115964120,1312090091,1428054211,102,257,8,1196125971,In > Out
Apr 2020,161,17,96,233171326,512993206,746164532,44,95,6,279821880,In > Out
Apr 2020,161,171,192,33911763,755140883,789052646,93,192,3,721229120,In > Out
Apr 2020,161,173,11,191218,2602529,2793747,6,11,1,2411311,In > Out
Apr 2020,161,174,1628,1487250376,18882796739,20370047115,521,1529,159,17395546363,In > Out
Apr 2020,161,176,313,65858661,808244238,874102899,79,311,4,742385577,In > Out
Apr 2020,161,177,26,1986337,24604351,26590688,20,26,4,22618014,In > Out
Apr 2020,161,18,250,53657135,3601345627,3655002762,113,250,6,3547688492,In > Out
Apr 2020,161,180,1521,575213633,17520772616,18095986249,198,1465,10,16945558983,In > Out
Apr 2020,161,182,185,998934120,1908929463,2907863583,88,185,4,909995343,In > Out
Apr 2020,161,183,716,62056575,2154395021,2216451596,226,707,5,2092338446,In > Out
Apr 2020,161,184,90,31956988,569895494,601852482,26,90,8,537938506,In > Out
Apr 2020,161,186,1291,1695317614,7861847946,9557165560,235,1254,17,6166530332,In > Out
Apr 2020,161,187,4102,951906231,61579452146,62531358377,283,3760,6,60627545915,In > Out
Apr 2020,161,188,68,7652010,239870916,247522926,20,68,1,232218906,In > Out
Apr 2020,161,189,790,26861700,1261555979,1288417679,513,502,458,1234694279,In > Out
Apr 2020,161,190,202,54270256,2898386798,2952657054,97,202,3,2844116542,In > Out
Apr 2020,161,192,169,31173199,1588601807,1619775006,81,167,2,1557428608,In > Out
Apr 2020,161,193,46,2921977,85278000,88199977,15,46,2,82356023,In > Out
Apr 2020,161,194,173,10757255,293571607,304328862,47,173,2,282814352,In > Out
Apr 2020,161,195,1004,249840155,17748998680,17998838835,278,986,11,17499158525,In > Out
Apr 2020,161,196,75,9410830,109469329,118880159,44,75,2,100058499,In > Out
Apr 2020,161,197,96,13525121,127090156,140615277,63,96,2,113565035,In > Out
Apr 2020,161,198,29,14143445,58014053,72157498,20,29,3,43870608,In > Out
Apr 2020,161,20,226,83832403,2651751529,2735583932,88,226,5,2567919126,In > Out
Apr 2020,161,200,80,25262543,1723888616,1749151159,50,80,5,1698626073,In > Out
Apr 2020,161,201,703,2541646886,4696037671,7237684557,260,696,9,2154390785,In > Out
Apr 2020,161,202,298,60235397,2110563808,2170799205,62,298,1,2050328411,In > Out
Apr 2020,161,203,540,118100063,6281298095,6399398158,209,537,2,6163198032,In > Out
Apr 2020,161,204,6,260833,8953089,9213922,5,6,2,8692256,In > Out
Apr 2020,161,206,134,64610976,1306633143,1371244119,47,133,3,1242022167,In > Out
Apr 2020,161,208,443,718696450,1581669432,2300365882,97,434,11,862972982,In > Out
Apr 2020,161,209,243,29225774,1163043456,1192269230,65,242,1,1133817682,In > Out
Apr 2020,161,21,49,6208105,1937339,8145444,3,49,1,4270766,Out > In
Apr 2020,161,210,63,8650962,362189506,370840468,33,63,1,353538544,In > Out
Apr 2020,161,211,842,31653447,9166415301,9198068748,49,842,1,9134761854,In > Out
Apr 2020,161,212,324,35083895,2114722820,2149806715,115,324,3,2079638925,In > Out
Apr 2020,161,215,79,14906516,1262555519,1277462035,41,79,1,1247649003,In > Out
Apr 2020,161,216,3,37957576,858729,38816305,3,3,1,37098847,Out > In
Apr 2020,161,217,93,9158834,253117617,262276451,41,92,2,243958783,In > Out
Apr 2020,161,220,1764,490225979,9111156461,9601382440,389,1727,7,8620930482,In > Out
Apr 2020,161,221,158,40274705,844581615,884856320,66,155,4,804306910,In > Out
Apr 2020,161,24,2040,485291732,25620712199,26106003931,366,1942,8,25135420467,In > Out
Apr 2020,161,25,2,21255,387082,408337,2,2,1,365827,In > Out
Apr 2020,161,26,70,7323843,126715755,134039598,27,70,3,119391912,In > Out
Apr 2020,161,27,44,1804613,45719044,47523657,29,44,2,43914431,In > Out
Apr 2020,161,28,119,14835732,195744556,210580288,39,119,2,180908824,In > Out
Apr 2020,161,30,583,159875848,834869391,994745239,166,575,10,674993543,In > Out
Apr 2020,161,31,1237,484656895,22832273973,23316930868,269,1234,9,22347617078,In > Out
Apr 2020,161,32,3,1224942,6292800,7517742,3,3,2,5067858,In > Out
Apr 2020,161,33,74,11140442,167534689,178675131,34,74,2,156394247,In > Out
Apr 2020,161,34,77,10107556,267141229,277248785,15,77,3,257033673,In > Out
Apr 2020,161,35,1817,84627750,4512104801,4596732551,174,1811,7,4427477051,In > Out
Apr 2020,161,36,1,6968,167002,173970,1,1,1,160034,In > Out
Apr 2020,161,37,3523,3979879305,16329964546,20309843851,438,3183,25,12350085241,In > Out
Apr 2020,161,38,199,13018836,232870847,245889683,109,197,4,219852011,In > Out
Apr 2020,161,39,1506,169415595,12963186004,13132601599,105,1493,5,12793770409,In > Out
Apr 2020,161,4,77,6798242,73822411,80620653,39,77,3,67024169,In > Out
Apr 2020,161,40,3438,525665862,6567534688,7093200550,516,3209,19,6041868826,In > Out
Apr 2020,161,42,20,1446576,14736871,16183447,14,20,2,13290295,In > Out
Apr 2020,161,43,177,29712815,406108917,435821732,84,177,5,376396102,In > Out
Apr 2020,161,44,2980,506486784,14497729254,15004216038,478,2772,7,13991242470,In > Out
Apr 2020,161,46,607,108816371,6702340807,6811157178,134,607,2,6593524436,In > Out
Apr 2020,161,47,171,141432688,180447703,321880391,103,171,2,39015015,In > Out
Apr 2020,161,49,558,51329259,2159699062,2211028321,206,549,6,2108369803,In > Out
Apr 2020,161,5,628,144906770,5011374144,5156280914,183,628,2,4866467374,In > Out
Apr 2020,161,50,208,19776351,727677134,747453485,107,203,3,707900783,In > Out
Apr 2020,161,51,780,24075204,1376620106,1400695310,87,780,1,1352544902,In > Out
Apr 2020,161,52,158,22614035,94017637,116631672,65,158,2,71403602,In > Out
Apr 2020,161,53,42,52413036,73118583,125531619,30,42,8,20705547,In > Out
Apr 2020,161,54,63,31068702,51867809,82936511,35,63,4,20799107,In > Out
Apr 2020,161,55,545,185767498,3007248581,3193016079,33,544,4,2821481083,In > Out
Apr 2020,161,56,1609,192017333,5530509623,5722526956,669,1322,359,5338492290,In > Out
Apr 2020,161,57,73,26221760,108028294,134250054,33,73,4,81806534,In > Out
Apr 2020,161,6,121,39891803,632017764,671909567,24,121,2,592125961,In > Out
Apr 2020,161,60,125,8388100,120875801,129263901,52,125,1,112487701,In > Out
Apr 2020,161,62,1798,82055963,2433971829,2516027792,179,1792,2,2351915866,In > Out
Apr 2020,161,63,65,15591400,236846362,252437762,44,65,13,221254962,In > Out
Apr 2020,161,64,224,73792588,2533818883,2607611471,106,224,2,2460026295,In > Out
Apr 2020,161,65,159,265627261,113046381,378673642,43,159,1,152580880,Out > In
Apr 2020,161,66,173,49010113,2154180232,2203190345,75,172,7,2105170119,In > Out
Apr 2020,161,67,197,89617104,639597653,729214757,42,197,3,549980549,In > Out
Apr 2020,161,68,451,74763662,3527385570,3602149232,95,448,3,3452621908,In > Out
Apr 2020,161,69,926,122906310,2292552090,2415458400,189,917,8,2169645780,In > Out
Apr 2020,161,7,276,26240303,1073403958,1099644261,89,276,4,1047163655,In > Out
Apr 2020,161,70,265,47579143,815170339,862749482,45,264,3,767591196,In > Out
Apr 2020,161,72,724,140771756,1635227743,1775999499,253,724,3,1494455987,In > Out
Apr 2020,161,74,1,17573,828645,846218,1,1,1,811072,In > Out
Apr 2020,161,75,3,1023213,454787,1478000,3,3,1,568426,Out > In
Apr 2020,161,76,57,6165020,787161288,793326308,39,57,4,780996268,In > Out
Apr 2020,161,77,155,5221571,126382513,131604084,26,155,4,121160942,In > Out
Apr 2020,161,78,99,4641222,215000000,219641222,47,99,2,210358778,In > Out
Apr 2020,161,8,30,1625386,28228241,29853627,9,30,2,26602855,In > Out
Apr 2020,161,80,276,24389060,674024370,698413430,118,273,1,649635310,In > Out
Apr 2020,161,82,98,28150616,3676266175,3704416791,42,98,2,3648115559,In > Out
Apr 2020,161,83,24,10133634,9469920,19603554,16,24,3,663714,Out > In
Apr 2020,161,84,14,507810,41873275,42381085,11,14,2,41365465,In > Out
Apr 2020,161,86,129,27232894,1337120462,1364353356,73,129,3,1309887568,In > Out
Apr 2020,161,87,289,106517270,4227236599,4333753869,132,289,2,4120719329,In > Out
Apr 2020,161,88,711,47385928,1843755242,1891141170,116,707,6,1796369314,In > Out
Apr 2020,161,90,448,62631818,3059823744,3122455562,167,448,5,2997191926,In > Out
Apr 2020,161,91,329,59191138,731538788,790729926,96,319,3,672347650,In > Out
Apr 2020,161,94,4,693503,660370,1353873,4,4,2,33133,Out > In
Apr 2020,161,95,1135,4767301444,2781212695,7548514139,464,1110,3,1986088749,Out > In
Apr 2020,161,96,955,542417579,26157901180,26700318759,339,939,5,25615483601,In > Out
Apr 2020,161,97,106,5382866,600557858,605940724,17,106,2,595174992,In > Out
Apr 2020,161,99,144,8871566,352012854,360884420,56,144,2,343141288,In > Out
Apr 2020,163,4,1,25259,441962,467221,1,1,1,416703,In > Out
Apr 2020,164,120,135,5060641,289578219,294638860,15,135,2,284517578,In > Out
Apr 2020,164,124,128,11387254,98014777,109402031,73,128,2,86627523,In > Out
Apr 2020,164,127,173,8397518,441491249,449888767,34,173,2,433093731,In > Out
Apr 2020,164,141,103,2830872,22950926,25781798,28,103,2,20120054,In > Out
Apr 2020,164,144,15,10918607,963442,11882049,2,15,2,9955165,Out > In
Apr 2020,164,147,22,451546,13491899,13943445,12,22,2,13040353,In > Out
Apr 2020,164,158,1153,89796358,1997048848,2086845206,226,1116,2,1907252490,In > Out
Apr 2020,164,165,157,6121325,359216434,365337759,19,157,2,353095109,In > Out
Apr 2020,164,196,70,2062710,45821827,47884537,14,70,2,43759117,In > Out
Apr 2020,164,60,582,8990793,1383861079,1392851872,20,582,2,1374870286,In > Out
Apr 2020,164,69,31,3624786,61506001,65130787,22,31,2,57881215,In > Out
Apr 2020,164,77,14,440260,14521744,14962004,6,14,2,14081484,In > Out
Apr 2020,164,81,3,451308,251452,702760,3,1,1,199856,Out > In
Apr 2020,164,82,48,4719493,276108196,280827689,4,45,3,271388703,In > Out
Apr 2020,164,83,16,11320617,6088126,17408743,12,9,3,5232491,Out > In
Apr 2020,165,105,143,17648639,1075574798,1093223437,56,143,2,1057926159,In > Out
Apr 2020,165,127,10,7634624,423080540,430715164,8,10,2,415445916,In > Out
Apr 2020,165,131,161,30559660,2690668588,2721228248,26,161,2,2660108928,In > Out
Apr 2020,165,152,5,277075,7584620,7861695,4,5,2,7307545,In > Out
Apr 2020,165,153,838,160977095,91275399,252252494,46,838,5,69701696,Out > In
Apr 2020,165,158,812,384801845,17468015703,17852817548,75,803,4,17083213858,In > Out
Apr 2020,165,165,7539,1098038797,15339160728,16437199525,1096,6026,3,14241121931,In > Out
Apr 2020,165,176,61,5456087,287867365,293323452,26,47,3,282411278,In > Out
Apr 2020,165,187,276,19473327,516704011,536177338,78,271,2,497230684,In > Out
Apr 2020,165,198,786,106285697,443330188,549615885,90,769,2,337044491,In > Out
Apr 2020,165,199,1027,222705115,3365425884,3588130999,138,1008,4,3142720769,In > Out
Apr 2020,165,202,13,490593,3209296,3699889,5,13,2,2718703,In > Out
Apr 2020,165,233,2302,2052011917,594621414,2646633331,73,137,68,1457390503,Out > In
Apr 2020,165,43,995,107727251,4879078880,4986806131,130,963,4,4771351629,In > Out
Apr 2020,165,61,695,265359101,1018152116,1283511217,160,682,4,752793015,In > Out
Apr 2020,165,67,347,16444014,715934805,732378819,93,344,2,699490791,In > Out
Apr 2020,165,70,1476,778572919,1470788498,2249361417,109,1434,7,692215579,In > Out
Apr 2020,165,94,8,301952,12143266,12445218,5,8,2,11841314,In > Out
Apr 2020,166,12,50,1862367,94187212,96049579,19,50,2,92324845,In > Out
Apr 2020,166,133,73,1577272,216566388,218143660,21,73,2,214989116,In > Out
Apr 2020,166,135,42,3043740,93375474,96419214,18,42,2,90331734,In > Out
Apr 2020,166,138,1156,144574733,1915290279,2059865012,146,1156,4,1770715546,In > Out
Apr 2020,166,144,95,4793705,276015964,280809669,21,93,2,271222259,In > Out
Apr 2020,166,15,286,16793818,848938096,865731914,27,280,2,832144278,In > Out
Apr 2020,166,163,141,13142148,378551714,391693862,28,141,2,365409566,In > Out
Apr 2020,166,165,154,4617770,263050312,267668082,13,154,2,258432542,In > Out
Apr 2020,166,174,151,16349195,336734962,353084157,24,151,2,320385767,In > Out
Apr 2020,166,192,81,32365529,72139321,104504850,33,80,2,39773792,In > Out
Apr 2020,166,193,55,408860,98293089,98701949,21,55,2,97884229,In > Out
Apr 2020,166,198,82,13768583,165355638,179124221,45,82,2,151587055,In > Out
Apr 2020,166,34,1235,427221171,2760743170,3187964341,413,1202,3,2333521999,In > Out
Apr 2020,167,121,219,8889331,533361169,542250500,26,219,2,524471838,In > Out
Apr 2020,167,139,704,162954042,1919216291,2082170333,216,686,2,1756262249,In > Out
Apr 2020,167,143,1036,75156339,1860039061,1935195400,210,1011,2,1784882722,In > Out
Apr 2020,167,146,413,37555958,528293702,565849660,92,408,2,490737744,In > Out
Apr 2020,167,148,303,27058733,487778721,514837454,119,302,2,460719988,In > Out
Apr 2020,167,156,11,3780409,277251124,281031533,10,11,2,273470715,In > Out
Apr 2020,167,160,135,282825370,61730203,344555573,70,133,2,221095167,Out > In
Apr 2020,167,177,5,410291,31933478,32343769,4,5,1,31523187,In > Out
Apr 2020,167,186,8,956249,8565776,9522025,6,8,2,7609527,In > Out
Apr 2020,167,232,1814,121421487,2493535266,2614956753,222,1720,2,2372113779,In > Out
Apr 2020,167,35,74,6492410,330158110,336650520,21,74,2,323665700,In > Out
Apr 2020,167,37,85,8113394,417929440,426042834,19,85,2,409816046,In > Out
Apr 2020,167,40,249,31663222,393829845,425493067,111,247,3,362166623,In > Out
Apr 2020,168,112,139,14368017,22340390,36708407,3,138,2,7972373,In > Out
Apr 2020,168,114,167,8515252,493647471,502162723,21,167,2,485132219,In > Out
Apr 2020,168,116,178,47333048,2072322823,2119655871,52,178,2,2024989775,In > Out
Apr 2020,168,136,1583,357528938,2138672986,2496201924,107,1573,2,1781144048,In > Out
Apr 2020,168,138,1032,126436716,869277533,995714249,177,1009,3,742840817,In > Out
Apr 2020,168,153,21,1382269,65222567,66604836,6,21,2,63840298,In > Out
Apr 2020,168,154,53,2557798,138770010,141327808,19,53,2,136212212,In > Out
Apr 2020,168,155,1635,9262276284,893652138,10155928422,557,644,773,8368624146,Out > In
Apr 2020,168,164,141,35564038,1917236777,1952800815,62,137,2,1881672739,In > Out
Apr 2020,168,173,9,3580656,212554166,216134822,4,9,1,208973510,In > Out
Apr 2020,168,176,15,5206605,60635732,65842337,9,15,2,55429127,In > Out
Apr 2020,168,186,1,486574,4204,490778,1,1,1,482370,Out > In
Apr 2020,168,187,45,2448215,9377621,11825836,16,45,2,6929406,In > Out
Apr 2020,168,195,29,2597022,115259876,117856898,14,29,2,112662854,In > Out
Apr 2020,168,20,29,2989352,42528120,45517472,9,29,2,39538768,In > Out
Apr 2020,168,201,119,171632563,227884235,399516798,12,119,2,56251672,In > Out
Apr 2020,168,209,739,81222881,219793722,301016603,44,739,2,138570841,In > Out
Apr 2020,168,21,175,18722801,461677005,480399806,104,175,3,442954204,In > Out
Apr 2020,168,218,64,18136386,205425004,223561390,21,64,2,187288618,In > Out
Apr 2020,168,222,13,120936,10260651,10381587,10,13,2,10139715,In > Out
Apr 2020,168,23,3,902469,23858778,24761247,3,3,2,22956309,In > Out
Apr 2020,168,26,45,3113884,44158181,47272065,23,43,2,41044297,In > Out
Apr 2020,168,37,17,810384,69757514,70567898,8,17,2,68947130,In > Out
Apr 2020,168,42,48,1237833,29700160,30937993,31,47,2,28462327,In > Out
Apr 2020,168,44,66,2320280,110888503,113208783,10,66,2,108568223,In > Out
Apr 2020,168,53,98,969019,27386672,28355691,8,98,2,26417653,In > Out
Apr 2020,168,55,44,11967188,25177497,37144685,24,44,2,13210309,In > Out
Apr 2020,168,57,16,10949027,7517663,18466690,11,9,3,3431364,Out > In
Apr 2020,168,60,10,361616,20965297,21326913,3,10,1,20603681,In > Out
Apr 2020,168,8,211,13600355,612382043,625982398,21,211,2,598781688,In > Out
Apr 2020,168,80,60,11107378,621571081,632678459,19,60,2,610463703,In > Out
Apr 2020,168,85,70,4905178,357489214,362394392,25,70,2,352584036,In > Out
Apr 2020,168,86,65,1762392,79000915,80763307,23,65,2,77238523,In > Out
Apr 2020,169,156,59,1855938,61374002,63229940,11,59,3,59518064,In > Out
Apr 2020,169,157,268,7066437,216046544,223112981,36,264,2,208980107,In > Out
Apr 2020,169,163,73,3594696,205420325,209015021,23,73,2,201825629,In > Out
Apr 2020,169,164,322,36467167,802191123,838658290,80,318,2,765723956,In > Out
Apr 2020,169,177,341,28075507,1512270689,1540346196,30,341,2,1484195182,In > Out
Apr 2020,169,178,106,3933785,211047672,214981457,20,106,2,207113887,In > Out
Apr 2020,169,188,39,3861534,151148358,155009892,9,39,2,147286824,In > Out
Apr 2020,169,191,165,17744804,263061300,280806104,81,164,2,245316496,In > Out
Apr 2020,169,193,100,4864664,270971760,275836424,17,99,2,266107096,In > Out
Apr 2020,169,194,200,10384020,373535540,383919560,50,195,2,363151520,In > Out
Apr 2020,169,6,39995,190780165609,439471186588,630251352197,1983,19165,24,248691020979,In > Out
Apr 2020,169,8,133,8947756055,28074166136,37021922191,34,1,83,19126410081,In > Out
Apr 2020,170,129,41,4106872,2598988,6705860,3,1,1,1507884,Out > In
Apr 2020,170,13,876,41522612,2593698918,2635221530,79,876,3,2552176306,In > Out
Apr 2020,170,155,21,886453,147076527,147962980,4,21,2,146190074,In > Out
Apr 2020,170,157,203,6887131,748355961,755243092,30,203,2,741468830,In > Out
Apr 2020,170,159,17,471635,6274858,6746493,14,17,2,5803223,In > Out
Apr 2020,170,19,17,776923,2140677,2917600,4,17,1,1363754,In > Out
Apr 2020,170,192,46,4703992,223396215,228100207,18,46,2,218692223,In > Out
Apr 2020,170,194,219,38839514,2379482874,2418322388,56,217,2,2340643360,In > Out
Apr 2020,170,197,1,11707,274146,285853,1,1,1,262439,In > Out
Apr 2020,170,205,66,7251931,72014642,79266573,15,66,2,64762711,In > Out
Apr 2020,170,208,690,113305104,170574075,283879179,29,677,2,57268971,In > Out
Apr 2020,170,220,62,2914754,141893894,144808648,19,62,2,138979140,In > Out
Apr 2020,170,227,8,1482071,2109428,3591499,5,8,2,627357,In > Out
Apr 2020,170,234,2,1513356,137245,1650601,2,2,1,1376111,Out > In
Apr 2020,170,240,93,85625844,480071704,565697548,51,89,2,394445860,In > Out
Apr 2020,170,241,1010,1452400913,946445559,2398846472,102,999,4,505955354,Out > In
Apr 2020,170,242,47,438461,99768317,100206778,14,47,2,99329856,In > Out
Apr 2020,170,246,469,51088773,210108082,261196855,94,465,3,159019309,In > Out
Apr 2020,170,28,2,403618,7377472,7781090,2,2,2,6973854,In > Out
Apr 2020,170,29,90,12433995,154400558,166834553,38,90,2,141966563,In > Out
Apr 2020,170,30,185,10665901,560344943,571010844,21,185,2,549679042,In > Out
Apr 2020,170,34,6,800182,57340802,58140984,3,6,2,56540620,In > Out
Apr 2020,170,37,6,192971,29080399,29273370,4,6,1,28887428,In > Out
Apr 2020,170,42,209,6817370,392274563,399091933,15,202,1,385457193,In > Out
Apr 2020,170,45,243,223095430,240464439,463559869,76,132,8,17369009,In > Out
Apr 2020,170,49,4,505017,4264535,4769552,2,4,2,3759518,In > Out
Apr 2020,170,59,1372,34841499,248270822,283112321,2,1343,1,213429323,In > Out
Apr 2020,170,68,81,4374328,200189993,204564321,21,81,2,195815665,In > Out
Apr 2020,171,10,195,326738025,411097622,737835647,48,192,4,84359597,In > Out
Apr 2020,171,100,101,6122891,130265823,136388714,52,101,3,124142932,In > Out
Apr 2020,171,101,167,40224007,529505157,569729164,51,167,4,489281150,In > Out
Apr 2020,171,102,515,190716774,2557969579,2748686353,133,502,12,2367252805,In > Out
Apr 2020,171,103,428,133043354,9391578606,9524621960,73,424,4,9258535252,In > Out
Apr 2020,171,104,191,102486123,874303248,976789371,33,189,5,771817125,In > Out
Apr 2020,171,105,745,98638185,2535352381,2633990566,243,732,6,2436714196,In > Out
Apr 2020,171,107,486,52423020,1491459631,1543882651,128,485,3,1439036611,In > Out
Apr 2020,171,108,133,84913805,7349279103,7434192908,63,133,1,7264365298,In > Out
Apr 2020,171,109,137,176892692,745734371,922627063,78,137,4,568841679,In > Out
Apr 2020,171,112,270,93982473,1451314417,1545296890,149,269,12,1357331944,In > Out
Apr 2020,171,114,336,75100492,5686389542,5761490034,76,336,4,5611289050,In > Out
Apr 2020,171,115,1,12497,95358,107855,1,1,1,82861,In > Out
Apr 2020,171,116,888,944635236,1462238533,2406873769,132,888,5,517603297,In > Out
Apr 2020,171,118,13,558982,24211700,24770682,9,13,1,23652718,In > Out
Apr 2020,171,119,113,6306601,155395492,161702093,37,113,2,149088891,In > Out
Apr 2020,171,120,68,2590060,169746557,172336617,29,68,3,167156497,In > Out
Apr 2020,171,122,166,7609560,229691871,237301431,89,165,2,222082311,In > Out
Apr 2020,171,123,189,24711313,431318069,456029382,83,189,3,406606756,In > Out
Apr 2020,171,125,196,26551189,2587751017,2614302206,36,193,3,2561199828,In > Out
Apr 2020,171,127,464,171107762,2083455390,2254563152,152,458,7,1912347628,In > Out
Apr 2020,171,128,293,26370593,1157424465,1183795058,132,288,3,1131053872,In > Out
Apr 2020,171,130,558,110684804,826810407,937495211,170,557,9,716125603,In > Out
Apr 2020,171,132,155,16152512,545486601,561639113,71,155,2,529334089,In > Out
Apr 2020,171,133,1591,81580757,3618567489,3700148246,157,1511,7,3536986732,In > Out
Apr 2020,171,134,510,259572827,3613743261,3873316088,180,506,12,3354170434,In > Out
Apr 2020,171,135,104,17108375,619112619,636220994,44,104,1,602004244,In > Out
Apr 2020,171,136,41,17371736,99372951,116744687,27,41,4,82001215,In > Out
Apr 2020,171,137,42,74984186,361570720,436554906,23,42,5,286586534,In > Out
Apr 2020,171,138,660,82339680,1847064045,1929403725,184,660,5,1764724365,In > Out
Apr 2020,171,139,25,24450700,185458635,209909335,20,25,14,161007935,In > Out
Apr 2020,171,141,327,270698374,484453184,755151558,77,300,54,213754810,In > Out
Apr 2020,171,142,114,56399753,627740967,684140720,55,114,15,571341214,In > Out
Apr 2020,171,143,962,245231105,9660430453,9905661558,247,938,16,9415199348,In > Out
Apr 2020,171,144,101,9270776,512412399,521683175,36,101,2,503141623,In > Out
Apr 2020,171,145,31,20241492,17075820,37317312,10,28,4,3165672,Out > In
Apr 2020,171,146,530,118499655,1896877646,2015377301,207,530,6,1778377991,In > Out
Apr 2020,171,147,159,91625043,4447631619,4539256662,84,159,3,4356006576,In > Out
Apr 2020,171,148,1962,96026133,6117305397,6213331530,43,1962,2,6021279264,In > Out
Apr 2020,171,149,1277,526206072,8000567196,8526773268,305,1235,11,7474361124,In > Out
Apr 2020,171,15,3486,1562992348,25721265650,27284257998,425,2701,5,24158273302,In > Out
Apr 2020,171,150,255,17374673,521984484,539359157,39,255,3,504609811,In > Out
Apr 2020,171,151,81,66480135,304337737,370817872,24,81,3,237857602,In > Out
Apr 2020,171,152,329,183139930,1010894889,1194034819,89,327,3,827754959,In > Out
Apr 2020,171,153,495,100019347,4015362838,4115382185,182,493,37,3915343491,In > Out
Apr 2020,171,154,109,66037172,431696567,497733739,60,109,2,365659395,In > Out
Apr 2020,171,156,190,284240326,2318490164,2602730490,24,190,2,2034249838,In > Out
Apr 2020,171,157,186,495906754,423859746,919766500,79,186,8,72047008,Out > In
Apr 2020,171,158,15,2332189,11357530,13689719,8,15,2,9025341,In > Out
Apr 2020,171,159,13,284215,5246335,5530550,12,13,1,4962120,In > Out
Apr 2020,171,16,690,432687882,2371300082,2803987964,241,683,28,1938612200,In > Out
Apr 2020,171,161,308,29314711,1006955324,1036270035,79,307,6,977640613,In > Out
Apr 2020,171,163,317,20393497,360083371,380476868,149,317,3,339689874,In > Out
Apr 2020,171,164,430,70259461,5752554232,5822813693,150,428,4,5682294771,In > Out
Apr 2020,171,165,164,222576978,516120584,738697562,70,164,5,293543606,In > Out
Apr 2020,171,166,3,42200,342103,384303,1,3,1,299903,In > Out
Apr 2020,171,167,1804,1024290350,4891714831,5916005181,452,1761,10,3867424481,In > Out
Apr 2020,171,168,3416,530009820,15598680806,16128690626,310,3271,9,15068670986,In > Out
Apr 2020,171,17,1458,1314879826,7149720383,8464600209,313,1407,9,5834840557,In > Out
Apr 2020,171,170,274,46364722,941857389,988222111,124,274,3,895492667,In > Out
Apr 2020,171,171,77,63489776,6304524882,6368014658,43,77,2,6241035106,In > Out
Apr 2020,171,172,126,83644510,395734104,479378614,77,126,3,312089594,In > Out
Apr 2020,171,173,454,105959677,3585127930,3691087607,176,447,6,3479168253,In > Out
Apr 2020,171,174,48,3962669,123994159,127956828,28,48,2,120031490,In > Out
Apr 2020,171,175,143,57981690,577373156,635354846,67,143,13,519391466,In > Out
Apr 2020,171,177,194,30809313,1904882763,1935692076,51,194,3,1874073450,In > Out
Apr 2020,171,179,109,40790169,605758533,646548702,50,105,18,564968364,In > Out
Apr 2020,171,181,1305,957042759,4060034108,5017076867,371,1195,8,3102991349,In > Out
Apr 2020,171,184,568,609933350,2873516438,3483449788,175,553,40,2263583088,In > Out
Apr 2020,171,185,324,280390017,362875383,643265400,105,324,28,82485366,In > Out
Apr 2020,171,186,1238,1437214049,10648288580,12085502629,214,1222,9,9211074531,In > Out
Apr 2020,171,187,347,328144626,1329085180,1657229806,97,345,5,1000940554,In > Out
Apr 2020,171,188,594,384129265,2052970982,2437100247,145,594,7,1668841717,In > Out
Apr 2020,171,19,1701,389809814,27499922507,27889732321,567,1666,5,27110112693,In > Out
Apr 2020,171,190,186,23446685,508973705,532420390,37,185,2,485527020,In > Out
Apr 2020,171,194,13,325409,8006687,8332096,9,13,1,7681278,In > Out
Apr 2020,171,196,2556,191586297,8375706839,8567293136,270,2436,21,8184120542,In > Out
Apr 2020,171,202,102,7135173,153998740,161133913,36,102,4,146863567,In > Out
Apr 2020,171,203,48,4196745,48092990,52289735,18,48,1,43896245,In > Out
Apr 2020,171,204,112,13678338,403971048,417649386,52,112,1,390292710,In > Out
Apr 2020,171,205,1830,220376221,7134756344,7355132565,282,1774,17,6914380123,In > Out
Apr 2020,171,206,1105,1653782407,3697043527,5350825934,273,1082,15,2043261120,In > Out
Apr 2020,171,207,17,162349,2489163,2651512,9,17,1,2326814,In > Out
Apr 2020,171,208,187,40704735,537931476,578636211,59,185,2,497226741,In > Out
Apr 2020,171,209,261,46112122,2562285165,2608397287,127,259,4,2516173043,In > Out
Apr 2020,171,210,254,19006459,549490729,568497188,33,253,2,530484270,In > Out
Apr 2020,171,211,283,36052284,1574568473,1610620757,110,273,4,1538516189,In > Out
Apr 2020,171,212,29,3141882,20709955,23851837,15,29,1,17568073,In > Out
Apr 2020,171,213,155,8482397,272577987,281060384,64,155,3,264095590,In > Out
Apr 2020,171,215,1072,66936387,1558148279,1625084666,174,1052,7,1491211892,In > Out
Apr 2020,171,22,115,238427448,1606448626,1844876074,33,115,3,1368021178,In > Out
Apr 2020,171,221,28,1424320,21934457,23358777,16,28,2,20510137,In > Out
Apr 2020,171,222,1002,363671321,21969380272,22333051593,258,988,14,21605708951,In > Out
Apr 2020,171,223,1,85496,57970,143466,1,1,1,27526,Out > In
Apr 2020,171,23,110,32098521,151452445,183550966,45,110,2,119353924,In > Out
Apr 2020,171,27,561,99828494,2700152071,2799980565,116,558,4,2600323577,In > Out
Apr 2020,171,30,192,47092592,1517652992,1564745584,99,192,3,1470560400,In > Out
Apr 2020,171,31,18,868300,11855906,12724206,11,18,2,10987606,In > Out
Apr 2020,171,33,28,3114032,20025301,23139333,18,28,2,16911269,In > Out
Apr 2020,171,35,80,9389065,258385843,267774908,35,80,4,248996778,In > Out
Apr 2020,171,36,537,85804294,5579962773,5665767067,143,536,2,5494158479,In > Out
Apr 2020,171,37,77,4901196,160152153,165053349,42,77,2,155250957,In > Out
Apr 2020,171,40,33,7951771,176513397,184465168,20,33,2,168561626,In > Out
Apr 2020,171,41,331,484229421,7611499448,8095728869,83,331,5,7127270027,In > Out
Apr 2020,171,42,477,201334361,1770702771,1972037132,172,473,10,1569368410,In > Out
Apr 2020,171,44,731,625643330,3944919923,4570563253,226,705,11,3319276593,In > Out
Apr 2020,171,45,81,4518575,212356307,216874882,38,81,2,207837732,In > Out
Apr 2020,171,46,34,2287980,30586005,32873985,8,34,2,28298025,In > Out
Apr 2020,171,47,141,375822432,1104042937,1479865369,79,140,5,728220505,In > Out
Apr 2020,171,48,434,92696029,4480029823,4572725852,178,434,5,4387333794,In > Out
Apr 2020,171,50,51,4141229,99206445,103347674,32,51,2,95065216,In > Out
Apr 2020,171,54,523,30256292,1142823409,1173079701,96,523,3,1112567117,In > Out
Apr 2020,171,57,905,52488859,689727948,742216807,220,861,4,637239089,In > Out
Apr 2020,171,58,2,29177,283587,312764,1,2,1,254410,In > Out
Apr 2020,171,59,10,3666728,11135130,14801858,4,10,1,7468402,In > Out
Apr 2020,171,6,230,129504340,928878679,1058383019,85,228,3,799374339,In > Out
Apr 2020,171,60,36,1525402,7505564,9030966,4,36,3,5980162,In > Out
Apr 2020,171,63,634,98082087,7705399224,7803481311,111,632,2,7607317137,In > Out
Apr 2020,171,64,1193,152156320,4566191836,4718348156,332,1171,5,4414035516,In > Out
Apr 2020,171,65,126,16271657,686960996,703232653,43,126,3,670689339,In > Out
Apr 2020,171,66,618,144735296,9476971167,9621706463,219,596,5,9332235871,In > Out
Apr 2020,171,67,127,22620206,348722605,371342811,51,127,2,326102399,In > Out
Apr 2020,171,71,65,5665765,122114482,127780247,30,65,3,116448717,In > Out
Apr 2020,171,72,73,194891133,492126815,687017948,41,72,4,297235682,In > Out
Apr 2020,171,74,125,76782099,659436051,736218150,60,125,3,582653952,In > Out
Apr 2020,171,75,58,12466084,226508392,238974476,32,58,4,214042308,In > Out
Apr 2020,171,76,38,1881692,13046652,14928344,17,38,3,11164960,In > Out
Apr 2020,171,77,508,86915844,1715660818,1802576662,88,508,4,1628744974,In > Out
Apr 2020,171,79,12,519134,11735040,12254174,9,12,2,11215906,In > Out
Apr 2020,171,81,3435,297964635,5520528916,5818493551,402,3184,53,5222564281,In > Out
Apr 2020,171,82,68,13709078,213121059,226830137,56,68,1,199411981,In > Out
Apr 2020,171,84,459,55637735,1408292239,1463929974,133,455,4,1352654504,In > Out
Apr 2020,171,85,48,10133656,40362288,50495944,37,48,2,30228632,In > Out
Apr 2020,171,86,600,90866030,726098342,816964372,186,596,6,635232312,In > Out
Apr 2020,171,87,435,363277826,8610400389,8973678215,158,435,3,8247122563,In > Out
Apr 2020,171,88,3,53142,933515,986657,3,3,1,880373,In > Out
Apr 2020,171,91,101,11779115,806047045,817826160,39,101,2,794267930,In > Out
Apr 2020,171,92,1317,93487989,3136193026,3229681015,732,972,546,3042705037,In > Out
Apr 2020,171,93,10,496459,1106234,1602693,9,10,1,609775,In > Out
Apr 2020,171,95,494,29907275,628997872,658905147,143,494,2,599090597,In > Out
Apr 2020,171,96,1147,118432872,8605434222,8723867094,248,1094,6,8487001350,In > Out
Apr 2020,171,98,15,800019,21151880,21951899,13,15,2,20351861,In > Out
Apr 2020,172,26,103,14531212,19564684,34095896,11,100,2,5033472,In > Out
Apr 2020,172,53,204,18428921,601554517,619983438,27,204,2,583125596,In > Out
Apr 2020,173,168,137,12518218,594766199,607284417,41,136,2,582247981,In > Out
Apr 2020,173,193,1345,308319815,4781533167,5089852982,84,1264,2,4473213352,In > Out
Apr 2020,174,109,488,110058035,785584272,895642307,118,483,2,675526237,In > Out
Apr 2020,174,118,49,6096548,231532435,237628983,23,47,2,225435887,In > Out
Apr 2020,174,167,159,30021075,280893433,310914508,18,59,3,250872358,In > Out
Apr 2020,175,192,227,68143580,293743125,361886705,34,224,5,225599545,In > Out
Apr 2020,175,246,114,11798985,213181700,224980685,45,114,2,201382715,In > Out
Apr 2020,175,32,11,221588,15640710,15862298,5,11,1,15419122,In > Out
Apr 2020,176,176,7,296988,27985730,28282718,2,7,1,27688742,In > Out
Apr 2020,176,177,17,921474,57996564,58918038,15,17,2,57075090,In > Out
Apr 2020,176,191,108,65288582,953763627,1019052209,59,108,2,888475045,In > Out
Apr 2020,177,174,52,757235,7769216,8526451,1,52,1,7011981,In > Out
Apr 2020,178,120,2,115034,425621,540655,2,2,1,310587,In > Out
Apr 2020,178,121,280,53200506,529334396,582534902,61,276,2,476133890,In > Out
Apr 2020,178,123,3507,1163679659,4687232627,5850912286,150,3148,2,3523552968,In > Out
Apr 2020,178,134,6,113275,1543692,1656967,6,6,2,1430417,In > Out
Apr 2020,178,151,17,3039445,18881501,21920946,12,17,2,15842056,In > Out
Apr 2020,178,219,5,4571337,334686881,339258218,4,5,2,330115544,In > Out
Apr 2020,178,29,489,29802444,1262882103,1292684547,46,489,2,1233079659,In > Out
Apr 2020,178,4,1102,468615898,4335536429,4804152327,284,1081,4,3866920531,In > Out
Apr 2020,178,51,76,21327981,954208229,975536210,33,75,2,932880248,In > Out
Apr 2020,178,55,40,7810832,367064750,374875582,22,40,2,359253918,In > Out
Apr 2020,178,56,206,13220654,638728845,651949499,61,206,2,625508191,In > Out
Apr 2020,178,75,129,7499869,434833070,442332939,35,129,2,427333201,In > Out
Apr 2020,178,76,143,3739156,132295429,136034585,31,117,2,128556273,In > Out
Apr 2020,178,78,795,128227719,2513696749,2641924468,304,782,3,2385469030,In > Out
Apr 2020,179,111,155,10840154,83390373,94230527,56,155,2,72550219,In > Out
Apr 2020,179,114,1990,337496450,1675974950,2013471400,117,1881,2,1338478500,In > Out
Apr 2020,179,157,76,45906757,1906693113,1952599870,15,76,2,1860786356,In > Out
Apr 2020,179,158,13,15969747,861156072,877125819,10,13,2,845186325,In > Out
Apr 2020,179,160,1009,11851896874,570827156,12422724030,508,6,783,11281069718,Out > In
Apr 2020,179,177,149,7844342,1380295148,1388139490,34,149,2,1372450806,In > Out
Apr 2020,179,180,11,620966,7798967,8419933,9,11,2,7178001,In > Out
Apr 2020,179,199,72,8484124,433122176,441606300,11,70,2,424638052,In > Out
Apr 2020,179,211,875,177462615,1081935044,1259397659,142,843,2,904472429,In > Out
Apr 2020,179,212,3,108508,3833497,3942005,1,3,1,3724989,In > Out
Apr 2020,179,52,321,456823995,22575979276,23032803271,88,318,2,22119155281,In > Out
Apr 2020,179,73,54,3864178,223639013,227503191,18,54,2,219774835,In > Out
Apr 2020,179,87,148,10594558,325506940,336101498,33,147,1,314912382,In > Out
Apr 2020,180,113,54,2571944,102795178,105367122,22,53,2,100223234,In > Out
Apr 2020,180,119,18,1638002,82068042,83706044,12,18,2,80430040,In > Out
Apr 2020,180,140,270,31673919,1054654163,1086328082,111,269,3,1022980244,In > Out
Apr 2020,180,159,1344,292869449,2120252156,2413121605,246,1286,2,1827382707,In > Out
Apr 2020,180,161,17,1243445,53640492,54883937,12,17,2,52397047,In > Out
Apr 2020,180,165,92,6187522,345728078,351915600,20,92,2,339540556,In > Out
Apr 2020,180,169,94,12601100,661343854,673944954,23,94,2,648742754,In > Out
Apr 2020,180,175,93,4859039,256475146,261334185,21,93,2,251616107,In > Out
Apr 2020,180,187,86,674665,166282440,166957105,20,86,2,165607775,In > Out
Apr 2020,180,188,106,5174608,257221030,262395638,21,106,2,252046422,In > Out
Apr 2020,180,189,1046,645415409,542974895,1188390304,121,1007,2,102440514,Out > In
Apr 2020,180,204,34,7170919,80729952,87900871,17,34,2,73559033,In > Out
Apr 2020,180,217,25,1400196,33394636,34794832,15,25,2,31994440,In > Out
Apr 2020,180,32,572,196249992,901112802,1097362794,122,561,3,704862810,In > Out
Apr 2020,180,44,106,5616370,298024775,303641145,18,106,2,292408405,In > Out
Apr 2020,180,54,293,14991175,1647482094,1662473269,56,291,2,1632490919,In > Out
Apr 2020,180,62,224,11131959,647293979,658425938,23,224,2,636162020,In > Out
Apr 2020,180,72,31,4307609,177169783,181477392,22,31,2,172862174,In > Out
Apr 2020,180,82,169,7795131,428355364,436150495,20,169,2,420560233,In > Out
Apr 2020,180,84,64,518183,147599229,148117412,17,64,2,147081046,In > Out
Apr 2020,180,85,94,3915379,211105665,215021044,18,94,2,207190286,In > Out
Apr 2020,180,96,318,31346977,450940278,482287255,151,317,2,419593301,In > Out
Apr 2020,181,109,32,5221894,305661477,310883371,18,32,2,300439583,In > Out
Apr 2020,181,111,60,64555908,2993556454,3058112362,23,60,2,2929000546,In > Out
Apr 2020,181,117,2,198704,8568,207272,1,2,1,190136,Out > In
Apr 2020,181,124,33,1136828,28329176,29466004,18,33,2,27192348,In > Out
Apr 2020,181,127,855,466146434,469006827,935153261,115,834,5,2860393,In > Out
Apr 2020,181,13,964,110529717,342202533,452732250,105,948,2,231672816,In > Out
Apr 2020,181,130,285,20306732,256744712,277051444,94,282,2,236437980,In > Out
Apr 2020,181,145,253,12524025,661397189,673921214,27,252,2,648873164,In > Out
Apr 2020,181,148,85,8629894,248477206,257107100,35,85,2,239847312,In > Out
Apr 2020,181,150,45,1365664,40530792,41896456,15,45,2,39165128,In > Out
Apr 2020,181,155,66,3090272,142034473,145124745,20,66,2,138944201,In > Out
Apr 2020,181,156,4,45726,4063512,4109238,3,3,1,4017786,In > Out
Apr 2020,181,159,55,5779123,48459508,54238631,28,55,1,42680385,In > Out
Apr 2020,181,160,1666,279808230,6102538464,6382346694,88,1624,1,5822730234,In > Out
Apr 2020,181,168,14,4928348,3850567,8778915,10,6,8,1077781,Out > In
Apr 2020,181,175,2,58805,509008,567813,1,2,1,450203,In > Out
Apr 2020,181,193,21,2329110,34765030,37094140,13,21,2,32435920,In > Out
Apr 2020,181,194,1406,31310782,1422888895,1454199677,51,1339,2,1391578113,In > Out
Apr 2020,181,198,566,28635162,1439811200,1468446362,19,566,2,1411176038,In > Out
Apr 2020,181,200,181,17350027,172997561,190347588,71,180,2,155647534,In > Out
Apr 2020,181,202,35,43532822,39241018,82773840,13,35,2,4291804,Out > In
Apr 2020,181,204,19,7187415,1854158393,1861345808,7,19,2,1846970978,In > Out
Apr 2020,181,210,292,14535453,1602746730,1617282183,71,292,2,1588211277,In > Out
Apr 2020,181,212,16,848163,2040776,2888939,13,11,2,1192613,In > Out
Apr 2020,181,226,1824,11121293682,23543593580,34664887262,117,1765,2,12422299898,In > Out
Apr 2020,181,230,2,33852,9623621,9657473,2,2,1,9589769,In > Out
Apr 2020,181,241,94,7514868,914619770,922134638,40,94,2,907104902,In > Out
Apr 2020,181,244,3,302622,148109,450731,3,2,2,154513,Out > In
Apr 2020,181,248,466,968691370,1899410561,2868101931,130,457,27,930719191,In > Out
Apr 2020,181,250,1,70648,21638299,21708947,1,1,1,21567651,In > Out
Apr 2020,181,251,1439,15322513,502645629,517968142,12,1439,2,487323116,In > Out
Apr 2020,181,36,15,1242105,8295878,9537983,5,15,2,7053773,In > Out
Apr 2020,181,37,15,66595,2319555,2386150,11,15,2,2252960,In > Out
Apr 2020,181,38,9,48795,1427638,1476433,5,9,1,1378843,In > Out
Apr 2020,181,4,8,667644,7645667,8313311,4,8,1,6978023,In > Out
Apr 2020,181,49,1,236868,18215769,18452637,1,1,1,17978901,In > Out
Apr 2020,181,5,16,71006,2328383,2399389,7,16,2,2257377,In > Out
Apr 2020,181,53,108,459935,31105616,31565551,4,108,2,30645681,In > Out
Apr 2020,181,54,4,177016,6291163,6468179,1,4,1,6114147,In > Out
Apr 2020,181,59,77,531107755,496316639,1027424394,36,77,2,34791116,Out > In
Apr 2020,181,6,17,74005,2646105,2720110,12,17,2,2572100,In > Out
Apr 2020,181,61,463,35935700,1501514624,1537450324,75,463,2,1465578924,In > Out
Apr 2020,181,63,6,1470942,97381887,98852829,3,6,2,95910945,In > Out
Apr 2020,181,64,18,675222,3912625,4587847,13,16,4,3237403,In > Out
Apr 2020,181,65,169,7895330,437136861,445032191,22,169,2,429241531,In > Out
Apr 2020,181,73,91,3487004,42655046,46142050,26,91,2,39168042,In > Out
Apr 2020,181,74,197,6028694,794104796,800133490,19,197,2,788076102,In > Out
Apr 2020,181,75,11,2102732,12303960,14406692,10,11,2,10201228,In > Out
Apr 2020,181,78,2,13409,1917359,1930768,2,2,2,1903950,In > Out
Apr 2020,181,8,202,15738346,490588237,506326583,34,202,2,474849891,In > Out
Apr 2020,181,81,173,13981352,426258336,440239688,23,173,2,412276984,In > Out
Apr 2020,181,82,247,30989223,787720309,818709532,23,247,2,756731086,In > Out
Apr 2020,181,84,6,360701,871243,1231944,5,6,2,510542,In > Out
Apr 2020,181,9,4674,2268333957,11568862961,13837196918,380,4320,5,9300529004,In > Out
Apr 2020,181,92,46,6456530,191135345,197591875,21,46,2,184678815,In > Out
Apr 2020,181,98,141,5525989,2044043694,2049569683,25,141,2,2038517705,In > Out
Apr 2020,183,119,6,197358,18730053,18927411,6,6,1,18532695,In > Out
Apr 2020,183,19,42,2181310,46389785,48571095,31,42,3,44208475,In > Out
Apr 2020,183,89,3,1578448,3048880,4627328,1,1,1,1470432,In > Out
Apr 2020,183,94,798,210654680,2491268419,2701923099,125,774,4,2280613739,In > Out
Apr 2020,184,134,9261,914558168,36215873165,37130431333,942,7481,10,35301314997,In > Out
Apr 2020,184,136,2558,403975124,9142427984,9546403108,296,2365,5,8738452860,In > Out
Apr 2020,184,181,147,14890446,269180281,284070727,22,147,4,254289835,In > Out
Apr 2020,184,203,442,20745759,698877599,719623358,78,440,2,678131840,In > Out
Apr 2020,184,216,121,2811200,10274863,13086063,2,112,3,7463663,In > Out
Apr 2020,184,218,18,3839180,65021611,68860791,12,18,2,61182431,In > Out
Apr 2020,184,219,3523,147358869,8769255613,8916614482,372,3129,100,8621896744,In > Out
Apr 2020,184,220,10651,1875161268,48980690784,50855852052,1941,8916,19,47105529516,In > Out
Apr 2020,184,246,2547,416495704,15229859542,15646355246,266,2407,5,14813363838,In > Out
Apr 2020,19,122,63,132417,10816219,10948636,1,63,1,10683802,In > Out
Apr 2020,19,143,3,34151,1494047,1528198,1,1,3,1459896,In > Out
Apr 2020,190,100,8,533940,57733150,58267090,4,8,1,57199210,In > Out
Apr 2020,190,101,5,759248,84413787,85173035,2,5,1,83654539,In > Out
Apr 2020,190,110,5,32499,2158872,2191371,3,5,1,2126373,In > Out
Apr 2020,190,119,367,9323714,889203986,898527700,12,363,2,879880272,In > Out
Apr 2020,190,120,18,440888,26174376,26615264,9,18,2,25733488,In > Out
Apr 2020,190,123,13,492373,35472527,35964900,4,13,1,34980154,In > Out
Apr 2020,190,125,17,1280329,62664206,63944535,7,17,1,61383877,In > Out
Apr 2020,190,135,4,334287,70589445,70923732,3,4,1,70255158,In > Out
Apr 2020,190,140,6,166475,786029,952504,1,6,1,619554,In > Out
Apr 2020,190,156,15,722144,34453511,35175655,8,15,1,33731367,In > Out
Apr 2020,190,160,14,370726,23650628,24021354,7,14,1,23279902,In > Out
Apr 2020,190,164,19,552649,45647047,46199696,11,19,2,45094398,In > Out
Apr 2020,190,165,14,414734,33088777,33503511,8,14,2,32674043,In > Out
Apr 2020,190,176,5,144290,1346331,1490621,2,5,1,1202041,In > Out
Apr 2020,190,180,15,412079,24054371,24466450,8,15,2,23642292,In > Out
Apr 2020,190,184,5,207400,41098664,41306064,2,5,1,40891264,In > Out
Apr 2020,190,188,1,10079,124882,134961,1,1,1,114803,In > Out
Apr 2020,190,208,5,172809,45063004,45235813,5,5,1,44890195,In > Out
Apr 2020,190,209,1151,4474468,308383869,312858337,37,1092,2,303909401,In > Out
Apr 2020,190,216,6,330203,75966106,76296309,6,6,1,75635903,In > Out
Apr 2020,190,217,400,1831870,144624287,146456157,17,388,2,142792417,In > Out
Apr 2020,190,219,1181,4903397,377439573,382342970,22,1134,2,372536176,In > Out
Apr 2020,190,223,15,683711,112907758,113591469,8,15,2,112224047,In > Out
Apr 2020,190,39,4,280652,66889461,67170113,2,4,1,66608809,In > Out
Apr 2020,190,43,192,2803045,146518191,149321236,10,191,2,143715146,In > Out
Apr 2020,190,44,172,2342614,93504328,95846942,9,171,2,91161714,In > Out
Apr 2020,190,46,1,6111,338691,344802,1,1,1,332580,In > Out
Apr 2020,190,48,209,6441310,140151811,146593121,5,5,209,133710501,In > Out
Apr 2020,190,53,6,392056,84109266,84501322,3,6,1,83717210,In > Out
Apr 2020,190,54,5,119699,40711735,40831434,2,5,1,40592036,In > Out
Apr 2020,190,57,10,744470,112312844,113057314,5,10,2,111568374,In > Out
Apr 2020,190,58,19,825893,149300370,150126263,9,19,2,148474477,In > Out
Apr 2020,191,13,1033,91505025,412480552,503985577,33,1000,3,320975527,In > Out
Apr 2020,191,15,743,99357071,2930253653,3029610724,28,729,2,2830896582,In > Out
Apr 2020,191,37,147,1780485,84472402,86252887,12,146,2,82691917,In > Out
Apr 2020,191,48,12,132139,8474593,8606732,3,12,2,8342454,In > Out
Apr 2020,191,51,1197,268255284,318688421,586943705,57,1178,2,50433137,In > Out
Apr 2020,191,56,788,57408417,289835711,347244128,62,772,7,232427294,In > Out
Apr 2020,192,38,28,1153401,2657641,3811042,3,28,1,1504240,In > Out
Apr 2020,192,39,48,2132825,4602208,6735033,3,48,1,2469383,In > Out
Apr 2020,192,40,130,9597263,153127121,162724384,10,130,3,143529858,In > Out
Apr 2020,192,45,37,1923661,86134780,88058441,9,37,2,84211119,In > Out
Apr 2020,195,10,217,92993970,1054555074,1147549044,54,216,5,961561104,In > Out
Apr 2020,195,105,104,11884693,685340999,697225692,47,104,2,673456306,In > Out
Apr 2020,195,106,21,1784273,10016698,11800971,9,21,1,8232425,In > Out
Apr 2020,195,107,2,54979,2727100,2782079,1,2,1,2672121,In > Out
Apr 2020,195,109,24,10525804,35695218,46221022,6,24,3,25169414,In > Out
Apr 2020,195,11,107,124102498,472502920,596605418,20,99,11,348400422,In > Out
Apr 2020,195,110,1,8833,107864,116697,1,1,1,99031,In > Out
Apr 2020,195,113,2074,837460540,13926577995,14764038535,436,1975,9,13089117455,In > Out
Apr 2020,195,114,383,98121257,1391788030,1489909287,129,372,7,1293666773,In > Out
Apr 2020,195,115,703,137481666,8743224180,8880705846,273,699,7,8605742514,In > Out
Apr 2020,195,117,660,671992367,3455971386,4127963753,94,649,5,2783979019,In > Out
Apr 2020,195,118,99,31207806,1463343419,1494551225,35,99,2,1432135613,In > Out
Apr 2020,195,12,560,55784644,2163910887,2219695531,158,556,4,2108126243,In > Out
Apr 2020,195,120,46,2211260,14755186,16966446,29,46,1,12543926,In > Out
Apr 2020,195,123,1,17570,121430,139000,1,1,1,103860,In > Out
Apr 2020,195,128,326,315957640,1002638978,1318596618,143,321,7,686681338,In > Out
Apr 2020,195,129,301,6583823,570843863,577427686,63,301,2,564260040,In > Out
Apr 2020,195,13,17,6267227,474657958,480925185,13,17,1,468390731,In > Out
Apr 2020,195,130,949,1370330033,4065888799,5436218832,170,897,19,2695558766,In > Out
Apr 2020,195,131,2,228246,226476,454722,1,2,1,1770,Out > In
Apr 2020,195,132,1449,189338054,2649939595,2839277649,330,1415,16,2460601541,In > Out
Apr 2020,195,133,71,4107477,289931048,294038525,34,71,1,285823571,In > Out
Apr 2020,195,134,116,93687686,5290517586,5384205272,32,116,4,5196829900,In > Out
Apr 2020,195,135,255,25156264,916434339,941590603,80,255,1,891278075,In > Out
Apr 2020,195,136,43,77147247,7415583534,7492730781,26,43,1,7338436287,In > Out
Apr 2020,195,137,935,123821024,4079594485,4203415509,262,931,6,3955773461,In > Out
Apr 2020,195,138,1141,137569343,3218018534,3355587877,144,1121,4,3080449191,In > Out
Apr 2020,195,139,46,2476041,52563052,55039093,19,46,3,50087011,In > Out
Apr 2020,195,14,193,20325150,646902803,667227953,22,193,2,626577653,In > Out
Apr 2020,195,140,785,296303651,5425074961,5721378612,232,773,21,5128771310,In > Out
Apr 2020,195,141,230,121267921,2258922617,2380190538,104,230,5,2137654696,In > Out
Apr 2020,195,142,41,2606479,30110688,32717167,27,41,1,27504209,In > Out
Apr 2020,195,143,82,35157253,109150890,144308143,52,82,4,73993637,In > Out
Apr 2020,195,144,222,19285935,4343574822,4362860757,78,222,4,4324288887,In > Out
Apr 2020,195,147,37,2941640,57490344,60431984,12,37,1,54548704,In > Out
Apr 2020,195,148,10,872835,18377219,19250054,7,10,2,17504384,In > Out
Apr 2020,195,149,799,235256264,4684342658,4919598922,190,780,2,4449086394,In > Out
Apr 2020,195,15,14,910175,59804207,60714382,7,14,1,58894032,In > Out
Apr 2020,195,150,140,51755029,205025563,256780592,38,140,2,153270534,In > Out
Apr 2020,195,151,579,117181044,7212814635,7329995679,230,570,3,7095633591,In > Out
Apr 2020,195,152,2,47617,1720916,1768533,1,2,1,1673299,In > Out
Apr 2020,195,153,230,58370701,270604933,328975634,74,229,9,212234232,In > Out
Apr 2020,195,154,388,48953820,517096895,566050715,88,383,7,468143075,In > Out
Apr 2020,195,155,193,41171383,4195129999,4236301382,85,193,3,4153958616,In > Out
Apr 2020,195,156,143,19765273,216638377,236403650,52,142,3,196873104,In > Out
Apr 2020,195,157,150,64956495,375724837,440681332,98,149,11,310768342,In > Out
Apr 2020,195,158,1177,56519658,6352092942,6408612600,119,1175,2,6295573284,In > Out
Apr 2020,195,159,876,81386542,2070533272,2151919814,161,860,4,1989146730,In > Out
Apr 2020,195,16,29,2764807,68893882,71658689,9,29,2,66129075,In > Out
Apr 2020,195,161,329,19688886,744641052,764329938,99,328,6,724952166,In > Out
Apr 2020,195,163,131,4710306,114080243,118790549,49,131,5,109369937,In > Out
Apr 2020,195,165,420,30492244,728887135,759379379,177,420,2,698394891,In > Out
Apr 2020,195,166,120,12749859,383724815,396474674,45,118,4,370974956,In > Out
Apr 2020,195,167,14,841448,10665624,11507072,14,14,3,9824176,In > Out
Apr 2020,195,168,256,177279577,435879057,613158634,48,255,4,258599480,In > Out
Apr 2020,195,169,58,2315485,47196555,49512040,28,58,1,44881070,In > Out
Apr 2020,195,17,18,2571901,121296139,123868040,10,18,1,118724238,In > Out
Apr 2020,195,170,1,16229,157299,173528,1,1,1,141070,In > Out
Apr 2020,195,172,19,879374,23735894,24615268,8,19,3,22856520,In > Out
Apr 2020,195,173,264,43955929,982421413,1026377342,99,264,2,938465484,In > Out
Apr 2020,195,174,145,2251540414,1393704097,3645244511,81,145,3,857836317,Out > In
Apr 2020,195,175,6,231938,3791089,4023027,4,6,2,3559151,In > Out
Apr 2020,195,177,248,21197870,309373783,330571653,8,247,3,288175913,In > Out
Apr 2020,195,178,19,5085327,241915874,247001201,12,19,1,236830547,In > Out
Apr 2020,195,18,18,13994100,38972150,52966250,15,18,5,24978050,In > Out
Apr 2020,195,180,460,176286779,8193550125,8369836904,151,460,11,8017263346,In > Out
Apr 2020,195,181,126,15610610,494320047,509930657,35,126,4,478709437,In > Out
Apr 2020,195,182,53,29632516,353834206,383466722,26,53,3,324201690,In > Out
Apr 2020,195,183,95,179732591,701520772,881253363,35,95,3,521788181,In > Out
Apr 2020,195,184,131,28503136,1264419619,1292922755,72,131,3,1235916483,In > Out
Apr 2020,195,185,13,1006294,35661440,36667734,6,13,1,34655146,In > Out
Apr 2020,195,186,140,770690115,311705626,1082395741,76,140,2,458984489,Out > In
Apr 2020,195,187,134,28469807,1943754644,1972224451,67,134,3,1915284837,In > Out
Apr 2020,195,188,74,1907700,47168692,49076392,30,74,2,45260992,In > Out
Apr 2020,195,189,9,499974,20686635,21186609,3,9,1,20186661,In > Out
Apr 2020,195,190,5,114202,1134101,1248303,5,5,1,1019899,In > Out
Apr 2020,195,191,3,1520004,314325,1834329,3,3,2,1205679,Out > In
Apr 2020,195,192,25,72228246,1780970505,1853198751,17,25,4,1708742259,In > Out
Apr 2020,195,193,1,12219,190134,202353,1,1,1,177915,In > Out
Apr 2020,195,194,175,48602187,3695422997,3744025184,95,175,2,3646820810,In > Out
Apr 2020,195,195,32,4681270,376296247,380977517,20,32,2,371614977,In > Out
Apr 2020,195,196,91,8182193,321515590,329697783,26,91,1,313333397,In > Out
Apr 2020,195,197,51,6159967,575665530,581825497,32,51,5,569505563,In > Out
Apr 2020,195,198,811,44347820,5073256821,5117604641,154,810,2,5028909001,In > Out
Apr 2020,195,199,80,7088887,71098994,78187881,48,80,1,64010107,In > Out
Apr 2020,195,20,83,3757171,94049205,97806376,32,83,3,90292034,In > Out
Apr 2020,195,200,1015,846526040,1235735769,2082261809,273,1008,4,389209729,In > Out
Apr 2020,195,201,1,11184,102381,113565,1,1,1,91197,In > Out
Apr 2020,195,202,85,42162327,210753900,252916227,54,84,2,168591573,In > Out
Apr 2020,195,203,218,29423391,512241989,541665380,131,218,3,482818598,In > Out
Apr 2020,195,204,12,177938,4328639,4506577,10,12,1,4150701,In > Out
Apr 2020,195,205,74,4389654,70979795,75369449,64,74,2,66590141,In > Out
Apr 2020,195,206,3110,1223487668,39452835498,40676323166,714,2925,6,38229347830,In > Out
Apr 2020,195,207,235,82962299,1472947313,1555909612,66,235,6,1389985014,In > Out
Apr 2020,195,208,53,59278882,48777791,108056673,38,53,3,10501091,Out > In
Apr 2020,195,209,80,24748136,2074361432,2099109568,48,79,5,2049613296,In > Out
Apr 2020,195,21,21,954643,20442359,21397002,9,21,1,19487716,In > Out
Apr 2020,195,210,63,7488338,115927930,123416268,39,62,3,108439592,In > Out
Apr 2020,195,211,417,57986278,1963494987,2021481265,207,417,3,1905508709,In > Out
Apr 2020,195,212,37,4484647,165766583,170251230,16,37,2,161281936,In > Out
Apr 2020,195,213,6,382556,4359387,4741943,5,6,1,3976831,In > Out
Apr 2020,195,214,238,38912047,372203279,411115326,135,238,2,333291232,In > Out
Apr 2020,195,215,16,846827,5025984,5872811,4,16,1,4179157,In > Out
Apr 2020,195,217,125,24058430,621963421,646021851,33,125,3,597904991,In > Out
Apr 2020,195,218,552,756065463,2292456472,3048521935,162,545,8,1536391009,In > Out
Apr 2020,195,219,84,8633145,488623991,497257136,37,84,3,479990846,In > Out
Apr 2020,195,22,1587,782818182,4082041847,4864860029,266,1547,42,3299223665,In > Out
Apr 2020,195,220,13,970038,30508826,31478864,8,13,2,29538788,In > Out
Apr 2020,195,221,1666,2138175598,10665607550,12803783148,397,1632,4,8527431952,In > Out
Apr 2020,195,222,2723,261251768,6990449591,7251701359,319,2600,8,6729197823,In > Out
Apr 2020,195,223,9,484697,4239963,4724660,9,9,2,3755266,In > Out
Apr 2020,195,24,16,924114,8837471,9761585,14,16,2,7913357,In > Out
Apr 2020,195,27,71,14391554,2039523122,2053914676,28,71,2,2025131568,In > Out
Apr 2020,195,28,17,1660313,63466238,65126551,10,17,1,61805925,In > Out
Apr 2020,195,29,192,15706004,1029795001,1045501005,92,192,2,1014088997,In > Out
Apr 2020,195,30,26,27755005,2374848915,2402603920,16,26,2,2347093910,In > Out
Apr 2020,195,32,4,167060,11073304,11240364,4,4,2,10906244,In > Out
Apr 2020,195,33,20,12593875,1983537278,1996131153,11,20,1,1970943403,In > Out
Apr 2020,195,34,21,51463345,42845430,94308775,16,21,4,8617915,Out > In
Apr 2020,195,35,309,40330426,1354541677,1394872103,82,309,9,1314211251,In > Out
Apr 2020,195,36,6,106883,3126809,3233692,5,6,2,3019926,In > Out
Apr 2020,195,37,15,493959,22621100,23115059,8,15,1,22127141,In > Out
Apr 2020,195,38,366,391551396,1311339768,1702891164,85,362,9,919788372,In > Out
Apr 2020,195,4,25,1262260,19803290,21065550,19,25,2,18541030,In > Out
Apr 2020,195,40,249,27287187,635777307,663064494,68,248,3,608490120,In > Out
Apr 2020,195,41,559,853422071,905750262,1759172333,210,557,9,52328191,In > Out
Apr 2020,195,42,6,77442126,126143057,203585183,3,6,3,48700931,In > Out
Apr 2020,195,43,159,57103990,74470649,131574639,105,159,3,17366659,In > Out
Apr 2020,195,44,1,37193,1125695,1162888,1,1,1,1088502,In > Out
Apr 2020,195,46,90,14270890,300437954,314708844,11,90,2,286167064,In > Out
Apr 2020,195,48,44,12035155,69396954,81432109,24,44,2,57361799,In > Out
Apr 2020,195,5,80,2166639,47801989,49968628,26,80,2,45635350,In > Out
Apr 2020,195,50,34,30961343,3284588917,3315550260,22,34,1,3253627574,In > Out
Apr 2020,195,51,11,1210590,17368676,18579266,8,11,2,16158086,In > Out
Apr 2020,195,52,421,164284686,4051009608,4215294294,119,414,7,3886724922,In > Out
Apr 2020,195,53,461,10598447,1041340015,1051938462,14,461,1,1030741568,In > Out
Apr 2020,195,54,37,4082824190,84966122,4167790312,22,37,3,3997858068,Out > In
Apr 2020,195,55,418,555798131,6208398499,6764196630,153,418,8,5652600368,In > Out
Apr 2020,195,56,3556,615302018,14045434209,14660736227,476,3092,6,13430132191,In > Out
Apr 2020,195,57,9,591502,21034636,21626138,7,9,1,20443134,In > Out
Apr 2020,195,58,1050,241201442,8637710344,8878911786,411,1046,4,8396508902,In > Out
Apr 2020,195,6,2,37463,3846691,3884154,2,2,1,3809228,In > Out
Apr 2020,195,60,61,40183817,650829600,691013417,26,61,3,610645783,In > Out
Apr 2020,195,61,460,32776278,1368894629,1401670907,136,457,3,1336118351,In > Out
Apr 2020,195,63,1194,760959073,36804655599,37565614672,359,1178,2,36043696526,In > Out
Apr 2020,195,64,262,45144843,490972705,536117548,120,262,2,445827862,In > Out
Apr 2020,195,65,129,23682310,1825769593,1849451903,37,129,3,1802087283,In > Out
Apr 2020,195,66,665,37378216,1639971244,1677349460,76,665,3,1602593028,In > Out
Apr 2020,195,67,3,97376,3228603,3325979,2,3,1,3131227,In > Out
Apr 2020,195,68,2868,2283067676,32814607111,35097674787,422,2717,70,30531539435,In > Out
Apr 2020,195,69,29,10281766,167177750,177459516,10,29,1,156895984,In > Out
Apr 2020,195,7,14,566983,10492791,11059774,10,14,1,9925808,In > Out
Apr 2020,195,70,7,122178,1976538,2098716,4,7,2,1854360,In > Out
Apr 2020,195,71,235,37216164,468490276,505706440,79,231,6,431274112,In > Out
Apr 2020,195,72,329,34179592,741179833,775359425,103,327,3,707000241,In > Out
Apr 2020,195,73,934,211481157,2534248638,2745729795,265,917,10,2322767481,In > Out
Apr 2020,195,74,544,64557639,2972814695,3037372334,90,532,5,2908257056,In > Out
Apr 2020,195,75,477,45540944,963095055,1008635999,138,473,4,917554111,In > Out
Apr 2020,195,76,52,6214475,280722966,286937441,17,52,1,274508491,In > Out
Apr 2020,195,77,1521,258516461,13763716856,14022233317,186,1491,8,13505200395,In > Out
Apr 2020,195,79,286,97810909,463677957,561488866,154,250,29,365867048,In > Out
Apr 2020,195,8,39,2077474,19840243,21917717,32,39,3,17762769,In > Out
Apr 2020,195,81,490,45546775,1511012758,1556559533,198,486,3,1465465983,In > Out
Apr 2020,195,82,450,34569180,1665598507,1700167687,153,443,5,1631029327,In > Out
Apr 2020,195,83,2189,365713896,4721718639,5087432535,277,2058,9,4356004743,In > Out
Apr 2020,195,84,345,79433922,1518613664,1598047586,101,335,11,1439179742,In > Out
Apr 2020,195,85,294,14491303,342409384,356900687,44,294,2,327918081,In > Out
Apr 2020,195,87,46,6581120,128182435,134763555,25,46,2,121601315,In > Out
Apr 2020,195,88,14,949216,28934835,29884051,8,14,1,27985619,In > Out
Apr 2020,195,89,318,15958379,327576772,343535151,165,318,2,311618393,In > Out
Apr 2020,195,90,2,135475,130511,265986,2,2,1,4964,Out > In
Apr 2020,195,91,3,222438,262236,484674,3,3,2,39798,In > Out
Apr 2020,195,92,62,17390648,1022518553,1039909201,23,62,1,1005127905,In > Out
Apr 2020,195,96,23,4217783,4597606,8815389,16,23,1,379823,In > Out
Apr 2020,195,97,248,20555906,876485008,897040914,118,240,2,855929102,In > Out
Apr 2020,195,99,12,79125605,15204103,94329708,10,12,1,63921502,Out > In
Apr 2020,196,119,610,25444989,1956293596,1981738585,44,540,2,1930848607,In > Out
Apr 2020,196,137,578,25925880,1943582556,1969508436,47,530,2,1917656676,In > Out
Apr 2020,196,162,135,5229191,363280792,368509983,15,135,2,358051601,In > Out
Apr 2020,196,170,16,980448,38909717,39890165,13,16,2,37929269,In > Out
Apr 2020,196,178,48,1558449,111115029,112673478,21,48,2,109556580,In > Out
Apr 2020,196,183,13,448250,39304668,39752918,9,13,2,38856418,In > Out
Apr 2020,196,187,16,1126246,46649431,47775677,11,16,2,45523185,In > Out
Apr 2020,196,189,71,2070452,147201421,149271873,14,71,2,145130969,In > Out
Apr 2020,196,190,14,466708,43374922,43841630,8,14,2,42908214,In > Out
Apr 2020,196,191,10,194085,13745278,13939363,8,10,2,13551193,In > Out
Apr 2020,196,192,13,188901,14486157,14675058,7,13,2,14297256,In > Out
Apr 2020,196,33,19,925097,45777650,46702747,13,19,2,44852553,In > Out
Apr 2020,196,34,14,205447,16476639,16682086,10,14,2,16271192,In > Out
Apr 2020,196,36,17,334228,21452005,21786233,13,17,2,21117777,In > Out
Apr 2020,196,37,14,279486,16014861,16294347,9,14,2,15735375,In > Out
Apr 2020,196,39,12,170898,12051809,12222707,6,12,2,11880911,In > Out
Apr 2020,196,40,10,239491,20214769,20454260,8,10,2,19975278,In > Out
Apr 2020,196,42,17,363620,21305278,21668898,10,17,2,20941658,In > Out
Apr 2020,196,44,11,175518,15516460,15691978,8,11,2,15340942,In > Out
Apr 2020,196,46,12,257165,18741091,18998256,8,12,2,18483926,In > Out
Apr 2020,196,47,14,222556,21038758,21261314,10,14,2,20816202,In > Out
Apr 2020,196,53,960,235125855,12432048900,12667174755,77,848,2,12196923045,In > Out
Apr 2020,196,62,18,705292,16999116,17704408,13,18,2,16293824,In > Out
Apr 2020,197,100,104,32453923,355207122,387661045,58,103,8,322753199,In > Out
Apr 2020,197,101,89,4503025,131023810,135526835,30,89,3,126520785,In > Out
Apr 2020,197,102,135,14018761,394250674,408269435,55,133,5,380231913,In > Out
Apr 2020,197,103,66,105035066,267223154,372258220,30,66,2,162188088,In > Out
Apr 2020,197,104,149,20454441,603611771,624066212,64,149,3,583157330,In > Out
Apr 2020,197,105,107,412659543,1171279716,1583939259,43,107,2,758620173,In > Out
Apr 2020,197,107,178,390050592,700168809,1090219401,74,177,4,310118217,In > Out
Apr 2020,197,108,57,7862721,141379949,149242670,30,57,2,133517228,In > Out
Apr 2020,197,11,56,45524424,616304408,661828832,34,56,4,570779984,In > Out
Apr 2020,197,110,149,57368950,1002214410,1059583360,48,147,4,944845460,In > Out
Apr 2020,197,113,167,206802197,6444251484,6651053681,83,167,4,6237449287,In > Out
Apr 2020,197,115,112,104660848,401147503,505808351,39,110,5,296486655,In > Out
Apr 2020,197,117,107,430404118,544602993,975007111,48,107,6,114198875,In > Out
Apr 2020,197,118,41,1513963,30894606,32408569,25,41,2,29380643,In > Out
Apr 2020,197,12,85,120306643,1181756364,1302063007,39,82,3,1061449721,In > Out
Apr 2020,197,120,177,972673380,380362961,1353036341,55,176,4,592310419,Out > In
Apr 2020,197,121,2519,50507259,6977924615,7028431874,120,2467,2,6927417356,In > Out
Apr 2020,197,123,150,526670449,913141755,1439812204,42,150,2,386471306,In > Out
Apr 2020,197,124,33,10803118,45029465,55832583,26,33,3,34226347,In > Out
Apr 2020,197,125,79,26871600,91349972,118221572,41,79,4,64478372,In > Out
Apr 2020,197,126,72,59674757,375321717,434996474,46,72,4,315646960,In > Out
Apr 2020,197,128,24,2276574,21771295,24047869,12,24,3,19494721,In > Out
Apr 2020,197,129,140,10401826,208621458,219023284,38,137,4,198219632,In > Out
Apr 2020,197,130,70,6481855,506688387,513170242,42,70,4,500206532,In > Out
Apr 2020,197,131,288,80901674,278508895,359410569,84,287,4,197607221,In > Out
Apr 2020,197,132,128,133046720,1008314218,1141360938,59,128,5,875267498,In > Out
Apr 2020,197,133,24,2668317,40902915,43571232,13,24,1,38234598,In > Out
Apr 2020,197,135,23,15303315,1309875616,1325178931,16,23,3,1294572301,In > Out
Apr 2020,197,136,72,14473434,152898184,167371618,29,72,4,138424750,In > Out
Apr 2020,197,137,48,612617226,82784975,695402201,28,48,3,529832251,Out > In
Apr 2020,197,138,9,718515,3738066,4456581,9,9,3,3019551,In > Out
Apr 2020,197,139,911,239362376,3983848055,4223210431,107,892,4,3744485679,In > Out
Apr 2020,197,14,113,27299178,1174272058,1201571236,73,113,3,1146972880,In > Out
Apr 2020,197,140,105,19678072,73354808,93032880,47,105,3,53676736,In > Out
Apr 2020,197,141,83,12102895,509555028,521657923,26,83,2,497452133,In > Out
Apr 2020,197,142,92,6219068,56989734,63208802,41,92,3,50770666,In > Out
Apr 2020,197,143,109,6576988,113450018,120027006,30,109,2,106873030,In > Out
Apr 2020,197,144,99,68282153,422658441,490940594,33,98,2,354376288,In > Out
Apr 2020,197,145,30,2308151,40952763,43260914,19,30,4,38644612,In > Out
Apr 2020,197,146,254,678599952,925848019,1604447971,100,254,5,247248067,In > Out
Apr 2020,197,148,20,1548664,4950955,6499619,10,20,3,3402291,In > Out
Apr 2020,197,149,16,2200056,53408544,55608600,12,16,2,51208488,In > Out
Apr 2020,197,15,21,734718,32928956,33663674,15,21,3,32194238,In > Out
Apr 2020,197,150,67,2422633,114559270,116981903,35,66,3,112136637,In > Out
Apr 2020,197,152,674,89212284,2633028500,2722240784,149,652,24,2543816216,In > Out
Apr 2020,197,153,95,138543021,310408873,448951894,41,94,4,171865852,In > Out
Apr 2020,197,154,128,69341051,265131942,334472993,43,127,4,195790891,In > Out
Apr 2020,197,155,59,13453230,263659762,277112992,38,59,3,250206532,In > Out
Apr 2020,197,156,148,14100756,140491015,154591771,68,148,5,126390259,In > Out
Apr 2020,197,157,22,11503835,428855060,440358895,14,22,4,417351225,In > Out
Apr 2020,197,158,37,4039519,28640511,32680030,29,37,2,24600992,In > Out
Apr 2020,197,159,32,2257189,10743666,13000855,17,32,4,8486477,In > Out
Apr 2020,197,16,64,9704302,153288135,162992437,40,64,4,143583833,In > Out
Apr 2020,197,160,40,2139733,76431234,78570967,20,40,2,74291501,In > Out
Apr 2020,197,161,159,102141819,565077951,667219770,75,158,4,462936132,In > Out
Apr 2020,197,162,121,5324350,184220719,189545069,21,121,2,178896369,In > Out
Apr 2020,197,163,153,150586388,17274955899,17425542287,60,153,3,17124369511,In > Out
Apr 2020,197,164,108,7779893,464565729,472345622,44,106,6,456785836,In > Out
Apr 2020,197,165,107,131209369,467375596,598584965,48,107,2,336166227,In > Out
Apr 2020,197,166,73,5900995,68970007,74871002,44,73,4,63069012,In > Out
Apr 2020,197,167,199,66730718,1456989236,1523719954,89,198,6,1390258518,In > Out
Apr 2020,197,168,97,32730723,1136522609,1169253332,40,97,4,1103791886,In > Out
Apr 2020,197,169,138,11480895,720759707,732240602,42,134,7,709278812,In > Out
Apr 2020,197,17,49,18991014,437417148,456408162,22,49,3,418426134,In > Out
Apr 2020,197,170,40,1436122,21332058,22768180,23,40,4,19895936,In > Out
Apr 2020,197,171,87,22665824,54254538,76920362,49,86,5,31588714,In > Out
Apr 2020,197,172,17,1017129,5853963,6871092,13,17,2,4836834,In > Out
Apr 2020,197,174,59,4721462,571976631,576698093,28,59,3,567255169,In > Out
Apr 2020,197,178,42,5517984,24586818,30104802,30,42,10,19068834,In > Out
Apr 2020,197,179,338,14921966,515450208,530372174,49,337,6,500528242,In > Out
Apr 2020,197,18,218,35079875,1449992328,1485072203,56,218,5,1414912453,In > Out
Apr 2020,197,180,268,100950025,591057166,692007191,51,268,2,490107141,In > Out
Apr 2020,197,181,23,8111423,29139994,37251417,15,23,3,21028571,In > Out
Apr 2020,197,183,293,202682507,686074273,888756780,74,292,4,483391766,In > Out
Apr 2020,197,184,74,161632524,772434566,934067090,42,74,3,610802042,In > Out
Apr 2020,197,186,493,38582431,1670752978,1709335409,75,489,3,1632170547,In > Out
Apr 2020,197,187,181,118809279,4999886728,5118696007,72,181,4,4881077449,In > Out
Apr 2020,197,188,139,8170759,153610105,161780864,60,139,3,145439346,In > Out
Apr 2020,197,19,56,18848039,367839818,386687857,48,53,8,348991779,In > Out
Apr 2020,197,190,152,8624677,682672785,691297462,15,152,5,674048108,In > Out
Apr 2020,197,191,446,81116315,6347288457,6428404772,49,446,2,6266172142,In > Out
Apr 2020,197,192,91,12038336,258459007,270497343,36,90,3,246420671,In > Out
Apr 2020,197,193,74,7869523,303854932,311724455,39,74,4,295985409,In > Out
Apr 2020,197,194,69,4239380,30102420,34341800,28,69,2,25863040,In > Out
Apr 2020,197,195,218,128230425,793859366,922089791,58,217,6,665628941,In > Out
Apr 2020,197,196,87,20818409,1732699779,1753518188,35,87,1,1711881370,In > Out
Apr 2020,197,197,131,18050875,1134224008,1152274883,59,131,11,1116173133,In > Out
Apr 2020,197,198,21,2495227,93124352,95619579,14,21,2,90629125,In > Out
Apr 2020,197,199,256,59033120,579658834,638691954,68,255,4,520625714,In > Out
Apr 2020,197,20,32,5305861,30247558,35553419,25,32,3,24941697,In > Out
Apr 2020,197,201,74,4874970,90376724,95251694,39,74,6,85501754,In > Out
Apr 2020,197,202,17,764038,7444961,8208999,14,17,1,6680923,In > Out
Apr 2020,197,204,97,9824269,78948680,88772949,45,97,3,69124411,In > Out
Apr 2020,197,205,89,13845786,672011219,685857005,46,89,2,658165433,In > Out
Apr 2020,197,206,73,25671044,28965313,54636357,29,73,3,3294269,In > Out
Apr 2020,197,208,39,4361130,59706162,64067292,32,39,5,55345032,In > Out
Apr 2020,197,209,18,1029194,8765201,9794395,12,18,3,7736007,In > Out
Apr 2020,197,21,32,2334628,66169786,68504414,16,32,2,63835158,In > Out
Apr 2020,197,210,221,7579643,232609081,240188724,39,220,3,225029438,In > Out
Apr 2020,197,211,13,538061,11373310,11911371,10,13,3,10835249,In > Out
Apr 2020,197,212,40,1629927,19471566,21101493,15,40,3,17841639,In > Out
Apr 2020,197,213,64,42361534,112926527,155288061,43,63,3,70564993,In > Out
Apr 2020,197,214,181,28224200,351480655,379704855,64,180,4,323256455,In > Out
Apr 2020,197,215,159,37383197,604138254,641521451,68,158,2,566755057,In > Out
Apr 2020,197,216,161,44708696,2071839393,2116548089,76,161,5,2027130697,In > Out
Apr 2020,197,219,76,26335772,216185767,242521539,41,76,2,189849995,In > Out
Apr 2020,197,22,109,7357483,250216732,257574215,52,109,6,242859249,In > Out
Apr 2020,197,220,90,13424515,187995870,201420385,33,90,2,174571355,In > Out
Apr 2020,197,221,59,12960396,956548640,969509036,30,59,4,943588244,In > Out
Apr 2020,197,222,27,4720999,223528891,228249890,21,27,3,218807892,In > Out
Apr 2020,197,223,183,179054187,10515807081,10694861268,78,182,8,10336752894,In > Out
Apr 2020,197,24,507,63799246,1845123107,1908922353,55,507,3,1781323861,In > Out
Apr 2020,197,25,47,6280546,115395615,121676161,21,47,1,109115069,In > Out
Apr 2020,197,26,69,19999347,368738024,388737371,45,69,5,348738677,In > Out
Apr 2020,197,27,89,2676062574,335591934,3011654508,33,89,3,2340470640,Out > In
Apr 2020,197,30,432,38703949,1260107410,1298811359,110,432,3,1221403461,In > Out
Apr 2020,197,31,223,25783155,581494927,607278082,67,222,4,555711772,In > Out
Apr 2020,197,32,178,52792279,2794303843,2847096122,47,177,3,2741511564,In > Out
Apr 2020,197,35,290,468938212,1253061979,1722000191,70,290,4,784123767,In > Out
Apr 2020,197,37,33,183447143,303115121,486562264,15,33,3,119667978,In > Out
Apr 2020,197,38,104,16395900,719925102,736321002,65,103,2,703529202,In > Out
Apr 2020,197,39,102,21123539,186945088,208068627,22,102,1,165821549,In > Out
Apr 2020,197,4,167,180874928,615042902,795917830,58,166,4,434167974,In > Out
Apr 2020,197,40,193,14771198,1069169792,1083940990,48,192,2,1054398594,In > Out
Apr 2020,197,41,80,22461104,873427101,895888205,38,80,2,850965997,In > Out
Apr 2020,197,42,45,41788700,101775131,143563831,29,45,3,59986431,In > Out
Apr 2020,197,43,51,6434860,221925876,228360736,30,51,3,215491016,In > Out
Apr 2020,197,44,99,18658524,697767054,716425578,45,99,3,679108530,In > Out
Apr 2020,197,45,110,12011190,271443010,283454200,30,110,3,259431820,In > Out
Apr 2020,197,46,26,1357996,40757052,42115048,17,26,2,39399056,In > Out
Apr 2020,197,48,389,95987018,1678205218,1774192236,120,382,5,1582218200,In > Out
Apr 2020,197,49,431,35704822,1789287026,1824991848,82,429,7,1753582204,In > Out
Apr 2020,197,51,601,253224271,2110543803,2363768074,69,586,8,1857319532,In > Out
Apr 2020,197,53,42,2814959,92944452,95759411,16,42,3,90129493,In > Out
Apr 2020,197,54,32,6680577,15695374,22375951,20,32,2,9014797,In > Out
Apr 2020,197,55,242,106999092,5599111769,5706110861,81,237,6,5492112677,In > Out
Apr 2020,197,57,36,1424050,30831467,32255517,16,36,4,29407417,In > Out
Apr 2020,197,58,84,3353233,145014240,148367473,43,84,3,141661007,In > Out
Apr 2020,197,60,59,7197518,149773901,156971419,38,59,3,142576383,In > Out
Apr 2020,197,62,343,67286303,4381018152,4448304455,50,339,4,4313731849,In > Out
Apr 2020,197,63,84,20765361,1022748830,1043514191,46,84,3,1001983469,In > Out
Apr 2020,197,64,81,124234093,476569677,600803770,34,81,4,352335584,In > Out
Apr 2020,197,65,148,69659158,9246802748,9316461906,71,148,3,9177143590,In > Out
Apr 2020,197,66,41,96433955,28950192,125384147,23,41,1,67483763,Out > In
Apr 2020,197,68,67,8572817,114219340,122792157,36,67,2,105646523,In > Out
Apr 2020,197,71,76,13967209,61004673,74971882,22,76,3,47037464,In > Out
Apr 2020,197,72,115,11713605,768023339,779736944,46,114,3,756309734,In > Out
Apr 2020,197,73,78,3672069,109232942,112905011,26,78,1,105560873,In > Out
Apr 2020,197,74,50,54305919,103312015,157617934,28,50,2,49006096,In > Out
Apr 2020,197,75,75,216541656,464315187,680856843,59,64,21,247773531,In > Out
Apr 2020,197,76,12,537647,4140819,4678466,10,12,2,3603172,In > Out
Apr 2020,197,77,18,688856,7110890,7799746,16,18,5,6422034,In > Out
Apr 2020,197,78,211,179514253,512540889,692055142,62,203,4,333026636,In > Out
Apr 2020,197,79,190,25438546,297259948,322698494,81,190,7,271821402,In > Out
Apr 2020,197,80,192,21417645,496980662,518398307,54,192,5,475563017,In > Out
Apr 2020,197,81,135,29665800,1347547385,1377213185,78,135,5,1317881585,In > Out
Apr 2020,197,82,91,8514964,53217802,61732766,40,91,3,44702838,In > Out
Apr 2020,197,83,131,155753091,239246860,394999951,41,130,3,83493769,In > Out
Apr 2020,197,85,108,10927525,882090162,893017687,17,108,1,871162637,In > Out
Apr 2020,197,86,182,70566058,355332513,425898571,62,182,4,284766455,In > Out
Apr 2020,197,87,33,3756934,255458826,259215760,21,33,3,251701892,In > Out
Apr 2020,197,89,114,35240799,59743539,94984338,80,114,7,24502740,In > Out
Apr 2020,197,9,296,74014733,5842434921,5916449654,113,296,4,5768420188,In > Out
Apr 2020,197,90,30,2139069,38991331,41130400,24,30,3,36852262,In > Out
Apr 2020,197,91,44,4152105,196965385,201117490,23,44,4,192813280,In > Out
Apr 2020,197,92,27,5937870,31410131,37348001,13,27,3,25472261,In > Out
Apr 2020,197,93,30,644274,23614776,24259050,17,30,4,22970502,In > Out
Apr 2020,197,94,621,103679797,6450237956,6553917753,170,616,4,6346558159,In > Out
Apr 2020,197,95,87,50767489,211731704,262499193,37,87,3,160964215,In > Out
Apr 2020,197,98,62,5276507,145071022,150347529,45,62,1,139794515,In > Out
Apr 2020,197,99,89,4978529,280148799,285127328,59,88,2,275170270,In > Out
Apr 2020,198,22,24901,3439304659,93568999650,97008304309,2483,12574,168,90129694991,In > Out
Apr 2020,199,77,14,606954,1048155,1655109,3,14,1,441201,In > Out
Apr 2020,2,1,2,122436,120612,243048,1,1,1,1824,Out > In
Apr 2020,2,100,6,1178724,827060,2005784,5,6,2,351664,Out > In
Apr 2020,2,13,84,905265,48539706,49444971,11,84,1,47634441,In > Out
Apr 2020,2,14,24,2054469,343208389,345262858,7,24,2,341153920,In > Out
Apr 2020,2,15,8,1523730,62570265,64093995,2,2,8,61046535,In > Out
Apr 2020,2,16,65,1563467,76549463,78112930,15,65,2,74985996,In > Out
Apr 2020,2,21,421,51140711,263885798,315026509,49,415,5,212745087,In > Out
Apr 2020,2,244,7,278714,47524562,47803276,1,7,1,47245848,In > Out
Apr 2020,2,253,9,990408,217404618,218395026,1,9,1,216414210,In > Out
Apr 2020,2,31,1,107678,4613,112291,1,1,1,103065,Out > In
Apr 2020,2,7,34,6261701,957542987,963804688,2,34,1,951281286,In > Out
Apr 2020,2,91,570,4505268616,834626373430,839131642046,21,557,3,830121104814,In > Out
Apr 2020,200,17,16,580271,3008880,3589151,9,16,3,2428609,In > Out
Apr 2020,200,199,73,1873950,70970064,72844014,8,73,2,69096114,In > Out
Apr 2020,200,20,91,2491318,88593710,91085028,24,91,2,86102392,In > Out
Apr 2020,200,200,13,831245,44119425,44950670,3,13,1,43288180,In > Out
Apr 2020,200,204,10,487255,715235,1202490,5,10,2,227980,In > Out
Apr 2020,200,205,6,333651,354419,688070,2,6,1,20768,In > Out
Apr 2020,200,206,604,100475332,115233801,215709133,22,604,2,14758469,In > Out
Apr 2020,200,21,21,892565,52865972,53758537,11,21,2,51973407,In > Out
Apr 2020,200,210,204,2639263,112475141,115114404,6,204,2,109835878,In > Out
Apr 2020,200,211,3290,164547154,15274576762,15439123916,12,3025,2,15110029608,In > Out
Apr 2020,200,212,39,4242450,66834620,71077070,17,39,2,62592170,In > Out
Apr 2020,200,22,16,728953,61458342,62187295,6,16,2,60729389,In > Out
Apr 2020,200,24,19,1046431,52591404,53637835,8,19,2,51544973,In > Out
Apr 2020,200,25,34,907509,75520300,76427809,8,34,2,74612791,In > Out
Apr 2020,200,26,513,5039283,128018095,133057378,14,508,2,122978812,In > Out
Apr 2020,200,27,21,1092240,51863587,52955827,10,21,2,50771347,In > Out
Apr 2020,200,28,26,608750,60869524,61478274,11,26,2,60260774,In > Out
Apr 2020,200,29,23,858896,100964612,101823508,10,23,1,100105716,In > Out
Apr 2020,200,30,21,1206705,54190004,55396709,11,21,2,52983299,In > Out
Apr 2020,200,33,13,672434,79318849,79991283,4,13,1,78646415,In > Out
Apr 2020,200,34,93,7747576,141315100,149062676,47,93,2,133567524,In > Out
Apr 2020,200,35,31,1865028,110042937,111907965,10,31,2,108177909,In > Out
Apr 2020,200,36,22,778248,83231106,84009354,10,22,2,82452858,In > Out
Apr 2020,200,38,20,731762,62108211,62839973,8,20,2,61376449,In > Out
Apr 2020,200,39,7,431646,48915218,49346864,4,7,2,48483572,In > Out
Apr 2020,200,40,10,454628,45409844,45864472,4,10,2,44955216,In > Out
Apr 2020,200,43,5,1100009,42167313,43267322,3,5,2,41067304,In > Out
Apr 2020,200,44,10,3005841,42790588,45796429,6,10,2,39784747,In > Out
Apr 2020,200,45,17,3730605,51090365,54820970,5,17,2,47359760,In > Out
Apr 2020,200,46,26,1090947,95800816,96891763,12,26,2,94709869,In > Out
Apr 2020,200,47,7,496196,55246088,55742284,2,7,1,54749892,In > Out
Apr 2020,200,48,13,442507,41960448,42402955,6,13,2,41517941,In > Out
Apr 2020,200,53,16,1108632,64947269,66055901,8,16,2,63838637,In > Out
Apr 2020,200,55,15,378605,36497795,36876400,4,15,1,36119190,In > Out
Apr 2020,200,60,10,2199515,36105958,38305473,6,10,2,33906443,In > Out
Apr 2020,200,61,10,2125057,30808103,32933160,8,10,2,28683046,In > Out
Apr 2020,200,65,10,485187,713050,1198237,4,10,2,227863,In > Out
Apr 2020,200,66,14,4964957,56724727,61689684,7,14,2,51759770,In > Out
Apr 2020,200,68,16,766814,49479221,50246035,11,16,2,48712407,In > Out
Apr 2020,200,89,13,3075381,59075052,62150433,8,13,2,55999671,In > Out
Apr 2020,200,96,10,3864611,81002680,84867291,5,10,2,77138069,In > Out
Apr 2020,203,221,648,111604957,613096657,724701614,178,637,6,501491700,In > Out
Apr 2020,203,241,142,12343133,240267226,252610359,68,142,2,227924093,In > Out
Apr 2020,203,65,237,15072747,790137412,805210159,30,237,2,775064665,In > Out
Apr 2020,203,91,1692,424916492,1077044048,1501960540,241,1614,3,652127556,In > Out
Apr 2020,204,205,3548,754021062,52988818874,53742839936,498,3363,8,52234797812,In > Out
Apr 2020,204,223,620,2014587752,17777114923,19791702675,204,521,93,15762527171,In > Out
Apr 2020,206,118,29,833964,14255246,15089210,6,29,1,13421282,In > Out
Apr 2020,206,200,153,19513814,358144328,377658142,77,153,3,338630514,In > Out
Apr 2020,206,205,69,1684582,44805928,46490510,11,69,2,43121346,In > Out
Apr 2020,206,208,69,844204,27591195,28435399,11,69,2,26746991,In > Out
Apr 2020,206,209,251,105201659,2748098048,2853299707,72,251,2,2642896389,In > Out
Apr 2020,206,245,22,775222,41018904,41794126,15,22,2,40243682,In > Out
Apr 2020,206,33,179,8927031,94413056,103340087,57,137,10,85486025,In > Out
Apr 2020,206,49,1,3585,131166,134751,1,1,1,127581,In > Out
Apr 2020,206,7,204,13040678227,607565490110,620606168337,44,170,13,594524811883,In > Out
Apr 2020,207,111,126,4138065,511593462,515731527,18,126,2,507455397,In > Out
Apr 2020,207,127,132,142936312,15235959,158172271,35,1,129,127700353,Out > In
Apr 2020,207,151,1461,207754935,2737328381,2945083316,119,1391,3,2529573446,In > Out
Apr 2020,207,227,151,155377347,1653054871,1808432218,49,151,2,1497677524,In > Out
Apr 2020,207,47,33,767418,23645797,24413215,29,33,1,22878379,In > Out
Apr 2020,207,57,162,2864173,113351031,116215204,18,162,2,110486858,In > Out
Apr 2020,208,104,4,8348891,924437809,932786700,2,4,1,916088918,In > Out
Apr 2020,208,105,130,6239549,788330686,794570235,6,130,2,782091137,In > Out
Apr 2020,208,109,2,9427074,1258347188,1267774262,2,2,1,1248920114,In > Out
Apr 2020,208,111,11,303337,52115645,52418982,5,11,2,51812308,In > Out
Apr 2020,208,113,1,216496,2346,218842,1,1,1,214150,Out > In
Apr 2020,208,119,8,92065,5533664,5625729,4,8,2,5441599,In > Out
Apr 2020,208,125,13,277529,29819444,30096973,3,13,1,29541915,In > Out
Apr 2020,208,127,10,405521,51835653,52241174,3,10,2,51430132,In > Out
Apr 2020,208,128,183,5353550,119311454,124665004,28,183,2,113957904,In > Out
Apr 2020,208,17,2,57642,4856467,4914109,2,2,1,4798825,In > Out
Apr 2020,208,18,896,347602311,1328824505,1676426816,7,876,2,981222194,In > Out
Apr 2020,208,195,8,341123,49404870,49745993,4,8,2,49063747,In > Out
Apr 2020,208,29,4,2525016,160183569,162708585,4,4,2,157658553,In > Out
Apr 2020,208,30,5,4028190,761982090,766010280,4,5,2,757953900,In > Out
Apr 2020,208,32,19,1687447,2845919,4533366,16,18,2,1158472,In > Out
Apr 2020,208,40,6,9645448,637550131,647195579,5,6,2,627904683,In > Out
Apr 2020,208,41,28,18747335,4479164,23226499,23,28,2,14268171,Out > In
Apr 2020,208,45,6,299552,44210304,44509856,4,6,2,43910752,In > Out
Apr 2020,208,47,7,18891522,2400529736,2419421258,5,7,2,2381638214,In > Out
Apr 2020,208,48,7,13103402,1087898081,1101001483,5,7,2,1074794679,In > Out
Apr 2020,208,49,4,10772798,648767898,659540696,4,4,1,637995100,In > Out
Apr 2020,208,50,4,10379158,477059976,487439134,4,4,1,466680818,In > Out
Apr 2020,208,52,2,111103,4373073,4484176,1,2,1,4261970,In > Out
Apr 2020,208,55,4,46231423,1069594844,1115826267,3,4,1,1023363421,In > Out
Apr 2020,208,58,19,1882099,5578123,7460222,16,19,2,3696024,In > Out
Apr 2020,208,59,4,63137,3834740,3897877,4,4,1,3771603,In > Out
Apr 2020,208,60,6,1994614,100824066,102818680,5,6,2,98829452,In > Out
Apr 2020,208,62,3,2664030,122382245,125046275,3,3,2,119718215,In > Out
Apr 2020,208,64,67,18393541,8925838,27319379,40,67,2,9467703,Out > In
Apr 2020,208,66,4,19818,1285801,1305619,3,4,1,1265983,In > Out
Apr 2020,208,69,3,12515675,668843183,681358858,3,3,2,656327508,In > Out
Apr 2020,208,71,1,7531557,1107136343,1114667900,1,1,1,1099604786,In > Out
Apr 2020,208,78,4,2733922,101711440,104445362,4,4,1,98977518,In > Out
Apr 2020,208,81,7,489544,57319452,57808996,4,7,2,56829908,In > Out
Apr 2020,208,83,21,498954,23095357,23594311,6,21,3,22596403,In > Out
Apr 2020,208,87,12,278824,2549849,2828673,4,12,1,2271025,In > Out
Apr 2020,208,89,6,19109,693051,712160,2,6,1,673942,In > Out
Apr 2020,208,90,28,1860525,4045558,5906083,8,28,1,2185033,In > Out
Apr 2020,208,91,23,7660835,7100685,14761520,1,23,1,560150,Out > In
Apr 2020,208,92,28,5420396,20564134,25984530,3,28,2,15143738,In > Out
Apr 2020,208,93,12,1834586,1750624,3585210,1,12,1,83962,Out > In
Apr 2020,209,100,7,152986595,14206715378,14359701973,2,7,2,14053728783,In > Out
Apr 2020,209,18,644,49525756,271288924,320814680,152,631,2,221763168,In > Out
Apr 2020,209,204,1399,79385875,2788509649,2867895524,18,1224,120,2709123774,In > Out
Apr 2020,209,205,7,1087094,96008769,97095863,2,7,1,94921675,In > Out
Apr 2020,209,214,30,4955939,69334604,74290543,6,21,12,64378665,In > Out
Apr 2020,209,65,1,298597,10308822,10607419,1,1,1,10010225,In > Out
Apr 2020,21,167,9,707142,14950195,15657337,6,9,2,14243053,In > Out
Apr 2020,21,185,7,926026,60142942,61068968,5,7,1,59216916,In > Out
Apr 2020,21,190,131,23972752,681995058,705967810,42,130,2,658022306,In > Out
Apr 2020,21,212,7,794363,211628,1005991,2,7,1,582735,Out > In
Apr 2020,21,214,5,84364,498817,583181,4,5,2,414453,In > Out
Apr 2020,21,216,3,47372,1678563,1725935,1,3,1,1631191,In > Out
Apr 2020,21,234,14,250976,16166288,16417264,7,14,2,15915312,In > Out
Apr 2020,210,12,1679,253050822391,63139134806,316189957197,1029,1,1582,189911687585,Out > In
Apr 2020,210,4,541,59055000018,16580170270,75635170288,336,1,532,42474829748,Out > In
Apr 2020,212,31,198,8860649882,430778808,9291428690,103,1,197,8429871074,Out > In
Apr 2020,213,1,37131,13640472958,269910358228,283550831186,4247,18315,222,256269885270,In > Out
Apr 2020,213,10,76485,16896581025,680788587385,697685168410,4348,22086,827,663892006360,In > Out
Apr 2020,213,100,35049,16449963177,199297388723,215747351900,3713,16930,203,182847425546,In > Out
Apr 2020,213,101,26624,8679718841,102900009442,111579728283,3442,16227,352,94220290601,In > Out
Apr 2020,213,102,41882,20943676746,411194700357,432138377103,4567,17641,1038,390251023611,In > Out
Apr 2020,213,103,25995,9893608308,124373027414,134266635722,3400,14649,89,114479419106,In > Out
Apr 2020,213,104,35815,25520485719,233583237707,259103723426,5140,19350,675,208062751988,In > Out
Apr 2020,213,105,29263,14841371401,215669866395,230511237796,3551,16391,198,200828494994,In > Out
Apr 2020,213,106,28452,10055915988,110202243467,120258159455,2843,15544,172,100146327479,In > Out
Apr 2020,213,107,24817,18432345362,196951340549,215383685911,3646,14024,330,178518995187,In > Out
Apr 2020,213,108,36615,12367869167,126979866140,139347735307,3449,15869,89,114611996973,In > Out
Apr 2020,213,109,25891,7415739473,112771788776,120187528249,3517,15651,140,105356049303,In > Out
Apr 2020,213,11,32912,45005201283,144901778544,189906979827,4111,16049,173,99896577261,In > Out
Apr 2020,213,110,16909,12679376578,87197987990,99877364568,2786,11792,136,74518611412,In > Out
Apr 2020,213,111,31897,9842309592,210495747155,220338056747,3279,16228,187,200653437563,In > Out
Apr 2020,213,112,26153,8950057101,134489164184,143439221285,3326,14304,76,125539107083,In > Out
Apr 2020,213,113,30558,18948065785,151787319820,170735385605,3643,15159,107,132839254035,In > Out
Apr 2020,213,114,50926,36783298846,270635231610,307418530456,5270,18853,700,233851932764,In > Out
Apr 2020,213,115,22254,16929801253,290312741947,307242543200,3477,14216,559,273382940694,In > Out
Apr 2020,213,116,19757,12057514113,202392935149,214450449262,2898,14010,154,190335421036,In > Out
Apr 2020,213,117,33727,19352833002,190247051354,209599884356,4451,17903,763,170894218352,In > Out
Apr 2020,213,118,33550,15587254835,237170284349,252757539184,3660,16675,369,221583029514,In > Out
Apr 2020,213,119,36929,21555328364,198176130330,219731458694,4343,18466,843,176620801966,In > Out
Apr 2020,213,12,21390,7680027129,152353198553,160033225682,3086,13607,408,144673171424,In > Out
Apr 2020,213,120,34276,59339155486,165946030184,225285185670,3813,16917,208,106606874698,In > Out
Apr 2020,213,121,23053,18208124888,86659725412,104867850300,3130,13529,86,68451600524,In > Out
Apr 2020,213,122,42382,30113764636,200128463551,230242228187,5917,20128,2613,170014698915,In > Out
Apr 2020,213,123,37337,12832563460,222281834060,235114397520,3928,17715,415,209449270600,In > Out
Apr 2020,213,124,25450,8687634911,165113121391,173800756302,3425,13484,214,156425486480,In > Out
Apr 2020,213,125,27717,10997389135,207787567383,218784956518,3210,14562,143,196790178248,In > Out
Apr 2020,213,126,35640,14105109736,242050645551,256155755287,3907,18008,115,227945535815,In > Out
Apr 2020,213,127,35514,11398200686,151377430780,162775631466,5245,16502,1953,139979230094,In > Out
Apr 2020,213,128,26408,9135362305,145507032635,154642394940,3275,15146,205,136371670330,In > Out
Apr 2020,213,129,21301,8925184371,253743376142,262668560513,2942,12917,135,244818191771,In > Out
Apr 2020,213,13,36137,112216132929,171443585354,283659718283,3896,17628,186,59227452425,In > Out
Apr 2020,213,130,26784,18078834456,150955589767,169034424223,3196,14342,129,132876755311,In > Out
Apr 2020,213,131,22113,17554196233,217897538501,235451734734,3220,12864,190,200343342268,In > Out
Apr 2020,213,132,41488,86395103250,240925980617,327321083867,4739,18027,479,154530877367,In > Out
Apr 2020,213,133,36531,18786502266,256857397549,275643899815,4571,17673,598,238070895283,In > Out
Apr 2020,213,134,23047,29314514735,109968180225,139282694960,3460,14607,188,80653665490,In > Out
Apr 2020,213,135,28808,23605003129,148781578955,172386582084,3625,17144,120,125176575826,In > Out
Apr 2020,213,136,26978,11834880521,109966665667,121801546188,4251,15916,1046,98131785146,In > Out
Apr 2020,213,137,35022,13968661848,178305590287,192274252135,3589,16770,135,164336928439,In > Out
Apr 2020,213,138,25582,12418270151,135312293302,147730563453,3582,15248,141,122894023151,In > Out
Apr 2020,213,139,29463,14153095812,156993510131,171146605943,3404,16803,153,142840414319,In > Out
Apr 2020,213,14,31206,8547657510,178914748765,187462406275,3653,16736,394,170367091255,In > Out
Apr 2020,213,140,36945,12363589088,145428576536,157792165624,3829,16722,305,133064987448,In > Out
Apr 2020,213,141,26707,12791356039,131839133884,144630489923,3018,15706,301,119047777845,In > Out
Apr 2020,213,142,23946,29557096392,227108922257,256666018649,3148,14463,216,197551825865,In > Out
Apr 2020,213,143,26621,10029923121,150026032256,160055955377,3803,16527,322,139996109135,In > Out
Apr 2020,213,144,26467,13385614326,123517857009,136903471335,2963,14871,145,110132242683,In > Out
Apr 2020,213,145,29193,11398248253,225063433024,236461681277,3392,16672,209,213665184771,In > Out
Apr 2020,213,146,27689,23796426189,292280429703,316076855892,3427,16257,176,268484003514,In > Out
Apr 2020,213,147,31329,19113343405,140021424164,159134767569,4012,16687,422,120908080759,In > Out
Apr 2020,213,148,33735,15687031867,161238937018,176925968885,4078,15699,522,145551905151,In > Out
Apr 2020,213,149,27746,13048276500,117328923794,130377200294,3111,16253,146,104280647294,In > Out
Apr 2020,213,15,61067,16671787345,256951950134,273623737479,5330,18990,1937,240280162789,In > Out
Apr 2020,213,150,29408,20778770797,124572625433,145351396230,3742,16348,263,103793854636,In > Out
Apr 2020,213,151,19846,10384926203,80441423994,90826350197,2546,12711,174,70056497791,In > Out
Apr 2020,213,152,26633,8256972633,131012810307,139269782940,3825,15032,565,122755837674,In > Out
Apr 2020,213,153,29583,16166863496,162773419729,178940283225,3684,15726,107,146606556233,In > Out
Apr 2020,213,154,33057,9850401577,199192224878,209042626455,4272,17162,734,189341823301,In > Out
Apr 2020,213,155,15833,16315581178,141145127476,157460708654,2424,11011,151,124829546298,In > Out
Apr 2020,213,156,24455,21612599933,155421572023,177034171956,2856,13995,56,133808972090,In > Out
Apr 2020,213,157,32520,10740319678,155952259203,166692578881,5200,16337,1702,145211939525,In > Out
Apr 2020,213,158,34729,9123455486,169914619716,179038075202,3521,19391,166,160791164230,In > Out
Apr 2020,213,159,25868,10722370327,148905634605,159628004932,3286,16185,87,138183264278,In > Out
Apr 2020,213,16,32042,27876287587,904505733449,932382021036,3614,16961,533,876629445862,In > Out
Apr 2020,213,160,31842,12660032711,126195821583,138855854294,3615,17169,80,113535788872,In > Out
Apr 2020,213,161,22957,35853899661,115759508089,151613407750,3039,13872,125,79905608428,In > Out
Apr 2020,213,162,20926,10214930170,78485350025,88700280195,2881,13553,78,68270419855,In > Out
Apr 2020,213,163,25203,11944435554,131224796612,143169232166,3374,13963,141,119280361058,In > Out
Apr 2020,213,164,18253,6615590671,95948379137,102563969808,2848,12122,107,89332788466,In > Out
Apr 2020,213,165,23796,14002999541,220612498044,234615497585,3209,14175,167,206609498503,In > Out
Apr 2020,213,166,20498,14206448835,103816432421,118022881256,2941,13028,251,89609983586,In > Out
Apr 2020,213,167,40589,15346691620,153218377978,168565069598,3975,17581,192,137871686358,In > Out
Apr 2020,213,168,27647,16820051712,150435908642,167255960354,3545,15412,88,133615856930,In > Out
Apr 2020,213,169,22355,15814297618,237814731882,253629029500,3061,13955,164,222000434264,In > Out
Apr 2020,213,17,29669,9751466865,155115007420,164866474285,3836,18254,608,145363540555,In > Out
Apr 2020,213,170,17703,10452351771,84545967703,94998319474,2592,11800,86,74093615932,In > Out
Apr 2020,213,171,17076,4987229734,69293489354,74280719088,2656,11264,122,64306259620,In > Out
Apr 2020,213,172,20496,6529510822,110361109737,116890620559,3255,12952,420,103831598915,In > Out
Apr 2020,213,173,29829,25843972798,145072356291,170916329089,3403,15523,121,119228383493,In > Out
Apr 2020,213,174,19310,9679706430,157562818481,167242524911,2690,12541,103,147883112051,In > Out
Apr 2020,213,175,13426,9940892566,73998054834,83938947400,2595,9902,167,64057162268,In > Out
Apr 2020,213,176,28488,12638227609,197449963234,210088190843,3011,16071,91,184811735625,In > Out
Apr 2020,213,177,16776,4984427468,77669886253,82654313721,2549,11479,164,72685458785,In > Out
Apr 2020,213,178,23677,5299144317,162689013488,167988157805,3002,13873,104,157389869171,In > Out
Apr 2020,213,179,28412,8383197429,175629176345,184012373774,3273,14588,362,167245978916,In > Out
Apr 2020,213,18,36581,16159981192,245520242255,261680223447,3907,19593,229,229360261063,In > Out
Apr 2020,213,180,17588,6939500622,74798464738,81737965360,2614,12640,100,67858964116,In > Out
Apr 2020,213,181,23234,19793924063,94686464872,114480388935,3714,14237,1120,74892540809,In > Out
Apr 2020,213,182,11693,7115074948,56468727372,63583802320,1871,8948,56,49353652424,In > Out
Apr 2020,213,183,12255,3943923180,78131821902,82075745082,1894,9389,52,74187898722,In > Out
Apr 2020,213,184,28490,8889886188,175872063444,184761949632,3264,16680,199,166982177256,In > Out
Apr 2020,213,185,19924,11631888033,75154920373,86786808406,2626,12632,111,63523032340,In > Out
Apr 2020,213,186,10062,3405704767,54585723949,57991428716,1813,8208,43,51180019182,In > Out
Apr 2020,213,187,16577,7993696805,77834163588,85827860393,2989,12011,572,69840466783,In > Out
Apr 2020,213,188,15319,8835078749,61893408652,70728487401,2200,10627,60,53058329903,In > Out
Apr 2020,213,189,21302,3722105252,110954766539,114676871791,2970,13895,602,107232661287,In > Out
Apr 2020,213,19,33416,14284374032,184088758486,198373132518,4154,18171,1288,169804384454,In > Out
Apr 2020,213,190,18848,8778080990,129591104814,138369185804,2883,12814,58,120813023824,In > Out
Apr 2020,213,191,17859,11866016842,229979343676,241845360518,1796,11833,212,218113326834,In > Out
Apr 2020,213,192,12778,4301877793,55763624904,60065502697,2150,9876,74,51461747111,In > Out
Apr 2020,213,193,22534,4773773843,172637666383,177411440226,1932,15449,57,167863892540,In > Out
Apr 2020,213,194,10756,4129780126,81632126995,85761907121,1974,8213,96,77502346869,In > Out
Apr 2020,213,195,12303,6210150233,63192588616,69402738849,1735,9270,51,56982438383,In > Out
Apr 2020,213,196,11000,9263613055,50237681989,59501295044,2087,8871,31,40974068934,In > Out
Apr 2020,213,197,7049,19497261921,28477393893,47974655814,1398,5976,46,8980131972,In > Out
Apr 2020,213,198,11070,2510289095,56371248542,58881537637,1931,8852,81,53860959447,In > Out
Apr 2020,213,199,29200,8008479357,81858685460,89867164817,2448,14230,62,73850206103,In > Out
Apr 2020,213,2,39691,17549035357,176361185792,193910221149,4139,18977,132,158812150435,In > Out
Apr 2020,213,20,25716,11487932235,116108292034,127596224269,3030,15002,167,104620359799,In > Out
Apr 2020,213,200,17572,5600400307,80727524155,86327924462,2481,11404,71,75127123848,In > Out
Apr 2020,213,201,9843,3516986172,43057577533,46574563705,1371,7816,39,39540591361,In > Out
Apr 2020,213,202,35216,10098596571,248637425447,258736022018,3097,17355,112,238538828876,In > Out
Apr 2020,213,203,9551,3440372917,54835414549,58275787466,1776,7532,37,51395041632,In > Out
Apr 2020,213,204,10193,4951345452,44742057313,49693402765,1525,8591,97,39790711861,In > Out
Apr 2020,213,205,16939,7243078949,97633801998,104876880947,2622,12358,277,90390723049,In > Out
Apr 2020,213,206,10356,6506359228,122931282129,129437641357,1764,8227,72,116424922901,In > Out
Apr 2020,213,207,11935,3197144267,68328897912,71526042179,1672,9488,47,65131753645,In > Out
Apr 2020,213,208,20411,4602183180,67870989833,72473173013,1986,12224,50,63268806653,In > Out
Apr 2020,213,209,35842,7921801420,261182271093,269104072513,3733,16666,257,253260469673,In > Out
Apr 2020,213,21,31411,15417688224,212441976027,227859664251,3471,15836,162,197024287803,In > Out
Apr 2020,213,210,16249,10171584072,121092680228,131264264300,2486,10900,55,110921096156,In > Out
Apr 2020,213,211,11888,9686078636,47343627744,57029706380,1607,9108,37,37657549108,In > Out
Apr 2020,213,212,12189,4966335262,42815913455,47782248717,1755,9886,49,37849578193,In > Out
Apr 2020,213,213,12155,5039698097,100329935674,105369633771,2148,9097,119,95290237577,In > Out
Apr 2020,213,214,21203,10043311168,106301164972,116344476140,3030,12964,97,96257853804,In > Out
Apr 2020,213,215,11456,9113306598,48903353415,58016660013,1938,8755,58,39790046817,In > Out
Apr 2020,213,216,15109,7399147204,88976173666,96375320870,2305,10563,143,81577026462,In > Out
Apr 2020,213,217,13225,2769508189,73949951094,76719459283,1930,10347,86,71180442905,In > Out
Apr 2020,213,218,30937,26660793019,151279901042,177940694061,3851,15923,686,124619108023,In > Out
Apr 2020,213,219,14597,3782357891,67472722057,71255079948,2086,10016,47,63690364166,In > Out
Apr 2020,213,22,33516,11575039801,264419604178,275994643979,3942,16924,208,252844564377,In > Out
Apr 2020,213,220,13282,4098180300,64479792406,68577972706,2569,9852,409,60381612106,In > Out
Apr 2020,213,221,23684,15469901883,160655620033,176125521916,3188,14789,109,145185718150,In > Out
Apr 2020,213,222,24210,61374267694,167476332596,228850600290,3294,14090,135,106102064902,In > Out
Apr 2020,213,223,21133,6180966056,103537592802,109718558858,2611,13364,185,97356626746,In > Out
Apr 2020,213,224,43961,8039776194,301242177110,309281953304,2370,17052,69,293202400916,In > Out
Apr 2020,213,225,12672,5653053148,85997320257,91650373405,1925,9550,144,80344267109,In > Out
Apr 2020,213,226,17181,8635417508,230295896190,238931313698,2265,12264,80,221660478682,In > Out
Apr 2020,213,227,18538,7412379112,125469614212,132881993324,2176,13408,100,118057235100,In > Out
Apr 2020,213,228,21142,88188974405,130168102582,218357076987,2646,13499,98,41979128177,In > Out
Apr 2020,213,229,9357,4915786994,38436994176,43352781170,1891,7716,49,33521207182,In > Out
Apr 2020,213,23,45271,18520807618,264127982435,282648790053,4502,20254,207,245607174817,In > Out
Apr 2020,213,230,22571,20072092596,101691018179,121763110775,2495,13451,56,81618925583,In > Out
Apr 2020,213,231,24513,37800882563,142359276943,180160159506,2680,14949,74,104558394380,In > Out
Apr 2020,213,232,32420,26532522861,161119563121,187652085982,3377,15241,86,134587040260,In > Out
Apr 2020,213,233,31180,12431068752,205567623081,217998691833,2965,17041,87,193136554329,In > Out
Apr 2020,213,234,24284,17174707569,265755932689,282930640258,3084,15306,415,248581225120,In > Out
Apr 2020,213,235,17132,3673236115,76211089114,79884325229,2391,12216,278,72537852999,In > Out
Apr 2020,213,236,26182,5679877136,147700280630,153380157766,2598,15004,127,142020403494,In > Out
Apr 2020,213,237,32550,14270804796,723513307460,737784112256,3155,15548,98,709242502664,In > Out
Apr 2020,213,238,21385,21248117996,121495936102,142744054098,2925,13298,177,100247818106,In > Out
Apr 2020,213,239,83838,16057448783,277973961871,294031410654,2412,19857,109,261916513088,In > Out
Apr 2020,213,24,26652,12274753056,118959400941,131234153997,3448,15913,249,106684647885,In > Out
Apr 2020,213,240,31441,13264264326,155734073102,168998337428,3643,16484,161,142469808776,In > Out
Apr 2020,213,241,19521,6803292067,68440384704,75243676771,2538,12332,115,61637092637,In > Out
Apr 2020,213,242,15137,10938627627,71044265481,81982893108,2204,10665,74,60105637854,In > Out
Apr 2020,213,243,42945,15451722515,420363544883,435815267398,3850,18416,461,404911822368,In > Out
Apr 2020,213,244,14684,7859650846,87591408519,95451059365,2103,10765,43,79731757673,In > Out
Apr 2020,213,245,22695,8440956059,98832481738,107273437797,3035,14368,281,90391525679,In > Out
Apr 2020,213,246,23990,10277226298,124074810602,134352036900,3316,15650,378,113797584304,In > Out
Apr 2020,213,247,24940,20144502801,142679723665,162824226466,3563,15297,514,122535220864,In > Out
Apr 2020,213,248,14290,5181323222,77679076734,82860399956,2288,10362,131,72497753512,In > Out
Apr 2020,213,249,27769,16625985895,208332466647,224958452542,3263,14013,378,191706480752,In > Out
Apr 2020,213,25,33991,36672554189,598174736038,634847290227,3990,18565,102,561502181849,In > Out
Apr 2020,213,250,22666,9753891001,114941901942,124695792943,3081,13899,383,105188010941,In > Out
Apr 2020,213,251,21584,9216287925,166621879861,175838167786,2925,13974,115,157405591936,In > Out
Apr 2020,213,252,22875,14735546211,134447361915,149182908126,2867,13645,74,119711815704,In > Out
Apr 2020,213,253,25949,22591016126,128485933146,151076949272,2988,15102,110,105894917020,In > Out
Apr 2020,213,254,27781,10796750692,156689282682,167486033374,2975,15065,112,145892531990,In > Out
Apr 2020,213,26,21472,9084687710,101398616085,110483303795,2963,12988,158,92313928375,In > Out
Apr 2020,213,27,30159,17302288348,142731745900,160034034248,3412,16157,178,125429457552,In > Out
Apr 2020,213,28,35842,31776409686,151348311427,183124721113,3881,18860,317,119571901741,In > Out
Apr 2020,213,29,27528,56532975871,141663841702,198196817573,3049,15268,130,85130865831,In > Out
Apr 2020,213,3,46230,14157796244,317483432958,331641229202,3510,18751,295,303325636714,In > Out
Apr 2020,213,30,109647,31105963681,248067445303,279173408984,4568,20318,154,216961481622,In > Out
Apr 2020,213,31,24100,18423194231,298353638259,316776832490,3170,14564,99,279930444028,In > Out
Apr 2020,213,32,35362,13394804866,193102425526,206497230392,4578,20970,951,179707620660,In > Out
Apr 2020,213,33,38289,19512375501,171870407506,191382783007,4227,17876,361,152358032005,In > Out
Apr 2020,213,34,34579,14366063740,269320406074,283686469814,4621,17722,1308,254954342334,In > Out
Apr 2020,213,35,35662,13586477793,207386219672,220972697465,4110,16057,153,193799741879,In > Out
Apr 2020,213,36,25883,7736859792,120059057509,127795917301,4288,13788,1204,112322197717,In > Out
Apr 2020,213,37,29089,8504920482,138227155165,146732075647,2990,15959,146,129722234683,In > Out
Apr 2020,213,38,43269,14224966896,220361704548,234586671444,4038,18661,122,206136737652,In > Out
Apr 2020,213,39,32307,34639644662,232835168192,267474812854,3922,18349,205,198195523530,In > Out
Apr 2020,213,4,29422,13959035175,263495077591,277454112766,3694,17246,147,249536042416,In > Out
Apr 2020,213,40,31581,12519630685,185271229061,197790859746,3576,16823,217,172751598376,In > Out
Apr 2020,213,41,25467,8778002547,116919158409,125697160956,3675,14726,115,108141155862,In > Out
Apr 2020,213,42,52839,27305774866,261621750819,288927525685,4983,19281,411,234315975953,In > Out
Apr 2020,213,43,22528,5690956226,108618039438,114308995664,3234,14181,124,102927083212,In > Out
Apr 2020,213,44,29394,15994418505,243428933731,259423352236,3467,16918,190,227434515226,In > Out
Apr 2020,213,45,29607,21594108723,152037083435,173631192158,3812,16692,225,130442974712,In > Out
Apr 2020,213,46,36044,21086974234,164692663563,185779637797,3708,17901,144,143605689329,In > Out
Apr 2020,213,47,44106,31933440264,524088585459,556022025723,4197,16033,348,492155145195,In > Out
Apr 2020,213,48,36625,12636685888,219101634782,231738320670,4180,17877,312,206464948894,In > Out
Apr 2020,213,49,26263,8008725851,114974887743,122983613594,3148,15207,348,106966161892,In > Out
Apr 2020,213,5,24481,12447405969,140197779532,152645185501,2868,13960,153,127750373563,In > Out
Apr 2020,213,50,37103,18028823528,254742781601,272771605129,4233,16951,178,236713958073,In > Out
Apr 2020,213,51,31656,22413066567,212725858588,235138925155,3726,16588,182,190312792021,In > Out
Apr 2020,213,52,26617,14638994042,166108493323,180747487365,3445,15971,155,151469499281,In > Out
Apr 2020,213,53,35154,12189924432,214412338738,226602263170,4267,18939,222,202222414306,In > Out
Apr 2020,213,54,37494,16973612439,186428210982,203401823421,3775,17708,269,169454598543,In > Out
Apr 2020,213,55,29173,11858672265,131016561023,142875233288,4680,16587,1374,119157888758,In > Out
Apr 2020,213,56,33595,15091333985,149435814390,164527148375,3650,16174,211,134344480405,In > Out
Apr 2020,213,57,31735,8779045013,172983718622,181762763635,5425,17746,1774,164204673609,In > Out
Apr 2020,213,58,22883,9475605331,112792233027,122267838358,2901,13517,443,103316627696,In > Out
Apr 2020,213,59,26606,38922635752,121214131960,160136767712,3321,15619,235,82291496208,In > Out
Apr 2020,213,6,27814,8314077159,178747113599,187061190758,2931,15559,66,170433036440,In > Out
Apr 2020,213,60,43075,17804924784,348465998811,366270923595,5784,19849,959,330661074027,In > Out
Apr 2020,213,61,25409,6553080027,134811046834,141364126861,3108,15551,185,128257966807,In > Out
Apr 2020,213,62,28108,11233795629,145499544489,156733340118,3668,15996,126,134265748860,In > Out
Apr 2020,213,63,30860,10511792761,198383836028,208895628789,3896,16409,277,187872043267,In > Out
Apr 2020,213,64,39407,17299303173,256740882107,274040185280,4555,17838,499,239441578934,In > Out
Apr 2020,213,65,29145,89659269892,171898251011,261557520903,3305,15516,237,82238981119,In > Out
Apr 2020,213,66,42015,16355641250,336625725228,352981366478,4492,19635,800,320270083978,In > Out
Apr 2020,213,67,31997,12013735885,294564605490,306578341375,3932,19984,182,282550869605,In > Out
Apr 2020,213,68,33259,11731632645,185323114169,197054746814,3951,17703,178,173591481524,In > Out
Apr 2020,213,69,37877,16498115632,252094990430,268593106062,4637,18446,136,235596874798,In > Out
Apr 2020,213,7,23739,7402731743,130092667383,137495399126,3137,14391,126,122689935640,In > Out
Apr 2020,213,70,33797,34039018455,178342443850,212381462305,3446,17518,189,144303425395,In > Out
Apr 2020,213,71,32312,17943687272,187075695576,205019382848,3656,16202,449,169132008304,In > Out
Apr 2020,213,72,26586,7101697009,145077900959,152179597968,3286,15986,75,137976203950,In > Out
Apr 2020,213,73,23638,10558533684,117118579347,127677113031,3116,13947,71,106560045663,In > Out
Apr 2020,213,74,32951,80408589230,155611995199,236020584429,5640,16035,2923,75203405969,In > Out
Apr 2020,213,75,25413,13081272488,151476740838,164558013326,2852,15467,117,138395468350,In > Out
Apr 2020,213,76,23268,9173125217,118614945328,127788070545,2816,13570,61,109441820111,In > Out
Apr 2020,213,77,27803,13530607119,165336892315,178867499434,3668,16037,109,151806285196,In > Out
Apr 2020,213,78,33349,24807415162,321311154420,346118569582,3800,18043,177,296503739258,In > Out
Apr 2020,213,79,30477,13171113829,203567876180,216738990009,4162,16431,110,190396762351,In > Out
Apr 2020,213,8,28760,25064337258,219763056951,244827394209,3842,16153,162,194698719693,In > Out
Apr 2020,213,80,23642,14625407880,153333986302,167959394182,3493,14936,290,138708578422,In > Out
Apr 2020,213,81,20102,6977585638,197992882824,204970468462,2893,13323,106,191015297186,In > Out
Apr 2020,213,82,29571,11333839074,126315732012,137649571086,3800,16147,546,114981892938,In > Out
Apr 2020,213,83,31127,11152205801,198357956212,209510162013,3895,18271,346,187205750411,In > Out
Apr 2020,213,84,32157,19243831703,350965330120,370209161823,3470,16203,110,331721498417,In > Out
Apr 2020,213,85,41230,13478191173,172851187794,186329378967,4859,21500,1230,159372996621,In > Out
Apr 2020,213,86,30991,15811005430,333134961315,348945966745,3056,17824,103,317323955885,In > Out
Apr 2020,213,87,39025,16569644763,243521848664,260091493427,3797,17973,118,226952203901,In > Out
Apr 2020,213,88,24722,11031779431,97474118533,108505897964,3115,14097,128,86442339102,In > Out
Apr 2020,213,89,34394,17494585504,241159824784,258654410288,4239,17543,144,223665239280,In > Out
Apr 2020,213,9,29311,17091155127,106826019237,123917174364,3322,16033,142,89734864110,In > Out
Apr 2020,213,90,27804,11117824026,155812784413,166930608439,3149,15178,113,144694960387,In > Out
Apr 2020,213,91,25643,13168627448,119369591417,132538218865,3133,15679,135,106200963969,In > Out
Apr 2020,213,92,29812,13853429903,117802818830,131656248733,3445,15895,287,103949388927,In > Out
Apr 2020,213,93,39574,30506278934,654169864925,684676143859,4268,18423,201,623663585991,In > Out
Apr 2020,213,94,25055,15351220545,137353040329,152704260874,3308,15297,430,122001819784,In > Out
Apr 2020,213,95,40374,18138758405,278729277950,296868036355,4546,18072,672,260590519545,In > Out
Apr 2020,213,96,28228,17028971166,146352244509,163381215675,3311,15246,92,129323273343,In > Out
Apr 2020,213,97,101505,23008735065,434040565237,457049300302,3797,18969,230,411031830172,In > Out
Apr 2020,213,98,31989,9181063965,163411018873,172592082838,3422,16909,169,154229954908,In > Out
Apr 2020,213,99,30468,16666977183,137089256497,153756233680,3613,15846,122,120422279314,In > Out
Apr 2020,214,18,104,5348809,199748586,205097395,19,104,2,194399777,In > Out
Apr 2020,214,29,277,22527783,1210363759,1232891542,20,277,2,1187835976,In > Out
Apr 2020,214,92,180,4214980,582246241,586461221,23,178,2,578031261,In > Out
Apr 2020,215,113,1211,12187594934,711489159,12899084093,539,231,748,11476105775,Out > In
Apr 2020,215,114,415,17938296,1071886649,1089824945,22,415,2,1053948353,In > Out
Apr 2020,215,115,749,41473463,1871349542,1912823005,23,734,2,1829876079,In > Out
Apr 2020,215,119,230,12979355,106521035,119500390,60,230,2,93541680,In > Out
Apr 2020,215,157,59,9060835,281496371,290557206,26,59,5,272435536,In > Out
Apr 2020,215,173,397,21423665,83324656,104748321,18,396,2,61900991,In > Out
Apr 2020,215,181,386,20619673,952690236,973309909,31,370,2,932070563,In > Out
Apr 2020,215,190,23,12407633,1067708191,1080115824,13,23,2,1055300558,In > Out
Apr 2020,215,202,222,16764634,83177016,99941650,21,222,2,66412382,In > Out
Apr 2020,215,209,188,13537239,790274727,803811966,28,182,2,776737488,In > Out
Apr 2020,215,212,1,41910,1589217,1631127,1,1,1,1547307,In > Out
Apr 2020,215,215,630,126982894,4486304179,4613287073,232,616,5,4359321285,In > Out
Apr 2020,215,218,222,19515267,1071431980,1090947247,23,221,2,1051916713,In > Out
Apr 2020,215,26,259,24028929,1225681952,1249710881,30,259,2,1201653023,In > Out
Apr 2020,215,38,71,5997825,278663194,284661019,23,71,2,272665369,In > Out
Apr 2020,215,55,239,24221565,1869614399,1893835964,36,239,2,1845392834,In > Out
Apr 2020,215,59,9,273723,15239711,15513434,3,9,1,14965988,In > Out
Apr 2020,215,61,308,25704937,89351759,115056696,17,308,1,63646822,In > Out
Apr 2020,215,67,165,6709711,409983230,416692941,17,165,2,403273519,In > Out
Apr 2020,215,74,63,183783,11898694,12082477,7,63,2,11714911,In > Out
Apr 2020,215,75,198,11749731,674893305,686643036,17,194,2,663143574,In > Out
Apr 2020,215,78,61,14048740,799846332,813895072,48,61,3,785797592,In > Out
Apr 2020,215,79,134,14445661,1005426529,1019872190,26,134,2,990980868,In > Out
Apr 2020,215,85,774,36339788,1692644254,1728984042,43,774,2,1656304466,In > Out
Apr 2020,215,91,192,13917938,815396601,829314539,20,192,2,801478663,In > Out
Apr 2020,215,92,579,67007506,1328426075,1395433581,63,570,3,1261418569,In > Out
Apr 2020,215,94,283,8261793,416446638,424708431,18,282,2,408184845,In > Out
Apr 2020,215,97,471,44153383,1533561567,1577714950,22,461,2,1489408184,In > Out
Apr 2020,22,156,227,12819901,851045149,863865050,41,195,2,838225248,In > Out
Apr 2020,221,116,14,1282662,6627680,7910342,6,14,2,5345018,In > Out
Apr 2020,221,119,161,18848917,2051416184,2070265101,64,161,2,2032567267,In > Out
Apr 2020,221,127,896,200879619,280486790,481366409,25,896,2,79607171,In > Out
Apr 2020,221,128,213,24880718,712406361,737287079,99,213,1,687525643,In > Out
Apr 2020,221,130,148,27187245,1363261687,1390448932,65,148,2,1336074442,In > Out
Apr 2020,221,144,892,134816341,595045486,729861827,77,869,2,460229145,In > Out
Apr 2020,221,145,1,64760,54612,119372,1,1,1,10148,Out > In
Apr 2020,221,146,14,91739,2147256,2238995,5,14,2,2055517,In > Out
Apr 2020,221,15,3,458654,62776,521430,2,1,3,395878,Out > In
Apr 2020,221,153,165,8585852,316369357,324955209,71,165,2,307783505,In > Out
Apr 2020,221,155,286,38251314,541911704,580163018,66,283,3,503660390,In > Out
Apr 2020,221,159,99,14193498,564687956,578881454,35,98,2,550494458,In > Out
Apr 2020,221,160,552,31411391,1388115508,1419526899,28,551,2,1356704117,In > Out
Apr 2020,221,168,1261,1387238581,9461837879,10849076460,353,1217,13,8074599298,In > Out
Apr 2020,221,184,271,74409435,85678944,160088379,20,251,12,11269509,In > Out
Apr 2020,221,186,31,1773763,11144792,12918555,18,31,1,9371029,In > Out
Apr 2020,221,196,3,189668,975242,1164910,3,3,1,785574,In > Out
Apr 2020,221,198,186,283514112,36084684,319598796,132,1,181,247429428,Out > In
Apr 2020,221,200,160,7640674,416941975,424582649,22,160,2,409301301,In > Out
Apr 2020,221,209,20,8040615,272985149,281025764,17,20,1,264944534,In > Out
Apr 2020,221,221,90,13356365,839491728,852848093,35,90,2,826135363,In > Out
Apr 2020,221,222,2,164810,148320,313130,2,2,2,16490,Out > In
Apr 2020,221,24,320,14599508,486922333,501521841,33,320,2,472322825,In > Out
Apr 2020,221,32,224,31049807,2269824970,2300874777,97,224,3,2238775163,In > Out
Apr 2020,221,55,4,602096,186776,788872,3,1,2,415320,Out > In
Apr 2020,221,59,1069,5938927827,413025644626,418964572453,57,1069,2,407086716799,In > Out
Apr 2020,221,61,163,11519964,208673079,220193043,99,161,2,197153115,In > Out
Apr 2020,221,62,3,1395537,226088,1621625,3,1,3,1169449,Out > In
Apr 2020,221,66,191,2382996778,230273351,2613270129,50,121,63,2152723427,Out > In
Apr 2020,221,80,183,20305309,1091503600,1111808909,17,179,2,1071198291,In > Out
Apr 2020,221,82,2237,139309794,1501402492,1640712286,121,2140,2,1362092698,In > Out
Apr 2020,221,83,93,7602612,249970167,257572779,24,93,2,242367555,In > Out
Apr 2020,222,2,1,2382,102870,105252,1,1,1,100488,In > Out
Apr 2020,224,107,106,20873590,931625439,952499029,27,106,2,910751849,In > Out
Apr 2020,224,145,1,32413,1338467,1370880,1,1,1,1306054,In > Out
Apr 2020,224,201,954,67549374,2339681976,2407231350,60,922,3,2272132602,In > Out
Apr 2020,224,203,89,1037583,68465791,69503374,9,89,1,67428208,In > Out
Apr 2020,224,221,1,3273,131163,134436,1,1,1,127890,In > Out
Apr 2020,225,106,47,6799622,232972600,239772222,25,47,2,226172978,In > Out
Apr 2020,225,108,371,26648928,1482715387,1509364315,43,370,2,1456066459,In > Out
Apr 2020,225,111,991,170101016,1268800629,1438901645,145,991,3,1098699613,In > Out
Apr 2020,225,120,95,98249957,10781689,109031646,20,1,91,87468268,Out > In
Apr 2020,225,126,79,8543479,492119548,500663027,25,79,2,483576069,In > Out
Apr 2020,225,142,2262,127346723,1231431504,1358778227,131,2103,2,1104084781,In > Out
Apr 2020,225,152,949,92297633,1079182380,1171480013,164,937,2,986884747,In > Out
Apr 2020,225,168,9763,1472309800,1499594882,2971904682,78,8492,2,27285082,In > Out
Apr 2020,225,169,45,6104334,411962516,418066850,12,45,1,405858182,In > Out
Apr 2020,225,175,10,324300,17032208,17356508,5,10,2,16707908,In > Out
Apr 2020,225,176,100,11457033,496847505,508304538,43,100,2,485390472,In > Out
Apr 2020,225,192,5,106160,5144088,5250248,5,5,1,5037928,In > Out
Apr 2020,225,210,93,1638885,31135256,32774141,18,93,2,29496371,In > Out
Apr 2020,225,218,7,402299,420952,823251,2,7,1,18653,In > Out
Apr 2020,225,232,6,5290255,291314749,296605004,4,6,1,286024494,In > Out
Apr 2020,225,78,5,280137,1000354,1280491,3,5,1,720217,In > Out
Apr 2020,225,8,564,14105100914,1482679792,15587780706,91,533,32,12622421122,Out > In
Apr 2020,225,82,2033,761881314,15481854418,16243735732,107,1919,2,14719973104,In > Out
Apr 2020,225,85,423,52771994,757865312,810637306,53,421,7,705093318,In > Out
Apr 2020,225,86,5,24628875,5009858,29638733,5,5,2,19619017,Out > In
Apr 2020,225,87,12,730027,29845352,30575379,9,12,2,29115325,In > Out
Apr 2020,225,9,51,8853052,472910624,481763676,17,51,1,464057572,In > Out
Apr 2020,225,91,860,86010539,616649456,702659995,69,855,2,530638917,In > Out
Apr 2020,226,99,70,7770342,349022462,356792804,29,70,2,341252120,In > Out
Apr 2020,228,100,25,1299375,17892271,19191646,22,25,1,16592896,In > Out
Apr 2020,228,103,16,6081977,47174890,53256867,7,16,3,41092913,In > Out
Apr 2020,228,104,25,797584,6017400,6814984,11,25,2,5219816,In > Out
Apr 2020,228,105,1519,171156332,8906934805,9078091137,256,1452,17,8735778473,In > Out
Apr 2020,228,107,546,202159656,5404651226,5606810882,192,535,5,5202491570,In > Out
Apr 2020,228,11,549,216724027,21343000324,21559724351,165,549,5,21126276297,In > Out
Apr 2020,228,110,43,3295583,51113140,54408723,21,43,3,47817557,In > Out
Apr 2020,228,113,413,58511427,1758416293,1816927720,114,413,4,1699904866,In > Out
Apr 2020,228,114,45,3425145,239318136,242743281,28,45,3,235892991,In > Out
Apr 2020,228,116,1387,566370840,12627019774,13193390614,315,1366,63,12060648934,In > Out
Apr 2020,228,117,198,24374543,1216171319,1240545862,82,198,4,1191796776,In > Out
Apr 2020,228,119,10,986380,3425963,4412343,6,10,2,2439583,In > Out
Apr 2020,228,12,5,1069766,539900,1609666,3,5,2,529866,Out > In
Apr 2020,228,123,239,86541873,364868771,451410644,74,237,5,278326898,In > Out
Apr 2020,228,124,1470,1209548982,3309377180,4518926162,328,1432,9,2099828198,In > Out
Apr 2020,228,127,391,265201564,4003831158,4269032722,83,389,4,3738629594,In > Out
Apr 2020,228,128,621,274746286,931936878,1206683164,101,618,6,657190592,In > Out
Apr 2020,228,131,173,163632322,98232635,261864957,103,172,3,65399687,Out > In
Apr 2020,228,132,1012,811703559,4533647042,5345350601,204,972,7,3721943483,In > Out
Apr 2020,228,134,271,22488871,860894096,883382967,92,271,1,838405225,In > Out
Apr 2020,228,135,2809,199674582,6350137544,6549812126,297,2610,9,6150462962,In > Out
Apr 2020,228,138,118,80638510,761724152,842362662,36,118,6,681085642,In > Out
Apr 2020,228,14,231,16955762,1105471585,1122427347,83,231,4,1088515823,In > Out
Apr 2020,228,140,52,3456752,83758691,87215443,25,52,2,80301939,In > Out
Apr 2020,228,141,56,3734395,171271514,175005909,34,56,2,167537119,In > Out
Apr 2020,228,142,181,9327233,525951304,535278537,65,170,14,516624071,In > Out
Apr 2020,228,145,61,12765341,126982794,139748135,22,61,3,114217453,In > Out
Apr 2020,228,146,70,4022413,228202706,232225119,35,70,2,224180293,In > Out
Apr 2020,228,149,121,40153546,2392882781,2433036327,63,121,3,2352729235,In > Out
Apr 2020,228,15,186,33938759,1147932548,1181871307,101,186,4,1113993789,In > Out
Apr 2020,228,150,252,139238049,1301256739,1440494788,92,251,4,1162018690,In > Out
Apr 2020,228,151,583,47528201,2065161582,2112689783,158,569,6,2017633381,In > Out
Apr 2020,228,152,459,69816329,2296434325,2366250654,130,455,5,2226617996,In > Out
Apr 2020,228,153,786,426239908,2406012291,2832252199,221,769,13,1979772383,In > Out
Apr 2020,228,154,15,9787834,23036706,32824540,15,15,2,13248872,In > Out
Apr 2020,228,155,63,5120352,22156318,27276670,36,63,3,17035966,In > Out
Apr 2020,228,159,110,7020955,137145282,144166237,56,110,4,130124327,In > Out
Apr 2020,228,16,696,205663918,2359765220,2565429138,192,676,6,2154101302,In > Out
Apr 2020,228,160,265,93527535,2007423213,2100950748,110,265,1,1913895678,In > Out
Apr 2020,228,161,624,124655135,5902788656,6027443791,239,624,7,5778133521,In > Out
Apr 2020,228,164,204,153676841,326654832,480331673,86,200,3,172977991,In > Out
Apr 2020,228,165,44,3134356,33322366,36456722,22,44,2,30188010,In > Out
Apr 2020,228,169,174,22816556,594638967,617455523,62,174,4,571822411,In > Out
Apr 2020,228,171,1384,58302705,4313572287,4371874992,179,1320,7,4255269582,In > Out
Apr 2020,228,175,5655,7211930570,35612579808,42824510378,662,4954,5,28400649238,In > Out
Apr 2020,228,178,445,40452211,497514527,537966738,165,436,15,457062316,In > Out
Apr 2020,228,18,96,12597448,1075124885,1087722333,36,95,4,1062527437,In > Out
Apr 2020,228,180,283,31425445,1278533848,1309959293,126,281,1,1247108403,In > Out
Apr 2020,228,181,106,3918871,37222476,41141347,66,106,3,33303605,In > Out
Apr 2020,228,183,702,12912643,2015279581,2028192224,78,702,2,2002366938,In > Out
Apr 2020,228,184,2,377542,123663,501205,2,2,2,253879,Out > In
Apr 2020,228,187,450,17929532,994036383,1011965915,114,450,2,976106851,In > Out
Apr 2020,228,191,2243,145074636,7880421285,8025495921,313,2098,15,7735346649,In > Out
Apr 2020,228,193,162,19245854,720099355,739345209,88,162,3,700853501,In > Out
Apr 2020,228,194,760,1865530736,2574763239,4440293975,285,699,4,709232503,In > Out
Apr 2020,228,195,230,26790553,844397396,871187949,125,230,11,817606843,In > Out
Apr 2020,228,196,268,26036474,1298046353,1324082827,149,267,4,1272009879,In > Out
Apr 2020,228,198,500,36945609,960317853,997263462,116,497,4,923372244,In > Out
Apr 2020,228,199,188,17363758,656128375,673492133,78,188,4,638764617,In > Out
Apr 2020,228,200,783,277318966,1291943011,1569261977,152,767,9,1014624045,In > Out
Apr 2020,228,201,301,25316030,190203722,215519752,66,296,2,164887692,In > Out
Apr 2020,228,202,3391,594121172,20939111305,21533232477,508,3151,19,20344990133,In > Out
Apr 2020,228,203,1145,458974226,7106918729,7565892955,218,1111,2,6647944503,In > Out
Apr 2020,228,204,325,422715688,838339344,1261055032,131,323,4,415623656,In > Out
Apr 2020,228,206,199,11396806,300106755,311503561,68,195,2,288709949,In > Out
Apr 2020,228,208,167,33640399,1223615256,1257255655,71,167,3,1189974857,In > Out
Apr 2020,228,209,1169,101306432,5426671718,5527978150,187,1149,3,5325365286,In > Out
Apr 2020,228,210,20,822590,25307785,26130375,8,20,1,24485195,In > Out
Apr 2020,228,211,40,5401143,55447623,60848766,27,40,3,50046480,In > Out
Apr 2020,228,212,1027,182260744,7904310662,8086571406,197,1001,10,7722049918,In > Out
Apr 2020,228,214,67,13784979,1210032679,1223817658,35,67,2,1196247700,In > Out
Apr 2020,228,215,98,56063630,791360343,847423973,28,98,2,735296713,In > Out
Apr 2020,228,216,148,16416127,199081222,215497349,72,148,2,182665095,In > Out
Apr 2020,228,217,297,73605308,1179999332,1253604640,57,290,2,1106394024,In > Out
Apr 2020,228,218,190,60705700,764924484,825630184,92,189,5,704218784,In > Out
Apr 2020,228,221,2427,714248274,36815366943,37529615217,499,2307,7,36101118669,In > Out
Apr 2020,228,23,513,144281356,3042416100,3186697456,184,510,6,2898134744,In > Out
Apr 2020,228,24,1417,82203412,3443959268,3526162680,224,1395,3,3361755856,In > Out
Apr 2020,228,27,503,60691797,944553716,1005245513,168,498,24,883861919,In > Out
Apr 2020,228,30,1063,245785218,13657130730,13902915948,324,1026,4,13411345512,In > Out
Apr 2020,228,31,6,341746,16409213,16750959,5,6,1,16067467,In > Out
Apr 2020,228,32,205,10499344,407832658,418332002,44,205,3,397333314,In > Out
Apr 2020,228,35,658,110848752,1726981521,1837830273,311,567,101,1616132769,In > Out
Apr 2020,228,36,121,16051992,902401088,918453080,53,121,4,886349096,In > Out
Apr 2020,228,37,1637,1422846348,8346253299,9769099647,225,1555,7,6923406951,In > Out
Apr 2020,228,38,298,9326206,717317436,726643642,37,298,1,707991230,In > Out
Apr 2020,228,39,68,4618058,159066627,163684685,30,68,3,154448569,In > Out
Apr 2020,228,4,35,45398243,4227486741,4272884984,15,35,3,4182088498,In > Out
Apr 2020,228,41,758,341285831,11713460503,12054746334,258,748,10,11372174672,In > Out
Apr 2020,228,42,1174,494470992,2996639476,3491110468,287,1141,7,2502168484,In > Out
Apr 2020,228,43,227,80845007,863285385,944130392,30,227,5,782440378,In > Out
Apr 2020,228,44,1766,136239461,4732747723,4868987184,167,1698,8,4596508262,In > Out
Apr 2020,228,45,463,278895083,1903651719,2182546802,147,462,8,1624756636,In > Out
Apr 2020,228,46,697,61467582,4607115397,4668582979,180,682,3,4545647815,In > Out
Apr 2020,228,47,25,8055989,46391994,54447983,13,25,5,38336005,In > Out
Apr 2020,228,48,437,84569528,2300059120,2384628648,128,431,7,2215489592,In > Out
Apr 2020,228,5,9,746583,2014588,2761171,9,9,3,1268005,In > Out
Apr 2020,228,51,222,50711429,3056338420,3107049849,132,222,4,3005626991,In > Out
Apr 2020,228,52,145,18926870,1040081689,1059008559,63,145,2,1021154819,In > Out
Apr 2020,228,53,1136,170947185,3070254007,3241201192,383,1119,4,2899306822,In > Out
Apr 2020,228,55,561,165287920,1484370052,1649657972,213,543,5,1319082132,In > Out
Apr 2020,228,57,156,15684584,1220657347,1236341931,82,156,2,1204972763,In > Out
Apr 2020,228,58,963,460481009,12928294283,13388775292,320,953,22,12467813274,In > Out
Apr 2020,228,61,136,13163347754,461418939,13624766693,78,136,4,12701928815,Out > In
Apr 2020,228,62,36,2867845,25249994,28117839,23,36,3,22382149,In > Out
Apr 2020,228,63,54,5407666,644732458,650140124,26,54,3,639324792,In > Out
Apr 2020,228,65,11,1275048,11668969,12944017,8,11,4,10393921,In > Out
Apr 2020,228,67,116,8310601,484778382,493088983,38,116,2,476467781,In > Out
Apr 2020,228,68,38,4182726,66428458,70611184,13,38,3,62245732,In > Out
Apr 2020,228,70,2364,41350247,3235221059,3276571306,108,2353,2,3193870812,In > Out
Apr 2020,228,71,469,1039650266,1758635057,2798285323,241,465,6,718984791,In > Out
Apr 2020,228,72,84,8308217,422104297,430412514,43,84,2,413796080,In > Out
Apr 2020,228,74,392,96167366,1901632783,1997800149,98,391,8,1805465417,In > Out
Apr 2020,228,79,3124,838041818,8799705684,9637747502,337,2916,3,7961663866,In > Out
Apr 2020,228,8,261,28985968,905618678,934604646,88,255,1,876632710,In > Out
Apr 2020,228,81,659,451894486,4484220176,4936114662,150,644,12,4032325690,In > Out
Apr 2020,228,82,482,32114013,1468645382,1500759395,99,479,4,1436531369,In > Out
Apr 2020,228,85,137,45792747,277061023,322853770,70,137,13,231268276,In > Out
Apr 2020,228,9,463,24833731,834941733,859775464,77,461,4,810108002,In > Out
Apr 2020,228,92,3367,593273148,57104796723,57698069871,474,3216,4,56511523575,In > Out
Apr 2020,228,95,3073,2263450951,8381791647,10645242598,516,2885,37,6118340696,In > Out
Apr 2020,228,97,1367,636703902,7567046875,8203750777,312,1190,59,6930342973,In > Out
Apr 2020,228,98,4,1217819,6065364,7283183,4,4,2,4847545,In > Out
Apr 2020,229,103,21,9820843,22109378,31930221,11,21,3,12288535,In > Out
Apr 2020,229,104,130,14603622,753724891,768328513,78,130,2,739121269,In > Out
Apr 2020,229,107,1681,668946525,4971110867,5640057392,324,1601,5,4302164342,In > Out
Apr 2020,229,108,22,1151231,7900378,9051609,12,22,2,6749147,In > Out
Apr 2020,229,109,1685,119584267,3349546025,3469130292,271,1587,15,3229961758,In > Out
Apr 2020,229,11,3,423645,323966,747611,2,3,1,99679,Out > In
Apr 2020,229,110,297,214027883,428670372,642698255,85,293,4,214642489,In > Out
Apr 2020,229,111,688,97978977,2366912421,2464891398,115,686,22,2268933444,In > Out
Apr 2020,229,115,449,177169993,1709281309,1886451302,174,446,5,1532111316,In > Out
Apr 2020,229,118,4453,2602439235,18425798208,21028237443,232,4399,14,15823358973,In > Out
Apr 2020,229,119,6,288284,396231,684515,6,6,1,107947,In > Out
Apr 2020,229,120,175,11083583,203274214,214357797,89,175,3,192190631,In > Out
Apr 2020,229,122,137,42173071,5755178557,5797351628,45,137,2,5713005486,In > Out
Apr 2020,229,123,380,67796959,1251241275,1319038234,144,373,4,1183444316,In > Out
Apr 2020,229,124,2744,680543885,3618521162,4299065047,250,2744,4,2937977277,In > Out
Apr 2020,229,125,338,320159336,2097315326,2417474662,148,323,22,1777155990,In > Out
Apr 2020,229,126,73,5130387,97467118,102597505,29,73,2,92336731,In > Out
Apr 2020,229,127,724,341792249,1765682646,2107474895,141,694,7,1423890397,In > Out
Apr 2020,229,128,75,992327,43831122,44823449,21,75,2,42838795,In > Out
Apr 2020,229,129,5607,1000874723,19044247117,20045121840,368,4819,93,18043372394,In > Out
Apr 2020,229,130,857,251578545,2549052509,2800631054,172,840,5,2297473964,In > Out
Apr 2020,229,132,2351,203395533,6893923739,7097319272,249,2172,11,6690528206,In > Out
Apr 2020,229,133,439,76638847,904200730,980839577,141,438,8,827561883,In > Out
Apr 2020,229,134,1083,225065205,2657078282,2882143487,172,1044,3,2432013077,In > Out
Apr 2020,229,135,421,78712586,2585159204,2663871790,145,418,3,2506446618,In > Out
Apr 2020,229,136,821,465666037,10025622944,10491288981,279,799,22,9559956907,In > Out
Apr 2020,229,137,561,145662392,745506052,891168444,147,551,8,599843660,In > Out
Apr 2020,229,138,443,188387970,7694013351,7882401321,161,440,5,7505625381,In > Out
Apr 2020,229,139,714,289557898,18031854853,18321412751,306,714,2,17742296955,In > Out
Apr 2020,229,14,349,91354898,1276372235,1367727133,75,348,2,1185017337,In > Out
Apr 2020,229,142,271,45175033,2757718493,2802893526,115,271,3,2712543460,In > Out
Apr 2020,229,143,61,5929379,133775897,139705276,12,61,4,127846518,In > Out
Apr 2020,229,144,910,144596439,3848540450,3993136889,303,896,5,3703944011,In > Out
Apr 2020,229,145,1209,219611129,5805762239,6025373368,248,1181,3,5586151110,In > Out
Apr 2020,229,146,20,1258411,112157684,113416095,9,20,1,110899273,In > Out
Apr 2020,229,147,51,3724338,9367171,13091509,31,51,2,5642833,In > Out
Apr 2020,229,148,339,40525074,888752569,929277643,142,339,4,848227495,In > Out
Apr 2020,229,149,287,39920857,301084173,341005030,117,285,4,261163316,In > Out
Apr 2020,229,15,77,42010330,3280820411,3322830741,38,77,2,3238810081,In > Out
Apr 2020,229,150,1930,799969718,5068301716,5868271434,457,1869,26,4268331998,In > Out
Apr 2020,229,151,530,243637203,11792524978,12036162181,155,525,13,11548887775,In > Out
Apr 2020,229,153,1062,514541025,5971602470,6486143495,149,1015,12,5457061445,In > Out
Apr 2020,229,154,805,646020213,14683890336,15329910549,149,783,16,14037870123,In > Out
Apr 2020,229,155,91,2982693,44896743,47879436,25,91,4,41914050,In > Out
Apr 2020,229,156,99,12450560,383647857,396098417,25,97,3,371197297,In > Out
Apr 2020,229,157,80,15000421,388946722,403947143,47,80,4,373946301,In > Out
Apr 2020,229,158,143,13611728,2014888348,2028500076,55,143,2,2001276620,In > Out
Apr 2020,229,159,1825,656720851,35676564504,36333285355,293,1720,4,35019843653,In > Out
Apr 2020,229,160,326,41457877,655140881,696598758,93,325,4,613683004,In > Out
Apr 2020,229,168,241,34333435,1766657928,1800991363,72,241,2,1732324493,In > Out
Apr 2020,229,170,392,47210640,1634418993,1681629633,129,374,11,1587208353,In > Out
Apr 2020,229,171,146,12684522,318617829,331302351,61,146,4,305933307,In > Out
Apr 2020,229,174,3035,1563438865,105861210147,107424649012,516,2847,7,104297771282,In > Out
Apr 2020,229,175,209,31797522,889062778,920860300,84,209,3,857265256,In > Out
Apr 2020,229,177,249,36855227,491817177,528672404,84,247,5,454961950,In > Out
Apr 2020,229,178,540,57841105,1939321535,1997162640,153,540,3,1881480430,In > Out
Apr 2020,229,18,1297,714169663,9505782399,10219952062,169,1247,16,8791612736,In > Out
Apr 2020,229,180,13,177504,2919577,3097081,8,13,1,2742073,In > Out
Apr 2020,229,181,429,22461729,532566674,555028403,96,429,2,510104945,In > Out
Apr 2020,229,182,93,30241309,3396104103,3426345412,47,93,2,3365862794,In > Out
Apr 2020,229,184,362,17261848,645539841,662801689,33,362,4,628277993,In > Out
Apr 2020,229,186,10,6097236,8776085,14873321,6,10,2,2678849,In > Out
Apr 2020,229,189,788,450357024,14876737065,15327094089,243,770,20,14426380041,In > Out
Apr 2020,229,190,86,6161090,163783213,169944303,26,86,2,157622123,In > Out
Apr 2020,229,191,1333,42671597,7635018866,7677690463,154,1333,3,7592347269,In > Out
Apr 2020,229,193,547,774569072,1585474945,2360044017,201,534,19,810905873,In > Out
Apr 2020,229,194,130,16223749,594714918,610938667,35,129,3,578491169,In > Out
Apr 2020,229,195,12,676095,6744561,7420656,12,12,3,6068466,In > Out
Apr 2020,229,199,138,10518368,217416233,227934601,55,138,5,206897865,In > Out
Apr 2020,229,20,504,62556555,2585310939,2647867494,209,504,4,2522754384,In > Out
Apr 2020,229,200,78,7069131,274067017,281136148,30,78,5,266997886,In > Out
Apr 2020,229,203,179,243480272,1252442492,1495922764,84,176,3,1008962220,In > Out
Apr 2020,229,208,95,82543675,252501163,335044838,63,95,4,169957488,In > Out
Apr 2020,229,209,692,131701899,4580884193,4712586092,110,688,5,4449182294,In > Out
Apr 2020,229,210,123,14587372,361469471,376056843,81,123,2,346882099,In > Out
Apr 2020,229,211,627,987082210,4164134223,5151216433,234,625,28,3177052013,In > Out
Apr 2020,229,212,532,1190506436,930528139,2121034575,158,524,6,259978297,Out > In
Apr 2020,229,213,468,31330517,333459658,364790175,168,467,2,302129141,In > Out
Apr 2020,229,214,131,176049911,781974541,958024452,55,131,2,605924630,In > Out
Apr 2020,229,215,246,17769364,424034179,441803543,79,246,2,406264815,In > Out
Apr 2020,229,216,163,130283282,441338439,571621721,40,163,3,311055157,In > Out
Apr 2020,229,217,29,1855551,46243818,48099369,20,29,1,44388267,In > Out
Apr 2020,229,218,250,290786617,1102219049,1393005666,51,249,8,811432432,In > Out
Apr 2020,229,219,264,48393299,1800598068,1848991367,126,258,4,1752204769,In > Out
Apr 2020,229,222,134,90605032,2059225405,2149830437,33,134,1,1968620373,In > Out
Apr 2020,229,223,49,2782759,172203683,174986442,19,49,1,169420924,In > Out
Apr 2020,229,23,277,28374945,1862867515,1891242460,107,276,4,1834492570,In > Out
Apr 2020,229,26,216,50160971,864715541,914876512,116,216,5,814554570,In > Out
Apr 2020,229,27,172,14604308,422365002,436969310,77,172,3,407760694,In > Out
Apr 2020,229,30,55,81008335,62564768,143573103,31,55,3,18443567,Out > In
Apr 2020,229,32,11,333071,9764932,10098003,1,11,1,9431861,In > Out
Apr 2020,229,38,2211,177145752,4405084701,4582230453,1310,1501,1049,4227938949,In > Out
Apr 2020,229,4,155,36953429,2515006148,2551959577,57,155,2,2478052719,In > Out
Apr 2020,229,42,345,61645130,2642582919,2704228049,95,344,5,2580937789,In > Out
Apr 2020,229,43,465,752663554,1164144159,1916807713,114,457,9,411480605,In > Out
Apr 2020,229,44,187,354900267,882457950,1237358217,70,186,11,527557683,In > Out
Apr 2020,229,45,117,173035566,596661035,769696601,54,116,4,423625469,In > Out
Apr 2020,229,46,148,32468888,818385852,850854740,48,148,5,785916964,In > Out
Apr 2020,229,5,28,3345285,11374716,14720001,19,28,2,8029431,In > Out
Apr 2020,229,52,140,10783003,317566084,328349087,61,140,2,306783081,In > Out
Apr 2020,229,53,264,164908869,1753897112,1918805981,92,248,30,1588988243,In > Out
Apr 2020,229,54,25,2019933,10764016,12783949,21,25,1,8744083,In > Out
Apr 2020,229,55,952,133772827,5343719035,5477491862,183,923,7,5209946208,In > Out
Apr 2020,229,58,311,31497003,892586401,924083404,48,307,4,861089398,In > Out
Apr 2020,229,59,120,24937851,148597870,173535721,46,120,3,123660019,In > Out
Apr 2020,229,6,4,211122,8834874,9045996,4,4,1,8623752,In > Out
Apr 2020,229,62,354,103470681,7794453006,7897923687,97,353,2,7690982325,In > Out
Apr 2020,229,63,7,1074310,3122375,4196685,4,7,1,2048065,In > Out
Apr 2020,229,64,46454,931749207,35246715083,36178464290,511,15877,19,34314965876,In > Out
Apr 2020,229,66,167,27985835,1142479558,1170465393,65,167,1,1114493723,In > Out
Apr 2020,229,67,179,147748441,1075748329,1223496770,85,179,4,927999888,In > Out
Apr 2020,229,69,63,3124388,185706191,188830579,35,63,3,182581803,In > Out
Apr 2020,229,70,1395,337672497,12005067130,12342739627,183,1365,19,11667394633,In > Out
Apr 2020,229,71,1392,87942813,1824001242,1911944055,197,1376,5,1736058429,In > Out
Apr 2020,229,72,20,23677688,23731784,47409472,13,20,2,54096,In > Out
Apr 2020,229,73,30,6105650,253150862,259256512,12,30,2,247045212,In > Out
Apr 2020,229,74,6,622835,8425491,9048326,4,6,1,7802656,In > Out
Apr 2020,229,76,325,23268654,461775799,485044453,186,268,93,438507145,In > Out
Apr 2020,229,77,444,63727871,1991413708,2055141579,153,444,2,1927685837,In > Out
Apr 2020,229,78,2,25289,371784,397073,2,2,2,346495,In > Out
Apr 2020,229,79,99,8218215,495623006,503841221,62,99,3,487404791,In > Out
Apr 2020,229,8,43,7418155,434398064,441816219,19,43,1,426979909,In > Out
Apr 2020,229,80,302,19186998,888000629,907187627,41,302,3,868813631,In > Out
Apr 2020,229,81,22,2524075,8320725,10844800,16,22,1,5796650,In > Out
Apr 2020,229,83,331,2187818604,2690297225,4878115829,132,326,9,502478621,In > Out
Apr 2020,229,89,257,36288051,1773602921,1809890972,84,255,5,1737314870,In > Out
Apr 2020,229,90,112,8138587,1163491118,1171629705,42,112,3,1155352531,In > Out
Apr 2020,229,92,715,187495810,1742210307,1929706117,228,712,6,1554714497,In > Out
Apr 2020,229,93,289,75495820,537062840,612558660,79,289,3,461567020,In > Out
Apr 2020,229,94,2044,537239536,32880885900,33418125436,527,1907,37,32343646364,In > Out
Apr 2020,229,96,492,59264728,1474855787,1534120515,191,486,6,1415591059,In > Out
Apr 2020,229,99,853,162031612,7004005711,7166037323,189,845,6,6841974099,In > Out
Apr 2020,23,4,133,12666828,560089374,572756202,22,133,1,547422546,In > Out
Apr 2020,234,113,289,13997792,405964208,419962000,44,284,2,391966416,In > Out
Apr 2020,234,114,381,33831389,1111013509,1144844898,151,376,2,1077182120,In > Out
Apr 2020,234,116,212,268741505,489091656,757833161,91,126,21,220350151,In > Out
Apr 2020,234,123,68,2233400,88118046,90351446,11,68,2,85884646,In > Out
Apr 2020,234,126,11,644093,31810446,32454539,2,11,2,31166353,In > Out
Apr 2020,234,129,116,4872761,276063304,280936065,21,116,2,271190543,In > Out
Apr 2020,234,130,183,14210895,607780958,621991853,21,182,2,593570063,In > Out
Apr 2020,234,132,2,5824,269365,275189,1,2,1,263541,In > Out
Apr 2020,234,134,399,103589821,3153866255,3257456076,102,395,2,3050276434,In > Out
Apr 2020,234,135,718,91945263,487586769,579532032,102,706,2,395641506,In > Out
Apr 2020,234,137,228,62502212,1609696343,1672198555,87,228,2,1547194131,In > Out
Apr 2020,234,139,276,9330943,222686691,232017634,64,275,2,213355748,In > Out
Apr 2020,234,144,59,7726140,143817592,151543732,24,59,2,136091452,In > Out
Apr 2020,234,151,506,37005421,354591689,391597110,114,497,6,317586268,In > Out
Apr 2020,234,200,288,291656016,248694709,540350725,22,283,3,42961307,Out > In
Apr 2020,234,201,19,1908511,2188530,4097041,4,15,2,280019,In > Out
Apr 2020,234,228,332,30125470,980831461,1010956931,51,327,2,950705991,In > Out
Apr 2020,234,23,15,1292540,45390310,46682850,5,15,3,44097770,In > Out
Apr 2020,234,234,464,21056921,202748969,223805890,75,457,2,181692048,In > Out
Apr 2020,234,237,1027,56806062,358210144,415016206,25,986,2,301404082,In > Out
Apr 2020,234,242,14,1334552,40307498,41642050,10,14,2,38972946,In > Out
Apr 2020,234,29,393,42760111,374214732,416974843,30,386,6,331454621,In > Out
Apr 2020,234,46,114,4961098,199369120,204330218,11,113,2,194408022,In > Out
Apr 2020,234,52,121,13857069,505607458,519464527,51,121,2,491750389,In > Out
Apr 2020,234,56,320,16884735,542407054,559291789,162,320,3,525522319,In > Out
Apr 2020,234,58,268,19125566,890511569,909637135,38,264,2,871386003,In > Out
Apr 2020,234,66,488,60690957,1023734740,1084425697,50,478,3,963043783,In > Out
Apr 2020,234,76,944,2023373559,2613826883,4637200442,195,918,10,590453324,In > Out
Apr 2020,234,81,145,11802339,224589476,236391815,72,144,2,212787137,In > Out
Apr 2020,234,83,165,186117529,517961839,704079368,57,164,2,331844310,In > Out
Apr 2020,234,84,462,116358797,482984874,599343671,133,455,2,366626077,In > Out
Apr 2020,234,89,203,11772658,646834785,658607443,27,203,2,635062127,In > Out
Apr 2020,235,212,299,2102955,193289813,195392768,9,299,1,191186858,In > Out
Apr 2020,235,223,813225,11136077169,423975240024,435111317193,1164,28232,2,412839162855,In > Out
Apr 2020,236,253,2790,1016917187,4943339181,5960256368,682,2602,8,3926421994,In > Out
Apr 2020,239,161,386,86884720,5178524543,5265409263,67,289,2,5091639823,In > Out
Apr 2020,239,162,786,135360331,7694875517,7830235848,69,529,2,7559515186,In > Out
Apr 2020,239,163,199,24197889,1330946229,1355144118,44,178,2,1306748340,In > Out
Apr 2020,239,164,35,3320993,214502104,217823097,14,35,2,211181111,In > Out
Apr 2020,239,165,337,65952589,3514618243,3580570832,50,277,2,3448665654,In > Out
Apr 2020,239,166,531,84198286,5091672034,5175870320,64,361,2,5007473748,In > Out
Apr 2020,239,167,520,111494148,6543278682,6654772830,67,322,2,6431784534,In > Out
Apr 2020,239,171,514,87247695,4804397179,4891644874,57,361,2,4717149484,In > Out
Apr 2020,239,172,209,41853648,2337114249,2378967897,46,162,2,2295260601,In > Out
Apr 2020,239,173,408,55089152,3002232821,3057321973,57,302,2,2947143669,In > Out
Apr 2020,239,174,647,91315083,5112212829,5203527912,76,457,2,5020897746,In > Out
Apr 2020,239,175,382,67346567,3959825285,4027171852,58,249,2,3892478718,In > Out
Apr 2020,239,178,328,66704936,3823420922,3890125858,58,250,2,3756715986,In > Out
Apr 2020,239,182,55,38261211,1856782984,1895044195,19,55,2,1818521773,In > Out
Apr 2020,239,184,237,38689835,2106297358,2144987193,44,198,2,2067607523,In > Out
Apr 2020,239,185,444,93691239,5534686164,5628377403,55,300,2,5440994925,In > Out
Apr 2020,239,186,72,13877954,610272947,624150901,24,58,2,596394993,In > Out
Apr 2020,239,187,201,41288190,2200409673,2241697863,46,174,2,2159121483,In > Out
Apr 2020,239,188,240,40806596,2075617055,2116423651,50,207,2,2034810459,In > Out
Apr 2020,239,189,162,23401258,1103495714,1126896972,41,147,2,1080094456,In > Out
Apr 2020,239,198,145,29955061,1462614586,1492569647,49,123,2,1432659525,In > Out
Apr 2020,239,199,383,87416806,4866122731,4953539537,73,271,2,4778705925,In > Out
Apr 2020,239,220,162,15581951,615196944,630778895,41,152,2,599614993,In > Out
Apr 2020,239,63,2,355552,30947,386499,1,2,1,324605,Out > In
Apr 2020,241,136,27,1437925,170394186,171832111,4,27,1,168956261,In > Out
Apr 2020,241,182,267,262967557,279818175,542785732,34,264,2,16850618,In > Out
Apr 2020,241,196,1639,19196124,529428631,548624755,11,1570,2,510232507,In > Out
Apr 2020,241,199,99,46269155,404220168,450489323,8,99,2,357951013,In > Out
Apr 2020,241,223,97,4015948,119921964,123937912,7,97,1,115906016,In > Out
Apr 2020,241,224,28,12531530,450541013,463072543,17,28,2,438009483,In > Out
Apr 2020,241,228,44,12118020,481472378,493590398,26,44,2,469354358,In > Out
Apr 2020,241,229,808,240912828,451411751,692324579,95,796,2,210498923,In > Out
Apr 2020,241,234,49,2234927,70139316,72374243,15,49,3,67904389,In > Out
Apr 2020,241,6,12,617038,36160116,36777154,4,12,1,35543078,In > Out
Apr 2020,242,140,92,4113890,347260867,351374757,34,92,2,343146977,In > Out
Apr 2020,242,39,3,31910,293215,325125,1,3,1,261305,In > Out
Apr 2020,242,41,133,1911897,20067513,21979410,1,132,1,18155616,In > Out
Apr 2020,242,44,21516,784852202,5935887815,6720740017,1204,14954,2,5151035613,In > Out
Apr 2020,246,106,180,43748932,1419002120,1462751052,54,180,2,1375253188,In > Out
Apr 2020,246,122,1,467002,29667171,30134173,1,1,1,29200169,In > Out
Apr 2020,246,129,158,19758968,946172880,965931848,32,158,2,926413912,In > Out
Apr 2020,246,132,75,14520721,570876195,585396916,24,75,2,556355474,In > Out
Apr 2020,246,138,76,10820655,524737116,535557771,28,76,2,513916461,In > Out
Apr 2020,246,140,84,18580982,891981943,910562925,25,84,2,873400961,In > Out
Apr 2020,246,141,19,6338550,156515962,162854512,14,19,2,150177412,In > Out
Apr 2020,246,143,84,2179240,25635261,27814501,9,84,2,23456021,In > Out
Apr 2020,246,152,66,10485453,502466239,512951692,25,66,2,491980786,In > Out
Apr 2020,246,155,75,12240744,520391262,532632006,25,75,2,508150518,In > Out
Apr 2020,246,160,51,3902694,19477187,23379881,18,51,2,15574493,In > Out
Apr 2020,246,162,126,15796584,779524405,795320989,33,121,2,763727821,In > Out
Apr 2020,246,177,75,7973166,402508935,410482101,22,75,2,394535769,In > Out
Apr 2020,246,185,94,5345615,282254442,287600057,28,92,2,276908827,In > Out
Apr 2020,246,193,72,4921519,155222707,160144226,22,71,2,150301188,In > Out
Apr 2020,246,195,85,15557134,852575456,868132590,27,84,2,837018322,In > Out
Apr 2020,246,197,75,18453084,559046775,577499859,24,75,2,540593691,In > Out
Apr 2020,246,198,14,2000772,9748382,11749154,8,14,1,7747610,In > Out
Apr 2020,246,206,86,12552895,556451311,569004206,22,86,2,543898416,In > Out
Apr 2020,246,208,87,16439945,562088493,578528438,23,87,2,545648548,In > Out
Apr 2020,246,209,108,12479521,718887835,731367356,33,108,2,706408314,In > Out
Apr 2020,246,214,80,17879971,908180900,926060871,22,80,2,890300929,In > Out
Apr 2020,246,215,13,2273994,18721465,20995459,10,13,2,16447471,In > Out
Apr 2020,246,220,75,13902994,692029459,705932453,25,75,2,678126465,In > Out
Apr 2020,246,222,77,12740975,573006488,585747463,23,77,2,560265513,In > Out
Apr 2020,246,227,141,11140467,544042281,555182748,34,141,2,532901814,In > Out
Apr 2020,246,229,22,4203296,55538481,59741777,12,22,2,51335185,In > Out
Apr 2020,246,233,73,9742018,425473083,435215101,23,73,2,415731065,In > Out
Apr 2020,246,235,116,13906421,795818453,809724874,26,116,2,781912032,In > Out
Apr 2020,246,238,46,4415032,225262724,229677756,8,46,2,220847692,In > Out
Apr 2020,246,241,128,31276807,1298297110,1329573917,28,128,2,1267020303,In > Out
Apr 2020,246,246,11,1194160,2812166,4006326,5,11,1,1618006,In > Out
Apr 2020,246,252,127,23828714,1275954717,1299783431,28,126,2,1252126003,In > Out
Apr 2020,246,41,50,11710066,545134305,556844371,19,50,2,533424239,In > Out
Apr 2020,246,42,55,9107289,491160241,500267530,21,55,2,482052952,In > Out
Apr 2020,246,43,92,11710452,593579384,605289836,27,92,2,581868932,In > Out
Apr 2020,246,44,57,7720902,356840378,364561280,22,57,2,349119476,In > Out
Apr 2020,246,45,79,16918334,767951727,784870061,24,79,2,751033393,In > Out
Apr 2020,246,46,123,20816789,1149885376,1170702165,32,123,2,1129068587,In > Out
Apr 2020,246,47,55,28016779,568991059,597007838,25,55,2,540974280,In > Out
Apr 2020,246,48,43,12841647,650108944,662950591,21,42,2,637267297,In > Out
Apr 2020,246,49,81,18781289,905325888,924107177,25,81,2,886544599,In > Out
Apr 2020,246,50,56,13811640,689648214,703459854,24,56,2,675836574,In > Out
Apr 2020,246,51,63,18817053,898280985,917098038,18,63,2,879463932,In > Out
Apr 2020,246,52,74,18370476,1122792431,1141162907,24,74,2,1104421955,In > Out
Apr 2020,246,54,95,50795451,1438019901,1488815352,26,95,2,1387224450,In > Out
Apr 2020,246,55,80,10445699,596431064,606876763,22,80,2,585985365,In > Out
Apr 2020,246,56,104,18052651,972920816,990973467,27,104,2,954868165,In > Out
Apr 2020,246,57,81,16279649,728218238,744497887,24,81,2,711938589,In > Out
Apr 2020,246,58,57,21906319,251665472,273571791,23,57,2,229759153,In > Out
Apr 2020,246,59,13,2514125,43086892,45601017,11,13,2,40572767,In > Out
Apr 2020,246,60,74,14019330,668532756,682552086,25,74,2,654513426,In > Out
Apr 2020,246,61,144,42474679,950299925,992774604,59,144,2,907825246,In > Out
Apr 2020,246,62,94,9332555,442832473,452165028,27,94,2,433499918,In > Out
Apr 2020,246,63,107,33167641,1287003419,1320171060,29,107,2,1253835778,In > Out
Apr 2020,246,64,67,12376070,563403072,575779142,20,67,2,551027002,In > Out
Apr 2020,246,65,49,8312525,437381101,445693626,20,49,2,429068576,In > Out
Apr 2020,246,66,39,6860473,377435149,384295622,20,39,2,370574676,In > Out
Apr 2020,246,67,183,22705979,280130366,302836345,100,180,2,257424387,In > Out
Apr 2020,246,68,66,3357798,163854069,167211867,26,66,2,160496271,In > Out
Apr 2020,246,69,59,28759374,496775526,525534900,20,59,2,468016152,In > Out
Apr 2020,246,71,89,25270958,1322778209,1348049167,28,89,2,1297507251,In > Out
Apr 2020,246,72,59,7470382,278314311,285784693,24,59,2,270843929,In > Out
Apr 2020,246,73,114,10731368,532527374,543258742,28,114,2,521796006,In > Out
Apr 2020,246,74,99,24607828,960341860,984949688,27,99,2,935734032,In > Out
Apr 2020,246,75,83,23216080,989722404,1012938484,33,83,2,966506324,In > Out
Apr 2020,246,76,62,10087004,486999363,497086367,25,62,2,476912359,In > Out
Apr 2020,246,77,45,25057748,78095315,103153063,31,45,2,53037567,In > Out
Apr 2020,246,79,51,7648501,455238433,462886934,15,51,2,447589932,In > Out
Apr 2020,246,80,53,9211959,491779532,500991491,24,53,2,482567573,In > Out
Apr 2020,246,81,67,16075654,648715638,664791292,21,67,2,632639984,In > Out
Apr 2020,246,82,73,10277046,570208861,580485907,21,73,2,559931815,In > Out
Apr 2020,246,83,52,3493892,176035114,179529006,15,52,2,172541222,In > Out
Apr 2020,246,84,61,8537852,311606015,320143867,21,61,2,303068163,In > Out
Apr 2020,246,85,77,19408990,704029228,723438218,22,77,2,684620238,In > Out
Apr 2020,246,86,102,9496288,446346761,455843049,25,102,2,436850473,In > Out
Apr 2020,246,87,176,12579782,596642402,609222184,37,176,2,584062620,In > Out
Apr 2020,248,111,123,7523737,646460046,653983783,44,123,2,638936309,In > Out
Apr 2020,248,131,132,7563520,492505211,500068731,41,130,2,484941691,In > Out
Apr 2020,25,22,1,16607,3206658,3223265,1,1,1,3190051,In > Out
Apr 2020,250,116,6,88804,2615642,2704446,1,6,1,2526838,In > Out
Apr 2020,250,15,232,99426065,552431025,651857090,54,188,2,453004960,In > Out
Apr 2020,250,193,75,7071437,751235533,758306970,8,75,2,744164096,In > Out
Apr 2020,250,204,9109,1240143320,53696583215,54936726535,212,6885,5,52456439895,In > Out
Apr 2020,250,3,6,491942,357187,849129,1,1,1,134755,Out > In
Apr 2020,250,39,36,1041307,8330387,9371694,10,36,1,7289080,In > Out
Apr 2020,250,41,275,82029266,3140486254,3222515520,76,273,3,3058456988,In > Out
Apr 2020,250,49,7,828852,265329,1094181,2,7,1,563523,Out > In
Apr 2020,250,51,1,59518,44169,103687,1,1,1,15349,Out > In
Apr 2020,256,11,5,5358227,153785,5512012,5,1,5,5204442,Out > In
Apr 2020,256,12,99,349517404,7444010,356961414,26,99,1,342073394,Out > In
Apr 2020,256,15,269,9878705,358753164,368631869,13,267,4,348874459,In > Out
Apr 2020,256,248,53798,16387889415,361050340213,377438229628,4973,24635,273,344662450798,In > Out
Apr 2020,256,249,65970,26368029441,292315526572,318683556013,5507,24469,448,265947497131,In > Out
Apr 2020,256,250,43100,22690702586,253547802632,276238505218,4810,22576,333,230857100046,In > Out
Apr 2020,256,251,46738,19469329062,299462245689,318931574751,4293,23472,264,279992916627,In > Out
Apr 2020,256,252,63133,28201469015,728217830825,756419299840,5850,24742,423,700016361810,In > Out
Apr 2020,256,253,46893,13577204077,317339324537,330916528614,5395,22472,225,303762120460,In > Out
Apr 2020,256,254,92820,27759549776,683607768853,711367318629,4990,30842,530,655848219077,In > Out
Apr 2020,26,2,2,51863,5385507,5437370,2,2,2,5333644,In > Out
Apr 2020,26,66,1,9802,413894,423696,1,1,1,404092,In > Out
Apr 2020,29,142,321,16619089,877138128,893757217,21,321,2,860519039,In > Out
Apr 2020,29,19,981,107419213,839404759,946823972,319,961,2,731985546,In > Out
Apr 2020,29,40,332,11878122,1008251046,1020129168,36,332,2,996372924,In > Out
Apr 2020,29,52,17008,6833807859,21641640328,28475448187,1666,10714,8,14807832469,In > Out
Apr 2020,29,94,201,10370469,547044245,557414714,30,199,2,536673776,In > Out
Apr 2020,3,195,873,5315019,203615597,208930616,6,842,1,198300578,In > Out
Apr 2020,3,196,376,4109695,596103586,600213281,4,371,1,591993891,In > Out
Apr 2020,3,197,4,51679,5408084,5459763,3,4,1,5356405,In > Out
Apr 2020,35,111,19,6467301,5824868,12292169,1,19,1,642433,Out > In
Apr 2020,35,112,22,16562090,8600102,25162192,2,22,2,7961988,Out > In
Apr 2020,35,116,540,2969571,118491334,121460905,1,540,1,115521763,In > Out
Apr 2020,35,118,3,7059964,424708431,431768395,2,3,2,417648467,In > Out
Apr 2020,35,16,2,24589402,872858145,897447547,2,2,1,848268743,In > Out
Apr 2020,35,162,1,22877,3118539,3141416,1,1,1,3095662,In > Out
Apr 2020,35,164,2,15872,317268,333140,1,2,1,301396,In > Out
Apr 2020,35,165,5,10833181,965070368,975903549,4,5,1,954237187,In > Out
Apr 2020,35,17,4,11106841,649769745,660876586,4,4,2,638662904,In > Out
Apr 2020,35,181,3,8913882,485330125,494244007,3,3,1,476416243,In > Out
Apr 2020,35,182,5,7201787,723265101,730466888,5,5,2,716063314,In > Out
Apr 2020,35,183,117,10074559,384879680,394954239,7,115,2,374805121,In > Out
Apr 2020,35,191,69,22646762,29856852,52503614,27,69,3,7210090,In > Out
Apr 2020,35,192,7,389709,420245,809954,2,7,1,30536,In > Out
Apr 2020,35,193,11,503275,12624307,13127582,8,11,2,12121032,In > Out
Apr 2020,35,194,5,296325,282099,578424,2,5,1,14226,Out > In
Apr 2020,35,195,34,1858621,22622046,24480667,3,34,2,20763425,In > Out
Apr 2020,35,198,7,7656725,436038163,443694888,5,7,1,428381438,In > Out
Apr 2020,35,199,5,8865281,494324861,503190142,5,5,1,485459580,In > Out
Apr 2020,35,208,5,278703,298438,577141,2,5,1,19735,In > Out
Apr 2020,35,232,2,1059768,534240841,535300609,2,2,1,533181073,In > Out
Apr 2020,35,98,3,8108385,1109646192,1117754577,2,3,1,1101537807,In > Out
Apr 2020,4,104,238,8158607,1119551168,1127709775,41,238,2,1111392561,In > Out
Apr 2020,4,105,2200,651893072,3876165127,4528058199,346,2069,3,3224272055,In > Out
Apr 2020,4,106,3189,1524358611,26645882157,28170240768,275,2909,11,25121523546,In > Out
Apr 2020,4,11,44,1775323,85227267,87002590,8,44,2,83451944,In > Out
Apr 2020,4,112,908,117398930,356135784,473534714,134,885,2,238736854,In > Out
Apr 2020,4,113,1390,222808359,5434452477,5657260836,373,1374,2,5211644118,In > Out
Apr 2020,4,12,29,6027162,269895535,275922697,15,29,2,263868373,In > Out
Apr 2020,4,14,1121,69053578,2912256670,2981310248,316,1076,4,2843203092,In > Out
Apr 2020,4,15,467,443682261,1217096026,1660778287,124,464,4,773413765,In > Out
Apr 2020,4,17,744,122423950,9072889743,9195313693,224,727,4,8950465793,In > Out
Apr 2020,4,2,2326,84301862,866818023,951119885,271,2168,3,782516161,In > Out
Apr 2020,4,35,907,59253754,1280206049,1339459803,170,882,2,1220952295,In > Out
Apr 2020,40,9,6,162810,7084065,7246875,6,6,1,6921255,In > Out
Apr 2020,41,171,1,1331,198319,199650,1,1,1,196988,In > Out
Apr 2020,43,4,3,184689211,12635847,197325058,3,1,3,172053364,Out > In
Apr 2020,44,26,1184,3220204638,20072037976,23292242614,286,1133,11,16851833338,In > Out
Apr 2020,45,161,5775,9944210635,207740254254,217684464889,974,4733,162,197796043619,In > Out
Apr 2020,46,12,192,129969192,2586752533,2716721725,55,185,11,2456783341,In > Out
Apr 2020,46,151,606,1569355721,52533520419,54102876140,183,589,57,50964164698,In > Out
Apr 2020,46,153,33,1602473,35965110,37567583,10,33,1,34362637,In > Out
Apr 2020,46,163,56,12162870,449283476,461446346,21,56,7,437120606,In > Out
Apr 2020,46,215,4823,1842479368,46132791598,47975270966,927,4270,50,44290312230,In > Out
Apr 2020,46,22,2213,1333401348,13566250046,14899651394,505,2076,6,12232848698,In > Out
Apr 2020,46,220,8265,7228911966,478017147164,485246059130,531,7051,30,470788235198,In > Out
Apr 2020,46,222,21,879598,20300749,21180347,11,21,3,19421151,In > Out
Apr 2020,46,34,15541,2821191370,88895045382,91716236752,701,14922,236,86073854012,In > Out
Apr 2020,46,44,1110,1552648036,60717449203,62270097239,184,1070,49,59164801167,In > Out
Apr 2020,46,79,839,478285010,15869443973,16347728983,163,797,20,15391158963,In > Out
Apr 2020,48,171,80958,5558504409,296247707615,301806212024,306,16274,26,290689203206,In > Out
Apr 2020,49,113,14657,2333868073,73058331816,75392199889,1319,10040,11,70724463743,In > Out
Apr 2020,49,114,21852,6393409031,75153632690,81547041721,1105,12711,11,68760223659,In > Out
Apr 2020,49,115,12893,2562814855,54698002115,57260816970,689,9271,134,52135187260,In > Out
Apr 2020,49,116,9839,9459303516,51157381261,60616684777,665,7541,8,41698077745,In > Out
Apr 2020,49,117,14520,37390725951,116127557866,153518283817,1021,10539,11,78736831915,In > Out
Apr 2020,49,118,22865,4756178390,68423173621,73179352011,935,14521,13,63666995231,In > Out
Apr 2020,49,119,16938,1751316394,87003033926,88754350320,1007,11854,5,85251717532,In > Out
Apr 2020,49,120,28563,8156923761,65284923393,73441847154,878,16617,35,57127999632,In > Out
Apr 2020,49,121,22250,4021429225,73087874596,77109303821,915,15604,7,69066445371,In > Out
Apr 2020,49,122,16131,4643486608,66873667488,71517154096,1143,11356,14,62230180880,In > Out
Apr 2020,49,123,17362,4621672759,107926983080,112548655839,1099,11556,13,103305310321,In > Out
Apr 2020,49,124,16331,5224572746,55404503007,60629075753,836,10814,22,50179930261,In > Out
Apr 2020,49,125,43021,2571976467,98423959049,100995935516,486,15204,2,95851982582,In > Out
Apr 2020,49,126,43299,11581345516,95830333071,107411678587,698,15451,3,84248987555,In > Out
Apr 2020,49,212,3,403471735,113863004,517334739,3,1,3,289608731,Out > In
Apr 2020,49,244,101,15703276,9701856,25405132,4,1,1,6001420,Out > In
Apr 2020,5,103,1,682830,11154,693984,1,1,1,671676,Out > In
Apr 2020,5,13,9,1179256,209024254,210203510,1,9,1,207844998,In > Out
Apr 2020,5,22,72,58908001,505091274,563999275,42,70,3,446183273,In > Out
Apr 2020,5,23,1,37696,2744184,2781880,1,1,1,2706488,In > Out
Apr 2020,5,25,627,26738194,1965102584,1991840778,242,613,3,1938364390,In > Out
Apr 2020,5,27,196,8436492,826262106,834698598,74,195,5,817825614,In > Out
Apr 2020,5,31,1,118051,23548752,23666803,1,1,1,23430701,In > Out
Apr 2020,5,6,2,362760,8274,371034,1,2,1,354486,Out > In
Apr 2020,50,241,4,20172,792116,812288,3,4,1,771944,In > Out
Apr 2020,50,51,1,55945,59798,115743,1,1,1,3853,In > Out
Apr 2020,50,52,11,591029,35802334,36393363,4,11,1,35211305,In > Out
Apr 2020,51,10,17,1203169,60085016,61288185,6,17,4,58881847,In > Out
Apr 2020,51,103,2094,226856991,2132370186,2359227177,453,1955,9,1905513195,In > Out
Apr 2020,51,14,5,3913634,500560608,504474242,2,5,2,496646974,In > Out
Apr 2020,51,151,861,389577391,2465260113,2854837504,155,842,7,2075682722,In > Out
Apr 2020,51,152,357,250743444,510016476,760759920,145,355,3,259273032,In > Out
Apr 2020,51,153,217,16539852,1072261515,1088801367,20,216,2,1055721663,In > Out
Apr 2020,51,154,797,155251765,12545770186,12701021951,96,782,232,12390518421,In > Out
Apr 2020,51,156,714,143424474,44231049,187655523,27,687,2,99193425,Out > In
Apr 2020,51,160,272,43053848,273753062,316806910,20,33,4,230699214,In > Out
Apr 2020,51,161,119,35575122,1911758280,1947333402,52,119,2,1876183158,In > Out
Apr 2020,51,162,77,4940160,196578269,201518429,11,77,2,191638109,In > Out
Apr 2020,51,163,651,142097775,187790970,329888745,11,633,2,45693195,In > Out
Apr 2020,51,169,256,41987593,1772472827,1814460420,50,256,2,1730485234,In > Out
Apr 2020,51,172,1152,209458192,1309673207,1519131399,278,1114,3,1100215015,In > Out
Apr 2020,51,174,87,8353983,1131659249,1140013232,32,87,2,1123305266,In > Out
Apr 2020,51,177,204,11697590,348384586,360082176,12,203,2,336686996,In > Out
Apr 2020,51,179,924,399629785,94725141,494354926,88,896,2,304904644,Out > In
Apr 2020,51,180,74,2639965,66239536,68879501,14,74,2,63599571,In > Out
Apr 2020,51,182,674,68817424,12503336778,12572154202,23,658,291,12434519354,In > Out
Apr 2020,51,184,540,39500639,1157776437,1197277076,155,533,2,1118275798,In > Out
Apr 2020,51,187,25,264160,31610315,31874475,4,25,2,31346155,In > Out
Apr 2020,51,188,165,4735378,140347440,145082818,35,165,2,135612062,In > Out
Apr 2020,51,197,4,365227,593632,958859,3,4,1,228405,In > Out
Apr 2020,51,205,794,57557914,688383679,745941593,55,782,2,630825765,In > Out
Apr 2020,51,209,864,70303364,870035490,940338854,196,850,8,799732126,In > Out
Apr 2020,51,210,70,2405856,102975101,105380957,10,70,2,100569245,In > Out
Apr 2020,51,211,81,81971830,885700454,967672284,31,81,5,803728624,In > Out
Apr 2020,51,212,500,30383992,1335472113,1365856105,210,493,3,1305088121,In > Out
Apr 2020,51,213,390,47034773,839934792,886969565,157,388,3,792900019,In > Out
Apr 2020,51,220,6,77814,3095026,3172840,3,6,1,3017212,In > Out
Apr 2020,51,224,34,555726,10667932,11223658,8,34,1,10112206,In > Out
Apr 2020,51,226,868,798516379,2148784436,2947300815,138,848,5,1350268057,In > Out
Apr 2020,51,232,777,42910303,446381597,489291900,289,552,206,403471294,In > Out
Apr 2020,51,237,122,27305107,1416825833,1444130940,35,122,2,1389520726,In > Out
Apr 2020,51,239,452,40846020,1435948245,1476794265,133,444,2,1395102225,In > Out
Apr 2020,51,30,628,154420760,456370430,610791190,103,618,2,301949670,In > Out
Apr 2020,51,35,46,1862326,104350587,106212913,14,46,2,102488261,In > Out
Apr 2020,51,4,12,1091481,78250391,79341872,4,12,1,77158910,In > Out
Apr 2020,51,45,356,48118761,544510599,592629360,106,352,2,496391838,In > Out
Apr 2020,51,5,10,832250,58444111,59276361,4,10,1,57611861,In > Out
Apr 2020,51,6,14,1184075,86419671,87603746,4,14,1,85235596,In > Out
Apr 2020,51,77,71,4874092,311487779,316361871,17,71,2,306613687,In > Out
Apr 2020,52,10,84,16026797,376880094,392906891,50,55,33,360853297,In > Out
Apr 2020,52,113,784,79297927,1461290801,1540588728,65,784,2,1381992874,In > Out
Apr 2020,52,115,247,5963293,714001861,719965154,39,246,2,708038568,In > Out
Apr 2020,52,116,255,9824132,1270432568,1280256700,51,255,2,1260608436,In > Out
Apr 2020,52,118,3,98371,4680346,4778717,3,3,1,4581975,In > Out
Apr 2020,52,119,782,140360945,2769167241,2909528186,134,768,2,2628806296,In > Out
Apr 2020,52,12,41,1506092,226370345,227876437,8,41,2,224864253,In > Out
Apr 2020,52,120,188,9518546,1468240135,1477758681,43,188,2,1458721589,In > Out
Apr 2020,52,141,27,1279699,74353142,75632841,4,27,1,73073443,In > Out
Apr 2020,52,142,4,4338354,790136138,794474492,3,4,2,785797784,In > Out
Apr 2020,52,143,71,5579039,517699304,523278343,30,71,2,512120265,In > Out
Apr 2020,52,149,34,1896721,91749442,93646163,5,19,2,89852721,In > Out
Apr 2020,52,15,35,1824112,381427698,383251810,21,34,2,379603586,In > Out
Apr 2020,52,16,30,1361897,348787006,350148903,14,30,2,347425109,In > Out
Apr 2020,52,163,1,70325,35150,105475,1,1,1,35175,Out > In
Apr 2020,52,164,33,5187746,149208463,154396209,7,33,2,144020717,In > Out
Apr 2020,52,172,25,1740597,252466149,254206746,18,20,2,250725552,In > Out
Apr 2020,52,183,3,22915542,37687212,60602754,2,3,3,14771670,In > Out
Apr 2020,52,192,2,8287475,14909631,23197106,2,2,2,6622156,In > Out
Apr 2020,52,199,12,1026524,70878409,71904933,4,12,1,69851885,In > Out
Apr 2020,52,22,22,1244263,280417130,281661393,13,22,1,279172867,In > Out
Apr 2020,52,24,28,1498055,104689735,106187790,5,28,2,103191680,In > Out
Apr 2020,52,25,34,1323076,48677526,50000602,8,34,2,47354450,In > Out
Apr 2020,52,29,28,1457780,112714864,114172644,4,28,1,111257084,In > Out
Apr 2020,52,33,13,571030,39353076,39924106,4,13,1,38782046,In > Out
Apr 2020,52,35,84,63227485,7451568670,7514796155,5,84,58,7388341185,In > Out
Apr 2020,52,36,75,52654455,6263872861,6316527316,5,74,47,6211218406,In > Out
Apr 2020,52,37,24,990600,81432432,82423032,4,24,1,80441832,In > Out
Apr 2020,52,38,31,1253960,104535345,105789305,6,31,2,103281385,In > Out
Apr 2020,52,4,29,1652002,114377140,116029142,4,29,1,112725138,In > Out
Apr 2020,52,6,59,3741979,243678319,247420298,11,59,2,239936340,In > Out
Apr 2020,52,8,29,1501550,111505576,113007126,4,29,1,110004026,In > Out
Apr 2020,52,9,29,1058514,106360157,107418671,4,29,1,105301643,In > Out
Apr 2020,52,94,58,6057131,487312343,493369474,28,58,2,481255212,In > Out
Apr 2020,52,97,6,1203090,317365181,318568271,5,6,2,316162091,In > Out
Apr 2020,54,103,16,414019,15198559,15612578,13,16,2,14784540,In > Out
Apr 2020,54,104,19,1067444,16812768,17880212,14,19,2,15745324,In > Out
Apr 2020,54,105,45,4813845,231098920,235912765,17,45,2,226285075,In > Out
Apr 2020,54,106,57,2654901,119711979,122366880,23,57,2,117057078,In > Out
Apr 2020,54,107,36,2126852,94406035,96532887,18,36,2,92279183,In > Out
Apr 2020,54,108,17,1159539,13544904,14704443,13,17,2,12385365,In > Out
Apr 2020,54,109,17,526018,8133874,8659892,12,17,2,7607856,In > Out
Apr 2020,54,110,19,1065282,30733080,31798362,12,19,2,29667798,In > Out
Apr 2020,54,115,14,415355,8207524,8622879,10,14,2,7792169,In > Out
Apr 2020,54,116,46,2724594,90734148,93458742,20,46,2,88009554,In > Out
Apr 2020,54,117,14,446834,10881249,11328083,10,14,2,10434415,In > Out
Apr 2020,54,118,17,1287102,33478735,34765837,13,17,2,32191633,In > Out
Apr 2020,54,119,14,428159,10060329,10488488,12,14,2,9632170,In > Out
Apr 2020,54,12,15,542905,29928437,30471342,3,15,1,29385532,In > Out
Apr 2020,54,120,18,601978,13423470,14025448,9,18,2,12821492,In > Out
Apr 2020,54,121,15,508905,15547199,16056104,13,15,2,15038294,In > Out
Apr 2020,54,122,17,1055744,27833586,28889330,12,17,2,26777842,In > Out
Apr 2020,54,127,41,1767436,75975363,77742799,20,41,2,74207927,In > Out
Apr 2020,54,128,42,747528,91024449,91771977,21,42,2,90276921,In > Out
Apr 2020,54,129,17,1136800,39205374,40342174,9,17,2,38068574,In > Out
Apr 2020,54,130,51,2097202,100226826,102324028,24,51,2,98129624,In > Out
Apr 2020,54,131,63,2743306,110518230,113261536,23,63,2,107774924,In > Out
Apr 2020,54,132,46,4271512,227295948,231567460,21,46,2,223024436,In > Out
Apr 2020,54,133,60,3151058,107406525,110557583,21,60,2,104255467,In > Out
Apr 2020,54,134,48,1573498,73297307,74870805,22,48,2,71723809,In > Out
Apr 2020,54,139,35,1479342,45996167,47475509,17,35,2,44516825,In > Out
Apr 2020,54,140,16,572771,11670330,12243101,11,16,2,11097559,In > Out
Apr 2020,54,141,56,2394441,89012032,91406473,23,56,2,86617591,In > Out
Apr 2020,54,142,41,1374074,58204405,59578479,18,41,2,56830331,In > Out
Apr 2020,54,143,43,1886733,74341702,76228435,22,42,2,72454969,In > Out
Apr 2020,54,144,14,478737,11085360,11564097,11,14,2,10606623,In > Out
Apr 2020,54,145,14,648852,11080317,11729169,9,14,2,10431465,In > Out
Apr 2020,54,146,13,655215,18443173,19098388,11,13,2,17787958,In > Out
Apr 2020,54,155,14,1520446,158097623,159618069,5,14,1,156577177,In > Out
Apr 2020,54,166,13,341336,14217240,14558576,10,13,2,13875904,In > Out
Apr 2020,54,167,54,1815914,88897694,90713608,27,54,2,87081780,In > Out
Apr 2020,54,20,14,1524970,162100390,163625360,4,14,1,160575420,In > Out
Apr 2020,54,21,14,1657828,144786695,146444523,4,14,1,143128867,In > Out
Apr 2020,54,22,11,1533042,109976696,111509738,4,11,1,108443654,In > Out
Apr 2020,54,23,13,1854958,214007419,215862377,4,13,1,212152461,In > Out
Apr 2020,54,24,10,981871,86894788,87876659,5,10,1,85912917,In > Out
Apr 2020,54,26,14,1580663,140380109,141960772,5,14,1,138799446,In > Out
Apr 2020,54,27,16,2459026,214642702,217101728,4,16,1,212183676,In > Out
Apr 2020,54,28,12,1220344,164460746,165681090,4,12,1,163240402,In > Out
Apr 2020,54,29,14,1177585,99224075,100401660,5,14,1,98046490,In > Out
Apr 2020,54,30,13,2359029,231542724,233901753,4,13,1,229183695,In > Out
Apr 2020,54,31,14,1618523,145163912,146782435,5,14,1,143545389,In > Out
Apr 2020,54,32,15,1242704,97917138,99159842,5,15,1,96674434,In > Out
Apr 2020,54,33,12,610181,44671098,45281279,3,12,1,44060917,In > Out
Apr 2020,54,34,14,1765891,152627666,154393557,4,14,1,150861775,In > Out
Apr 2020,54,35,12,1830177,142156536,143986713,5,12,1,140326359,In > Out
Apr 2020,54,36,16,1487246,170414772,171902018,5,16,1,168927526,In > Out
Apr 2020,54,37,16,1496166,118694228,120190394,5,16,1,117198062,In > Out
Apr 2020,54,38,16,2406597,222828921,225235518,5,16,1,220422324,In > Out
Apr 2020,54,39,15,1319360,112259159,113578519,4,15,1,110939799,In > Out
Apr 2020,54,40,12,861638,69697975,70559613,4,12,1,68836337,In > Out
Apr 2020,54,41,13,962391,87625024,88587415,3,13,1,86662633,In > Out
Apr 2020,54,42,14,2268709,159697050,161965759,5,14,1,157428341,In > Out
Apr 2020,54,43,13,1798610,154688382,156486992,4,13,1,152889772,In > Out
Apr 2020,54,44,14,1826801,192289065,194115866,5,14,1,190462264,In > Out
Apr 2020,54,45,14,2199273,170204194,172403467,5,14,1,168004921,In > Out
Apr 2020,54,46,16,2180371,184948340,187128711,5,16,1,182767969,In > Out
Apr 2020,54,47,12,2155349,170936037,173091386,5,12,1,168780688,In > Out
Apr 2020,54,48,15,2867997,211909048,214777045,5,15,1,209041051,In > Out
Apr 2020,54,49,12,1705044,153065536,154770580,4,12,1,151360492,In > Out
Apr 2020,54,50,12,1418654,125301819,126720473,4,12,1,123883165,In > Out
Apr 2020,54,51,13,1876771,147718131,149594902,5,13,1,145841360,In > Out
Apr 2020,54,52,14,1308898,151006069,152314967,5,14,1,149697171,In > Out
Apr 2020,54,53,16,1599383,153564729,155164112,4,16,1,151965346,In > Out
Apr 2020,54,54,13,824022,54706835,55530857,4,13,1,53882813,In > Out
Apr 2020,54,55,13,1621325,146585372,148206697,4,13,1,144964047,In > Out
Apr 2020,54,56,16,1813308,199231892,201045200,5,16,1,197418584,In > Out
Apr 2020,54,57,14,1096842,95369369,96466211,5,14,1,94272527,In > Out
Apr 2020,54,58,13,2342432,201380322,203722754,4,13,1,199037890,In > Out
Apr 2020,54,59,13,1319920,139640829,140960749,4,13,1,138320909,In > Out
Apr 2020,54,60,16,1423117,131304105,132727222,5,16,1,129880988,In > Out
Apr 2020,54,61,15,1325153,110496001,111821154,4,15,1,109170848,In > Out
Apr 2020,54,62,15,1174812,89996912,91171724,3,15,1,88822100,In > Out
Apr 2020,54,63,13,1757085,183236927,184994012,3,13,1,181479842,In > Out
Apr 2020,54,64,15,1499916,160783806,162283722,5,15,1,159283890,In > Out
Apr 2020,54,67,10,631293,48456132,49087425,4,10,1,47824839,In > Out
Apr 2020,54,68,10,395636,26677110,27072746,3,10,1,26281474,In > Out
Apr 2020,54,69,15,2087565,188172549,190260114,5,15,1,186084984,In > Out
Apr 2020,54,70,12,652255,51245082,51897337,4,12,1,50592827,In > Out
Apr 2020,54,71,15,2154913,204204954,206359867,5,15,1,202050041,In > Out
Apr 2020,54,72,14,1019474,104647646,105667120,5,14,1,103628172,In > Out
Apr 2020,54,73,12,2010938,209910914,211921852,5,12,1,207899976,In > Out
Apr 2020,54,76,14,1690936,175761535,177452471,3,14,1,174070599,In > Out
Apr 2020,54,77,17,460307,13983351,14443658,9,17,2,13523044,In > Out
Apr 2020,54,79,15,1408601,167407431,168816032,5,15,1,165998830,In > Out
Apr 2020,54,80,10,2760101,177553444,180313545,4,10,1,174793343,In > Out
Apr 2020,54,81,13,647790,37616903,38264693,4,13,1,36969113,In > Out
Apr 2020,54,82,13,2013740,192605015,194618755,5,13,1,190591275,In > Out
Apr 2020,54,83,14,1190964,136604425,137795389,5,14,1,135413461,In > Out
Apr 2020,54,84,12,1039089,90393277,91432366,2,12,1,89354188,In > Out
Apr 2020,54,85,14,1437491,141989240,143426731,4,14,1,140551749,In > Out
Apr 2020,54,86,12,870026,123782763,124652789,5,12,1,122912737,In > Out
Apr 2020,54,91,18,1336953,48236250,49573203,13,18,2,46899297,In > Out
Apr 2020,54,92,18,619312,15004629,15623941,11,18,2,14385317,In > Out
Apr 2020,54,93,14,472380,12334065,12806445,11,14,2,11861685,In > Out
Apr 2020,54,95,18,558270,17345490,17903760,13,18,2,16787220,In > Out
Apr 2020,54,96,17,622063,23206614,23828677,11,17,2,22584551,In > Out
Apr 2020,54,97,20,591396,17937190,18528586,14,20,2,17345794,In > Out
Apr 2020,54,98,18,669181,15690428,16359609,13,18,2,15021247,In > Out
Apr 2020,54,99,15,582828,12161627,12744455,11,15,2,11578799,In > Out
Apr 2020,55,106,704,79772868,824941567,904714435,83,688,1,745168699,In > Out
Apr 2020,55,13,4,297212,44711653,45008865,2,4,2,44414441,In > Out
Apr 2020,55,143,6,352632,334406,687038,2,6,1,18226,Out > In
Apr 2020,55,96,8,134592,3079433,3214025,7,8,1,2944841,In > Out
Apr 2020,56,132,1407,87574059,1755364561,1842938620,171,1347,3,1667790502,In > Out
Apr 2020,56,148,30,20115500,935600748,955716248,17,30,2,915485248,In > Out
Apr 2020,56,151,26,1178222,110690407,111868629,4,26,1,109512185,In > Out
Apr 2020,56,152,4,503412,47630,551042,2,4,1,455782,Out > In
Apr 2020,56,153,13,518189,38763795,39281984,3,13,1,38245606,In > Out
Apr 2020,56,154,99,3978699,211654140,215632839,22,99,3,207675441,In > Out
Apr 2020,56,155,25,1217187,89383644,90600831,4,25,1,88166457,In > Out
Apr 2020,56,164,281,14466984,1458340180,1472807164,45,281,2,1443873196,In > Out
Apr 2020,56,169,331,15530182,1795618176,1811148358,49,331,2,1780087994,In > Out
Apr 2020,56,172,111,3935048,210332063,214267111,21,111,2,206397015,In > Out
Apr 2020,56,177,32,3089715,59902195,62991910,15,32,2,56812480,In > Out
Apr 2020,56,181,41,2156969,35667449,37824418,27,41,2,33510480,In > Out
Apr 2020,56,190,20,729413,57188289,57917702,8,20,2,56458876,In > Out
Apr 2020,56,196,1360,340032060,1704129324,2044161384,193,1317,2,1364097264,In > Out
Apr 2020,56,199,146,7691614,31870932,39562546,45,146,2,24179318,In > Out
Apr 2020,56,221,23,995158,69820539,70815697,3,23,1,68825381,In > Out
Apr 2020,56,223,355,12956239,1317225791,1330182030,63,346,2,1304269552,In > Out
Apr 2020,56,224,604,135084167,2401333610,2536417777,137,589,2,2266249443,In > Out
Apr 2020,56,225,662,1047502784,1403267538,2450770322,160,654,2,355764754,In > Out
Apr 2020,56,226,808,83620248,1886766547,1970386795,102,795,2,1803146299,In > Out
Apr 2020,56,228,7,298597,45850075,46148672,3,7,1,45551478,In > Out
Apr 2020,56,234,15,533760,70437416,70971176,6,15,2,69903656,In > Out
Apr 2020,56,236,11,426966,34963412,35390378,7,11,2,34536446,In > Out
Apr 2020,56,240,250,10319649,221493350,231812999,46,247,2,211173701,In > Out
Apr 2020,56,241,216,22337749,502245703,524583452,99,215,2,479907954,In > Out
Apr 2020,56,242,1349,295254436,1567413611,1862668047,136,1349,2,1272159175,In > Out
Apr 2020,56,243,14,761416,82125093,82886509,4,14,1,81363677,In > Out
Apr 2020,56,244,854,71531694,287763957,359295651,67,836,2,216232263,In > Out
Apr 2020,56,247,120,7366378,383103370,390469748,23,120,2,375736992,In > Out
Apr 2020,56,250,48,1925433,101888218,103813651,20,48,2,99962785,In > Out
Apr 2020,56,252,935,83066367,262060573,345126940,37,914,2,178994206,In > Out
Apr 2020,56,253,4,772414,193400784,194173198,1,4,1,192628370,In > Out
Apr 2020,57,134,277,16839786,823059412,839899198,73,273,2,806219626,In > Out
Apr 2020,57,140,15,230659,8159927,8390586,11,15,2,7929268,In > Out
Apr 2020,57,150,169,15195636,884833877,900029513,29,168,2,869638241,In > Out
Apr 2020,57,160,17,878930,39562924,40441854,12,17,2,38683994,In > Out
Apr 2020,57,165,8,137123834,17033577,154157411,7,8,1,120090257,Out > In
Apr 2020,57,170,12,1085247,8976531,10061778,10,12,2,7891284,In > Out
Apr 2020,57,171,5,56518,2934420,2990938,4,5,1,2877902,In > Out
Apr 2020,57,172,41,4141409,238897168,243038577,16,41,2,234755759,In > Out
Apr 2020,57,174,26,2439143,77255936,79695079,4,26,1,74816793,In > Out
Apr 2020,57,175,16,534285,29036583,29570868,12,16,2,28502298,In > Out
Apr 2020,57,176,14,588867,34198388,34787255,10,14,2,33609521,In > Out
Apr 2020,57,179,49,1656924,70457084,72114008,20,49,2,68800160,In > Out
Apr 2020,57,180,210,2179164478,50154171,2229318649,12,208,4,2129010307,Out > In
Apr 2020,57,184,1,3814,142617,146431,1,1,1,138803,In > Out
Apr 2020,57,2,12,4521151,211325151,215846302,9,12,2,206804000,In > Out
Apr 2020,58,208,191,15084620,1173285877,1188370497,63,189,2,1158201257,In > Out
Apr 2020,58,218,120,7123973,377346617,384470590,22,120,2,370222644,In > Out
Apr 2020,58,220,1511,314297906,559340823,873638729,76,1486,2,245042917,In > Out
Apr 2020,58,222,89,5053185,576986513,582039698,12,89,2,571933328,In > Out
Apr 2020,58,224,14,2126317,253609900,255736217,8,14,2,251483583,In > Out
Apr 2020,58,228,6,332944,358858,691802,2,6,1,25914,In > Out
Apr 2020,58,234,6,5940599,6962362,12902961,6,6,1,1021763,In > Out
Apr 2020,59,16,2202,751303430,406317604,1157621034,47,2136,2,344985826,Out > In
Apr 2020,59,18,972,98942948819,57910443370,156853392189,346,735,944,41032505449,Out > In
Apr 2020,59,19,1983,740659397,351105721,1091765118,34,1888,1,389553676,Out > In
Apr 2020,59,20,70,784382,95521229,96305611,11,70,1,94736847,In > Out
Apr 2020,59,21,874,81377598775,52778552292,134156151067,300,685,856,28599046483,Out > In
Apr 2020,6,132,14,1571186,62639222,64210408,3,14,1,61068036,In > Out
Apr 2020,6,150,848,11245188,795691697,806936885,52,838,2,784446509,In > Out
Apr 2020,6,167,125,8618379,360684293,369302672,20,125,2,352065914,In > Out
Apr 2020,6,194,6,428741,19765103,20193844,5,6,2,19336362,In > Out
Apr 2020,6,4,29,4490885,174883732,179374617,17,29,2,170392847,In > Out
Apr 2020,6,43,125,4921085,217557057,222478142,9,125,2,212635972,In > Out
Apr 2020,6,45,45,11393591,294009294,305402885,33,45,1,282615703,In > Out
Apr 2020,6,5,127,8183982,367345414,375529396,18,121,2,359161432,In > Out
Apr 2020,6,6,81,4583954,200030920,204614874,22,74,2,195446966,In > Out
Apr 2020,6,8,95,8076769,418187396,426264165,19,95,2,410110627,In > Out
Apr 2020,60,90,47,333017690,15365329,348383019,26,1,47,317652361,Out > In
Apr 2020,63,132,23,5553391,278214923,283768314,13,23,2,272661532,In > Out
Apr 2020,63,149,289,19162094,1494016169,1513178263,30,289,2,1474854075,In > Out
Apr 2020,63,153,508,18869522,1276170308,1295039830,27,491,2,1257300786,In > Out
Apr 2020,63,17,18,639394,17322994,17962388,15,18,1,16683600,In > Out
Apr 2020,63,22,52,3016338,83859844,86876182,36,52,2,80843506,In > Out
Apr 2020,63,223,79,11604552,700919442,712523994,31,79,2,689314890,In > Out
Apr 2020,63,44,100,24802881,2438763123,2463566004,32,97,2,2413960242,In > Out
Apr 2020,65,132,2,23023,1290782,1313805,2,2,2,1267759,In > Out
Apr 2020,65,158,504,23670027,1806479390,1830149417,37,504,2,1782809363,In > Out
Apr 2020,65,165,53,2257018,119974318,122231336,18,53,2,117717300,In > Out
Apr 2020,65,167,695,107942047,4899495529,5007437576,95,684,3,4791553482,In > Out
Apr 2020,65,21,11,8495138,227716,8722854,1,11,1,8267422,Out > In
Apr 2020,65,58,1,140772,15371,156143,1,1,1,125401,Out > In
Apr 2020,65,91,584,247838494,965776340,1213614834,202,575,2,717937846,In > Out
Apr 2020,65,99,737,129895452,559112798,689008250,71,718,2,429217346,In > Out
Apr 2020,7,107,413,77759697,2053304894,2131064591,139,409,7,1975545197,In > Out
Apr 2020,7,108,30,1130029,31578681,32708710,9,30,2,30448652,In > Out
Apr 2020,7,11,131,13334364,969260674,982595038,48,129,3,955926310,In > Out
Apr 2020,7,119,451,460592087,1223536725,1684128812,109,449,3,762944638,In > Out
Apr 2020,7,12,3826,5382722460,9945720555,15328443015,888,3429,15,4562998095,In > Out
Apr 2020,7,129,162,4003831,153363846,157367677,15,160,2,149360015,In > Out
Apr 2020,7,15,129,39149882,3147366077,3186515959,61,129,5,3108216195,In > Out
Apr 2020,7,165,173,10241949,81658388,91900337,50,173,2,71416439,In > Out
Apr 2020,7,172,641,2325371362,7468513027,9793884389,30,626,18,5143141665,In > Out
Apr 2020,7,186,11,720446,2942481,3662927,8,11,2,2222035,In > Out
Apr 2020,7,202,56,3004917,650607245,653612162,25,56,2,647602328,In > Out
Apr 2020,7,208,39,2153764,95909668,98063432,8,39,2,93755904,In > Out
Apr 2020,7,213,166,9355003,1183957534,1193312537,15,166,4,1174602531,In > Out
Apr 2020,7,240,49,913400,54719293,55632693,10,49,2,53805893,In > Out
Apr 2020,7,26,547,301376824,904790883,1206167707,68,461,9,603414059,In > Out
Apr 2020,7,35,73,4043258,6089258,10132516,4,73,1,2046000,In > Out
Apr 2020,7,47,32,284995,13620473,13905468,8,32,1,13335478,In > Out
Apr 2020,7,49,404,53356548,296195177,349551725,136,404,3,242838629,In > Out
Apr 2020,7,56,664,96186519,538083657,634270176,169,658,3,441897138,In > Out
Apr 2020,7,69,7,33041,1549572,1582613,2,7,1,1516531,In > Out
Apr 2020,7,77,6,6469757,5201991,11671748,2,2,5,1267766,Out > In
Apr 2020,7,84,177,86615282,629199237,715814519,56,177,4,542583955,In > Out
Apr 2020,7,90,1036,110586935,795672025,906258960,132,1001,2,685085090,In > Out
Apr 2020,7,91,37,2642194,6058886,8701080,8,37,1,3416692,In > Out
Apr 2020,70,10,249,16558417,300382480,316940897,75,247,2,283824063,In > Out
Apr 2020,70,100,560,90033673,5427999001,5518032674,203,560,4,5337965328,In > Out
Apr 2020,70,101,486,2580773500,10088901578,12669675078,157,486,5,7508128078,In > Out
Apr 2020,70,103,413,24615166,801141078,825756244,130,408,5,776525912,In > Out
Apr 2020,70,104,161,8324138,353437938,361762076,76,161,4,345113800,In > Out
Apr 2020,70,106,482,63015458,4442872928,4505888386,165,479,3,4379857470,In > Out
Apr 2020,70,107,148,25554163,1193478320,1219032483,76,148,2,1167924157,In > Out
Apr 2020,70,108,270,922094704,1708634605,2630729309,122,269,5,786539901,In > Out
Apr 2020,70,11,42,3465820,43371778,46837598,27,42,2,39905958,In > Out
Apr 2020,70,113,926,171985019,3088572256,3260557275,280,923,5,2916587237,In > Out
Apr 2020,70,114,398,116426002,1406207154,1522633156,108,397,6,1289781152,In > Out
Apr 2020,70,115,283,27360780,344088068,371448848,114,283,5,316727288,In > Out
Apr 2020,70,121,757,238726482,3538223284,3776949766,241,741,8,3299496802,In > Out
Apr 2020,70,124,947,1637049029,3531398083,5168447112,161,944,13,1894349054,In > Out
Apr 2020,70,125,434,93952623,4080372587,4174325210,145,433,5,3986419964,In > Out
Apr 2020,70,128,1321,155647293,5249614253,5405261546,276,1280,11,5093966960,In > Out
Apr 2020,70,13,371,34243062,714471444,748714506,159,330,42,680228382,In > Out
Apr 2020,70,131,66,4408110,262192506,266600616,28,66,2,257784396,In > Out
Apr 2020,70,134,163,22515993,1152125485,1174641478,73,163,2,1129609492,In > Out
Apr 2020,70,135,24,3041106,10238867,13279973,23,24,2,7197761,In > Out
Apr 2020,70,136,242,75280397,410434712,485715109,103,242,12,335154315,In > Out
Apr 2020,70,138,631,293406270,1898166214,2191572484,135,628,2,1604759944,In > Out
Apr 2020,70,139,155,107095776,8959410134,9066505910,44,154,3,8852314358,In > Out
Apr 2020,70,14,231,21590968,315549216,337140184,125,227,3,293958248,In > Out
Apr 2020,70,140,920,380682638,13961534939,14342217577,217,906,7,13580852301,In > Out
Apr 2020,70,142,2079,425472237,14316224667,14741696904,361,1942,11,13890752430,In > Out
Apr 2020,70,143,48,1985619,24061415,26047034,17,48,2,22075796,In > Out
Apr 2020,70,146,205,82150844,9909167393,9991318237,111,202,3,9827016549,In > Out
Apr 2020,70,148,343,62551466,3195152724,3257704190,108,339,3,3132601258,In > Out
Apr 2020,70,149,871,142052409,6672204184,6814256593,307,860,9,6530151775,In > Out
Apr 2020,70,15,374,46107537,1511435040,1557542577,85,373,2,1465327503,In > Out
Apr 2020,70,151,866,225134165,1317818253,1542952418,163,866,8,1092684088,In > Out
Apr 2020,70,158,825,141403562,4074187784,4215591346,245,822,3,3932784222,In > Out
Apr 2020,70,159,964,211746074,11502361761,11714107835,361,940,3,11290615687,In > Out
Apr 2020,70,165,233,14253768,595883243,610137011,93,233,3,581629475,In > Out
Apr 2020,70,166,2106,357796435,1966405724,2324202159,340,2019,5,1608609289,In > Out
Apr 2020,70,168,133,43963944,840417233,884381177,73,133,1,796453289,In > Out
Apr 2020,70,169,1435,860203635,36691928397,37552132032,280,1405,4,35831724762,In > Out
Apr 2020,70,171,2303,580969565,5598307516,6179277081,331,2152,4,5017337951,In > Out
Apr 2020,70,174,455,27192263,968542559,995734822,132,453,8,941350296,In > Out
Apr 2020,70,175,65,7201591,38246774,45448365,37,65,2,31045183,In > Out
Apr 2020,70,177,1314,45907846,1013787911,1059695757,79,1309,10,967880065,In > Out
Apr 2020,70,178,1329,126604547,4065523672,4192128219,147,1266,3,3938919125,In > Out
Apr 2020,70,179,91,6339614,241656081,247995695,34,91,3,235316467,In > Out
Apr 2020,70,18,994,124637838,5600608369,5725246207,345,968,2,5475970531,In > Out
Apr 2020,70,181,93,16004629,282822701,298827330,49,93,2,266818072,In > Out
Apr 2020,70,183,983,205330796,1873710673,2079041469,139,968,6,1668379877,In > Out
Apr 2020,70,187,51,1779450,64489089,66268539,35,51,2,62709639,In > Out
Apr 2020,70,188,101,192364754,302147189,494511943,40,100,9,109782435,In > Out
Apr 2020,70,189,757,310310323,5827073059,6137383382,181,740,12,5516762736,In > Out
Apr 2020,70,19,32,5798141,306191696,311989837,20,32,4,300393555,In > Out
Apr 2020,70,192,55,20084043,1553176904,1573260947,34,55,2,1533092861,In > Out
Apr 2020,70,193,504,121807454,7171392395,7293199849,129,498,2,7049584941,In > Out
Apr 2020,70,197,841,156164010,6460868599,6617032609,134,834,9,6304704589,In > Out
Apr 2020,70,199,18,5689243,8016731,13705974,16,18,2,2327488,In > Out
Apr 2020,70,20,336,26253792,1424035315,1450289107,37,336,3,1397781523,In > Out
Apr 2020,70,200,378,230516381,1237109684,1467626065,124,376,6,1006593303,In > Out
Apr 2020,70,201,453,365690226,34130797646,34496487872,155,448,4,33765107420,In > Out
Apr 2020,70,204,425,170794718,1925012883,2095807601,154,423,4,1754218165,In > Out
Apr 2020,70,206,27,941328,46603905,47545233,10,27,1,45662577,In > Out
Apr 2020,70,207,541,620104870,1345771318,1965876188,275,527,6,725666448,In > Out
Apr 2020,70,208,273,30833871,2488454425,2519288296,53,269,2,2457620554,In > Out
Apr 2020,70,209,54,5887659,201627314,207514973,21,54,2,195739655,In > Out
Apr 2020,70,21,572,92403544,3446303346,3538706890,263,562,4,3353899802,In > Out
Apr 2020,70,210,1198,668251610,3876781792,4545033402,238,1150,21,3208530182,In > Out
Apr 2020,70,211,512,20202186,1162224375,1182426561,76,511,4,1142022189,In > Out
Apr 2020,70,214,1444,1139739145,5876858410,7016597555,322,1415,20,4737119265,In > Out
Apr 2020,70,217,452,90598043,5750261012,5840859055,180,448,1,5659662969,In > Out
Apr 2020,70,218,744,362716075,2325996358,2688712433,121,736,9,1963280283,In > Out
Apr 2020,70,222,541,86470817,3022192237,3108663054,225,541,3,2935721420,In > Out
Apr 2020,70,223,35,16313617,470875454,487189071,28,35,2,454561837,In > Out
Apr 2020,70,23,78,3961485,296885136,300846621,27,78,2,292923651,In > Out
Apr 2020,70,25,239,161480367,724292244,885772611,121,238,6,562811877,In > Out
Apr 2020,70,26,9,573813,4781115,5354928,7,9,1,4207302,In > Out
Apr 2020,70,27,673,1777726737,8541402455,10319129192,293,669,9,6763675718,In > Out
Apr 2020,70,28,204,35789992,1225837505,1261627497,66,204,2,1190047513,In > Out
Apr 2020,70,30,785,204298755,2867344293,3071643048,192,766,8,2663045538,In > Out
Apr 2020,70,32,1149,248116992,7863089727,8111206719,301,1143,5,7614972735,In > Out
Apr 2020,70,33,144,19365262,332776925,352142187,51,144,8,313411663,In > Out
Apr 2020,70,34,1320,1073833376,6645360002,7719193378,478,1198,159,5571526626,In > Out
Apr 2020,70,35,190,15555151,549741472,565296623,89,188,3,534186321,In > Out
Apr 2020,70,37,597,633673339,1638095227,2271768566,160,586,9,1004421888,In > Out
Apr 2020,70,4,14,141734338,72224280,213958618,10,14,3,69510058,Out > In
Apr 2020,70,40,334,127719698,5856918226,5984637924,160,332,3,5729198528,In > Out
Apr 2020,70,43,1941,158136887,4158338415,4316475302,305,1848,2,4000201528,In > Out
Apr 2020,70,44,128,25079728,946331890,971411618,61,126,6,921252162,In > Out
Apr 2020,70,47,1026,720286080,4637164052,5357450132,283,1019,12,3916877972,In > Out
Apr 2020,70,48,825,759526267,3149182088,3908708355,208,808,4,2389655821,In > Out
Apr 2020,70,51,4864,9481995319,21161818698,30643814017,500,4233,23,11679823379,In > Out
Apr 2020,70,54,360,14768187,277907498,292675685,91,357,4,263139311,In > Out
Apr 2020,70,56,48,49367677,111360240,160727917,32,48,2,61992563,In > Out
Apr 2020,70,58,465,326025363,4655324110,4981349473,129,463,6,4329298747,In > Out
Apr 2020,70,59,360,47658445,2233074894,2280733339,134,359,5,2185416449,In > Out
Apr 2020,70,6,6,130357,5770192,5900549,4,6,1,5639835,In > Out
Apr 2020,70,61,393,68988530,2738399959,2807388489,173,392,3,2669411429,In > Out
Apr 2020,70,62,726,90078531,5186991914,5277070445,183,714,7,5096913383,In > Out
Apr 2020,70,64,2821,196916856,25006121035,25203037891,465,2757,4,24809204179,In > Out
Apr 2020,70,66,1086,165384746,3119068607,3284453353,257,1048,11,2953683861,In > Out
Apr 2020,70,67,10,1506361,7266085,8772446,9,10,3,5759724,In > Out
Apr 2020,70,68,2371,2049086062,4516185590,6565271652,402,2254,7,2467099528,In > Out
Apr 2020,70,7,695,214143739,5512454595,5726598334,258,688,4,5298310856,In > Out
Apr 2020,70,70,53,1495041,62759825,64254866,16,53,2,61264784,In > Out
Apr 2020,70,71,53,2017478,69000032,71017510,10,53,1,66982554,In > Out
Apr 2020,70,72,335,27917916,416462045,444379961,129,328,5,388544129,In > Out
Apr 2020,70,74,154,13314033,145289106,158603139,74,154,2,131975073,In > Out
Apr 2020,70,75,341,20388930,579003074,599392004,136,336,7,558614144,In > Out
Apr 2020,70,76,4,52644,530466,583110,3,4,1,477822,In > Out
Apr 2020,70,77,36,2365847,63641234,66007081,17,36,5,61275387,In > Out
Apr 2020,70,79,28,3839499,202290373,206129872,20,28,3,198450874,In > Out
Apr 2020,70,83,115,21529235,71767192,93296427,32,115,12,50237957,In > Out
Apr 2020,70,85,28,1362604,17147898,18510502,19,28,2,15785294,In > Out
Apr 2020,70,89,36,8027953,65088619,73116572,19,35,4,57060666,In > Out
Apr 2020,70,91,899,168723136,4256036052,4424759188,241,855,7,4087312916,In > Out
Apr 2020,70,92,179,73763301,1356330467,1430093768,62,179,3,1282567166,In > Out
Apr 2020,70,94,452,286035314,2779910434,3065945748,113,440,12,2493875120,In > Out
Apr 2020,70,95,679,57335492,1682590829,1739926321,182,662,5,1625255337,In > Out
Apr 2020,70,96,686,120773210,1631856016,1752629226,168,679,5,1511082806,In > Out
Apr 2020,72,35,2,197338,321346,518684,1,2,1,124008,In > Out
Apr 2020,73,10,387,9456659,69777843,79234502,6,384,2,60321184,In > Out
Apr 2020,73,100,336,78056428,7684434317,7762490745,47,336,2,7606377889,In > Out
Apr 2020,73,102,49,12847276,53438849,66286125,35,49,2,40591573,In > Out
Apr 2020,73,104,12,5774984,355634683,361409667,5,12,2,349859699,In > Out
Apr 2020,73,105,121,14497554,370244442,384741996,52,120,2,355746888,In > Out
Apr 2020,73,107,122,10747176,373922686,384669862,43,122,2,363175510,In > Out
Apr 2020,73,108,448,22726934,757653405,780380339,85,446,2,734926471,In > Out
Apr 2020,73,109,383,62242902,2100253852,2162496754,64,380,2,2038010950,In > Out
Apr 2020,73,11,30,2121384,47687456,49808840,9,30,1,45566072,In > Out
Apr 2020,73,111,2703,127976428,3845192385,3973168813,434,2513,2,3717215957,In > Out
Apr 2020,73,113,91,32999971,1974216545,2007216516,23,91,2,1941216574,In > Out
Apr 2020,73,115,285,57398004,6446016100,6503414104,45,285,2,6388618096,In > Out
Apr 2020,73,117,2182,447514973,3080149963,3527664936,272,2065,4,2632634990,In > Out
Apr 2020,73,12,42,6085033,46819948,52904981,23,42,2,40734915,In > Out
Apr 2020,73,120,1823,2237059447,1259857303,3496916750,175,1764,2,977202144,Out > In
Apr 2020,73,121,721,58089429,830217376,888306805,187,713,3,772127947,In > Out
Apr 2020,73,122,235,83268274,9267543544,9350811818,43,235,2,9184275270,In > Out
Apr 2020,73,123,258,84098746,6281307415,6365406161,31,258,2,6197208669,In > Out
Apr 2020,73,127,2411,223800691,4434329210,4658129901,314,2173,3,4210528519,In > Out
Apr 2020,73,13,859,69852368,2649301832,2719154200,214,857,2,2579449464,In > Out
Apr 2020,73,130,4853,389292082,5890258900,6279550982,319,4184,4,5500966818,In > Out
Apr 2020,73,131,1,8821,334456,343277,1,1,1,325635,In > Out
Apr 2020,73,134,83,9744161,400538245,410282406,36,83,2,390794084,In > Out
Apr 2020,73,137,640,4927448151,4749512480,9676960631,42,640,3,177935671,Out > In
Apr 2020,73,138,1599,152965154,4842790666,4995755820,316,1508,3,4689825512,In > Out
Apr 2020,73,14,21,1928025,230297067,232225092,11,21,2,228369042,In > Out
Apr 2020,73,143,692,130694034,508168186,638862220,45,672,4,377474152,In > Out
Apr 2020,73,145,522,173302778,8021971534,8195274312,39,522,2,7848668756,In > Out
Apr 2020,73,148,3,638086,217264,855350,2,1,1,420822,Out > In
Apr 2020,73,157,18,6647628,6761812,13409440,11,10,5,114184,In > Out
Apr 2020,73,160,82,4842435,75272888,80115323,17,82,2,70430453,In > Out
Apr 2020,73,162,26,6216001,297287177,303503178,7,26,2,291071176,In > Out
Apr 2020,73,163,1073,123746226,1786261533,1910007759,97,1047,2,1662515307,In > Out
Apr 2020,73,166,58,1880600,21135672,23016272,11,58,2,19255072,In > Out
Apr 2020,73,168,163,242902550,17734078944,17976981494,4,163,2,17491176394,In > Out
Apr 2020,73,169,1973,233529088,3813192898,4046721986,290,1831,3,3579663810,In > Out
Apr 2020,73,17,1300,218549299,11769234930,11987784229,53,1298,2,11550685631,In > Out
Apr 2020,73,172,1829,226770354,16358731600,16585501954,442,1775,4,16131961246,In > Out
Apr 2020,73,18,69,8133753,1212129300,1220263053,13,69,2,1203995547,In > Out
Apr 2020,73,181,22909,21441890002,71867693502,93309583504,2267,13323,26,50425803500,In > Out
Apr 2020,73,182,2,142033,273897,415930,2,2,1,131864,In > Out
Apr 2020,73,189,1,171353,14886,186239,1,1,1,156467,Out > In
Apr 2020,73,19,22,6430193,1047076153,1053506346,14,22,2,1040645960,In > Out
Apr 2020,73,190,189,1494272,26810344,28304616,2,189,2,25316072,In > Out
Apr 2020,73,193,1,192082,9039,201121,1,1,1,183043,Out > In
Apr 2020,73,195,78,1051228,11511470,12562698,4,78,3,10460242,In > Out
Apr 2020,73,196,84,7256288,905991735,913248023,23,80,2,898735447,In > Out
Apr 2020,73,198,72,955614,9086817,10042431,2,72,2,8131203,In > Out
Apr 2020,73,20,25,274746,4023501,4298247,10,25,1,3748755,In > Out
Apr 2020,73,201,1290,68603401,361344090,429947491,64,1273,2,292740689,In > Out
Apr 2020,73,207,1240,161600545,1265268790,1426869335,85,1199,2,1103668245,In > Out
Apr 2020,73,211,292,29966138,1194979227,1224945365,59,290,3,1165013089,In > Out
Apr 2020,73,215,1254,358987625,1445337867,1804325492,108,1239,2,1086350242,In > Out
Apr 2020,73,217,6,291323,1101007,1392330,2,6,6,809684,In > Out
Apr 2020,73,218,93,14936640,536962793,551899433,46,93,3,522026153,In > Out
Apr 2020,73,22,309,178838694,10207493108,10386331802,42,309,2,10028654414,In > Out
Apr 2020,73,220,175,1656773,24089487,25746260,2,174,2,22432714,In > Out
Apr 2020,73,23,2,797664,29686304,30483968,1,2,1,28888640,In > Out
Apr 2020,73,237,365,18221575969,276711845,18498287814,227,1,247,17944864124,Out > In
Apr 2020,73,245,71,1629068,48603529,50232597,14,71,1,46974461,In > Out
Apr 2020,73,25,150,22362910,212509796,234872706,89,150,2,190146886,In > Out
Apr 2020,73,27,373,88627669,4005070781,4093698450,32,373,2,3916443112,In > Out
Apr 2020,73,28,150,34306117,2049909217,2084215334,25,149,2,2015603100,In > Out
Apr 2020,73,29,7,391582,420798,812380,2,7,1,29216,In > Out
Apr 2020,73,30,60,16897874,953086900,969984774,25,60,2,936189026,In > Out
Apr 2020,73,31,42,319656456,68934477,388590933,38,1,13,250721979,Out > In
Apr 2020,73,32,45,364002000,81328855,445330855,42,1,18,282673145,Out > In
Apr 2020,73,34,187,21742906,1999760304,2021503210,67,186,2,1978017398,In > Out
Apr 2020,73,36,627,35359079,3471538262,3506897341,47,626,2,3436179183,In > Out
Apr 2020,73,37,239,31577489,302793762,334371251,23,239,2,271216273,In > Out
Apr 2020,73,38,535,81448765,3742767167,3824215932,105,535,3,3661318402,In > Out
Apr 2020,73,39,293,194602525,11051110470,11245712995,39,293,2,10856507945,In > Out
Apr 2020,73,4,396,181350550,6678576218,6859926768,14,392,8,6497225668,In > Out
Apr 2020,73,41,1403,3051770586,8696824029,11748594615,266,1352,5,5645053443,In > Out
Apr 2020,73,45,2592,207019237,4669749022,4876768259,545,2453,4,4462729785,In > Out
Apr 2020,73,46,2,1300613,55000,1355613,1,2,1,1245613,Out > In
Apr 2020,73,47,1180,117161941,2583116349,2700278290,225,1149,2,2465954408,In > Out
Apr 2020,73,5,46,17940666,57966989,75907655,27,46,2,40026323,In > Out
Apr 2020,73,53,42,6919591,658834005,665753596,23,42,2,651914414,In > Out
Apr 2020,73,54,13,5559723,469672538,475232261,3,13,2,464112815,In > Out
Apr 2020,73,57,20,4423377,132118568,136541945,11,20,2,127695191,In > Out
Apr 2020,73,58,1967,387964687,4653450281,5041414968,320,1830,3,4265485594,In > Out
Apr 2020,73,59,630,147780154,12391136950,12538917104,144,617,2,12243356796,In > Out
Apr 2020,73,6,46,3441316,45278810,48720126,26,46,2,41837494,In > Out
Apr 2020,73,69,221,428878565,26930620818,27359499383,8,217,2,26501742253,In > Out
Apr 2020,73,7,2,2061612,143791725,145853337,2,2,1,141730113,In > Out
Apr 2020,73,72,1730,187484469,2538994900,2726479369,300,1683,3,2351510431,In > Out
Apr 2020,73,74,6,11271453,646614987,657886440,5,6,2,635343534,In > Out
Apr 2020,73,76,1017,157402864,2446200537,2603603401,179,989,2,2288797673,In > Out
Apr 2020,73,77,2,26099412,877456405,903555817,2,2,2,851356993,In > Out
Apr 2020,73,78,158,134494043,11176060916,11310554959,25,158,2,11041566873,In > Out
Apr 2020,73,79,2700,520109301,8220802877,8740912178,215,2486,4,7700693576,In > Out
Apr 2020,73,8,12,54076,3365440,3419516,5,12,1,3311364,In > Out
Apr 2020,73,80,4792,390106734,6373257503,6763364237,342,4077,4,5983150769,In > Out
Apr 2020,73,81,1,2314145,161115123,163429268,1,1,1,158800978,In > Out
Apr 2020,73,83,288,42239516,2679783402,2722022918,91,288,2,2637543886,In > Out
Apr 2020,73,86,314,60440445,12668009095,12728449540,45,308,2,12607568650,In > Out
Apr 2020,73,9,30,4753642,218490754,223244396,16,30,1,213737112,In > Out
Apr 2020,73,90,545,6391151,413207817,419598968,27,545,2,406816666,In > Out
Apr 2020,73,91,902,128794428,2261183745,2389978173,96,880,2,2132389317,In > Out
Apr 2020,73,92,386,24390303,2669263686,2693653989,32,381,2,2644873383,In > Out
Apr 2020,73,94,1,166349,9734,176083,1,1,1,156615,Out > In
Apr 2020,73,99,1026,92548131,2332234699,2424782830,306,995,3,2239686568,In > Out
Apr 2020,74,10,379,68058147,521131244,589189391,72,376,3,453073097,In > Out
Apr 2020,74,104,8,2678786215,61376890,2740163105,7,8,4,2617409325,Out > In
Apr 2020,74,105,115,23054063,1275637766,1298691829,37,115,3,1252583703,In > Out
Apr 2020,74,106,85,27532188,1355213091,1382745279,32,85,2,1327680903,In > Out
Apr 2020,74,113,89,33367800,1719093072,1752460872,27,89,2,1685725272,In > Out
Apr 2020,74,114,2062,842587755,5653843728,6496431483,632,1768,6,4811255973,In > Out
Apr 2020,74,120,23,117281181,532234329,649515510,13,23,2,414953148,In > Out
Apr 2020,74,125,831,58766994,826105533,884872527,257,809,2,767338539,In > Out
Apr 2020,74,13,35,1734447,57778543,59512990,20,35,2,56044096,In > Out
Apr 2020,74,134,35,5239440,171824135,177063575,21,35,2,166584695,In > Out
Apr 2020,74,135,200,7487566,406038014,413525580,60,199,2,398550448,In > Out
Apr 2020,74,145,71,2398597,145351238,147749835,18,71,2,142952641,In > Out
Apr 2020,74,147,133,5130870,718859414,723990284,49,131,2,713728544,In > Out
Apr 2020,74,152,97,14535732,934500952,949036684,31,96,3,919965220,In > Out
Apr 2020,74,154,1,156146,55648,211794,1,1,1,100498,Out > In
Apr 2020,74,155,16,1074587,4529112,5603699,11,13,2,3454525,In > Out
Apr 2020,74,162,236,114236882,452249069,566485951,61,235,2,338012187,In > Out
Apr 2020,74,169,854,172765987,920128174,1092894161,135,837,4,747362187,In > Out
Apr 2020,74,170,3007,27153247695,4943588040,32096835735,591,2745,8,22209659655,Out > In
Apr 2020,74,172,1,6021,156727,162748,1,1,1,150706,In > Out
Apr 2020,74,175,53,4896571,207572108,212468679,21,53,2,202675537,In > Out
Apr 2020,74,179,194,23593171,336309778,359902949,85,193,2,312716607,In > Out
Apr 2020,74,182,2,83421,342879,426300,2,2,2,259458,In > Out
Apr 2020,74,195,102,5392264,211266698,216658962,17,102,2,205874434,In > Out
Apr 2020,74,200,33,2438942,129224397,131663339,18,33,2,126785455,In > Out
Apr 2020,74,202,51,9155613,26255829,35411442,27,51,1,17100216,In > Out
Apr 2020,74,203,22,1190058,21441987,22632045,9,22,2,20251929,In > Out
Apr 2020,74,21,1825,541653998,4615682043,5157336041,184,1825,4,4074028045,In > Out
Apr 2020,74,216,4,864652,67103,931755,3,4,1,797549,Out > In
Apr 2020,74,217,716,74306228,263886562,338192790,87,703,2,189580334,In > Out
Apr 2020,74,218,88,20233739,834825360,855059099,43,88,2,814591621,In > Out
Apr 2020,74,219,17,823990,23956919,24780909,9,17,1,23132929,In > Out
Apr 2020,74,221,3296,995193231,5793301532,6788494763,192,3132,3,4798108301,In > Out
Apr 2020,74,222,645,105685713,1305528145,1411213858,75,645,2,1199842432,In > Out
Apr 2020,74,23,90,30835398,2755792561,2786627959,12,90,3,2724957163,In > Out
Apr 2020,74,230,41,5172189,397996612,403168801,22,38,4,392824423,In > Out
Apr 2020,74,247,251,10822133,330961679,341783812,71,248,2,320139546,In > Out
Apr 2020,74,251,125,55222557,509903744,565126301,71,125,2,454681187,In > Out
Apr 2020,74,39,48,21649411,89730088,111379499,26,48,3,68080677,In > Out
Apr 2020,74,40,187,17226595,751974541,769201136,68,187,2,734747946,In > Out
Apr 2020,74,41,192,31023944,1663066022,1694089966,54,192,2,1632042078,In > Out
Apr 2020,74,43,313,13553107,198042432,211595539,88,308,2,184489325,In > Out
Apr 2020,74,44,249,17407708,1269797999,1287205707,38,249,2,1252390291,In > Out
Apr 2020,74,45,49,3558073,4578874,8136947,12,15,2,1020801,In > Out
Apr 2020,74,50,63,2697842,134332060,137029902,22,63,2,131634218,In > Out
Apr 2020,74,52,143,307631741,106912895,414544636,92,14,36,200718846,Out > In
Apr 2020,74,57,97,7283712,533081223,540364935,38,97,2,525797511,In > Out
Apr 2020,74,58,1278,110273133,1504209411,1614482544,282,1045,3,1393936278,In > Out
Apr 2020,74,64,76,3719582,142796550,146516132,23,76,2,139076968,In > Out
Apr 2020,74,65,33,3159874,144204795,147364669,16,33,2,141044921,In > Out
Apr 2020,74,68,286,85921747,529471338,615393085,61,286,1,443549591,In > Out
Apr 2020,74,70,86,15472841,333930316,349403157,48,86,2,318457475,In > Out
Apr 2020,74,72,1382,517753838,4391279596,4909033434,460,1357,2,3873525758,In > Out
Apr 2020,74,79,2,36068,897935,934003,2,2,1,861867,In > Out
Apr 2020,74,87,44,4015070,40033054,44048124,27,44,2,36017984,In > Out
Apr 2020,74,88,10,396059,38623571,39019630,8,10,1,38227512,In > Out
Apr 2020,74,89,443,46380772,795110220,841490992,152,443,3,748729448,In > Out
Apr 2020,74,94,159,16050719,160811341,176862060,72,159,2,144760622,In > Out
Apr 2020,74,99,57,4792256,253197609,257989865,15,57,2,248405353,In > Out
Apr 2020,75,213,1370,188713449,2109698835,2298412284,122,1344,2,1920985386,In > Out
Apr 2020,76,184,1,1206,134463,135669,1,1,1,133257,In > Out
Apr 2020,77,121,6,109591,1263254,1372845,1,6,1,1153663,In > Out
Apr 2020,77,122,19,713115,2260914,2974029,5,5,2,1547799,In > Out
Apr 2020,77,123,6,136472,1419164,1555636,1,6,1,1282692,In > Out
Apr 2020,77,134,104,223784,11920282,12144066,1,103,1,11696498,In > Out
Apr 2020,77,231,2649,1049971351,5609887326,6659858677,654,2470,24,4559915975,In > Out
Apr 2020,79,10,5,39582,2387475,2427057,2,5,1,2347893,In > Out
Apr 2020,79,11,967,34702491,32976950222,33011652713,59,941,4,32942247731,In > Out
Apr 2020,79,14,986,4028375008,560340581255,564368956263,82,959,85,556312206247,In > Out
Apr 2020,79,20,4,201543,23350987,23552530,3,4,2,23149444,In > Out
Apr 2020,79,21,2,8172,687484,695656,2,2,1,679312,In > Out
Apr 2020,79,9,3,156566,27003750,27160316,2,3,1,26847184,In > Out
Apr 2020,80,133,66,3677408,119044289,122721697,9,66,2,115366881,In > Out
Apr 2020,80,51,418,200468504,2220867775,2421336279,152,413,6,2020399271,In > Out
Apr 2020,80,93,137,2575617,34060624,36636241,16,137,2,31485007,In > Out
Apr 2020,81,139,354,107260063,15131741,122391804,1,354,1,92128322,Out > In
Apr 2020,81,26,23,2186847523,61134792,2247982315,3,23,2,2125712731,Out > In
Apr 2020,81,28,6,1158369,356448,1514817,1,6,1,801921,Out > In
Apr 2020,81,29,1,105124,15090,120214,1,1,1,90034,Out > In
Apr 2020,81,30,33,469894281,13915873,483810154,6,33,2,455978408,Out > In
Apr 2020,81,31,23,1161575330,34226233,1195801563,5,23,2,1127349097,Out > In
Apr 2020,81,32,11,14616300,629065,15245365,3,11,2,13987235,Out > In
Apr 2020,81,33,1,638194,22671,660865,1,1,1,615523,Out > In
Apr 2020,81,35,161,27747022,2951647360,2979394382,35,161,2,2923900338,In > Out
Apr 2020,81,45,429,335968270,913898789,1249867059,4,423,2,577930519,In > Out
Apr 2020,82,103,663,94764657,3298332652,3393097309,92,655,2,3203567995,In > Out
Apr 2020,82,104,11,286038,10178779,10464817,7,11,2,9892741,In > Out
Apr 2020,82,109,14,259639,16476395,16736034,8,14,2,16216756,In > Out
Apr 2020,82,128,104,5332269,419016276,424348545,22,104,2,413684007,In > Out
Apr 2020,82,129,109,25684700,1020668655,1046353355,32,109,2,994983955,In > Out
Apr 2020,82,132,82,8861707,282104928,290966635,41,82,2,273243221,In > Out
Apr 2020,82,142,654,1092886937,1183456188,2276343125,208,451,112,90569251,In > Out
Apr 2020,82,151,364,22596454,148215610,170812064,32,362,5,125619156,In > Out
Apr 2020,82,162,71,10553839,396649330,407203169,13,71,2,386095491,In > Out
Apr 2020,82,204,1,163096,79328,242424,1,1,1,83768,Out > In
Apr 2020,82,208,1,7942,335486,343428,1,1,1,327544,In > Out
Apr 2020,82,224,224,6633961,70534948,77168909,24,224,2,63900987,In > Out
Apr 2020,82,235,118,1186577,355829376,357015953,15,118,2,354642799,In > Out
Apr 2020,82,239,12,325491,1645102,1970593,7,11,1,1319611,In > Out
Apr 2020,82,241,1,169394,18104,187498,1,1,1,151290,Out > In
Apr 2020,82,42,33,2099260,98017785,100117045,19,33,2,95918525,In > Out
Apr 2020,82,58,13,656549,14263028,14919577,5,13,2,13606479,In > Out
Apr 2020,82,77,2,109688,126634,236322,2,2,1,16946,In > Out
Apr 2020,82,85,6,15619344,73448404,89067748,6,6,2,57829060,In > Out
Apr 2020,82,86,178,10133608,627725576,637859184,10,176,2,617591968,In > Out
Apr 2020,82,87,238,13378722,787572896,800951618,22,238,2,774194174,In > Out
Apr 2020,82,92,1652,160410610,5826784454,5987195064,497,1590,3,5666373844,In > Out
Apr 2020,82,99,7,60143,3244599,3304742,1,7,1,3184456,In > Out
Apr 2020,83,107,116,27009396,506188131,533197527,38,111,6,479178735,In > Out
Apr 2020,83,112,21,27859325,2093105132,2120964457,15,21,3,2065245807,In > Out
Apr 2020,83,113,907,1120432854,1106689846,2227122700,112,884,2,13743008,Out > In
Apr 2020,83,114,113,22756319,747054887,769811206,37,113,2,724298568,In > Out
Apr 2020,83,121,32,5073515,231597406,236670921,8,32,2,226523891,In > Out
Apr 2020,83,146,116,49447409,2226529594,2275977003,36,116,2,2177082185,In > Out
Apr 2020,83,149,169,59610454,3236138657,3295749111,67,168,2,3176528203,In > Out
Apr 2020,83,152,149,23402880,1110420260,1133823140,42,149,3,1087017380,In > Out
Apr 2020,83,153,158,19755992,835055627,854811619,42,157,2,815299635,In > Out
Apr 2020,83,156,110,31385549,2863870816,2895256365,40,110,2,2832485267,In > Out
Apr 2020,83,158,9,161810,4246509,4408319,5,9,2,4084699,In > Out
Apr 2020,83,161,630,63145261,2788578939,2851724200,54,625,2,2725433678,In > Out
Apr 2020,83,163,389,27832978,968333517,996166495,106,385,2,940500539,In > Out
Apr 2020,83,165,125,12061043,687129912,699190955,36,125,2,675068869,In > Out
Apr 2020,83,166,622,68298196,1448320810,1516619006,59,622,3,1380022614,In > Out
Apr 2020,84,36,1155,464783887,6936894313,7401678200,270,1123,10,6472110426,In > Out
Apr 2020,85,100,3,23516,2925185,2948701,2,3,1,2901669,In > Out
Apr 2020,85,101,135,2783454,398696477,401479931,23,134,2,395913023,In > Out
Apr 2020,85,102,492,19448679,278289736,297738415,106,492,2,258841057,In > Out
Apr 2020,85,103,26,1836407,13361353,15197760,15,26,2,11524946,In > Out
Apr 2020,85,104,43,5454549619,141416926,5595966545,24,42,3,5313132693,Out > In
Apr 2020,85,105,6,1414187,221940842,223355029,4,6,2,220526655,In > Out
Apr 2020,85,106,162,3450799273,414180975,3864980248,78,159,2,3036618298,Out > In
Apr 2020,85,107,299,459701215,293757585,753458800,146,298,5,165943630,Out > In
Apr 2020,85,110,332,116271463,1502011256,1618282719,120,332,6,1385739793,In > Out
Apr 2020,85,111,332,14859279,1901427083,1916286362,52,332,2,1886567804,In > Out
Apr 2020,85,112,338,114295367,382318049,496613416,156,327,5,268022682,In > Out
Apr 2020,85,114,664,100885612,802814116,903699728,109,664,2,701928504,In > Out
Apr 2020,85,117,202,478058592,394286833,872345425,69,202,3,83771759,Out > In
Apr 2020,85,118,392,138968816,1325107764,1464076580,162,391,4,1186138948,In > Out
Apr 2020,85,119,165,50595881,1698408370,1749004251,86,164,5,1647812489,In > Out
Apr 2020,85,120,4,1071167,83881,1155048,4,4,1,987286,Out > In
Apr 2020,85,121,963,57604766,2412282459,2469887225,223,953,2,2354677693,In > Out
Apr 2020,85,122,188,205098434,458353080,663451514,68,188,3,253254646,In > Out
Apr 2020,85,123,332,3856529072,1230503470,5087032542,111,330,5,2626025602,Out > In
Apr 2020,85,124,424,905775013,1792790301,2698565314,165,418,4,887015288,In > Out
Apr 2020,85,126,460,542087149,1108628009,1650715158,224,460,3,566540860,In > Out
Apr 2020,85,127,762,6771486553,4357060547,11128547100,261,745,7,2414426006,Out > In
Apr 2020,85,130,470,16468445726,545725019,17014170745,102,466,3,15922720707,Out > In
Apr 2020,85,131,501,262553678,887731523,1150285201,221,497,6,625177845,In > Out
Apr 2020,85,132,327,3308113302,3573485687,6881598989,157,325,11,265372385,In > Out
Apr 2020,85,133,496,236555146,914758570,1151313716,235,484,4,678203424,In > Out
Apr 2020,85,134,373,12880726627,1192806250,14073532877,168,371,3,11687920377,Out > In
Apr 2020,85,135,872,1460312493,2443302282,3903614775,147,870,5,982989789,In > Out
Apr 2020,85,136,8,1468639,1056327666,1057796305,5,8,2,1054859027,In > Out
Apr 2020,85,137,11,110016,2707790,2817806,4,11,2,2597774,In > Out
Apr 2020,85,138,1,19667,6408037,6427704,1,1,1,6388370,In > Out
Apr 2020,85,139,409,23852386,629441955,653294341,106,408,3,605589569,In > Out
Apr 2020,85,140,466,50239746,2918798324,2969038070,137,459,2,2868558578,In > Out
Apr 2020,85,142,401,18243795,2060636223,2078880018,54,401,2,2042392428,In > Out
Apr 2020,85,147,113,1851158,300367310,302218468,22,113,2,298516152,In > Out
Apr 2020,85,149,16,605773,68220952,68826725,9,16,2,67615179,In > Out
Apr 2020,85,15,31,2183411,119236414,121419825,14,31,2,117053003,In > Out
Apr 2020,85,153,84,4535123,97302216,101837339,31,84,2,92767093,In > Out
Apr 2020,85,155,475,44046453,1678339518,1722385971,220,475,3,1634293065,In > Out
Apr 2020,85,16,46,13194091700,4756724082,17950815782,24,1,4,8437367618,Out > In
Apr 2020,85,168,38,3769021,309382210,313151231,27,38,2,305613189,In > Out
Apr 2020,85,170,590,25824113,2748694674,2774518787,52,572,2,2722870561,In > Out
Apr 2020,85,23,16,559864,24197585,24757449,7,16,2,23637721,In > Out
Apr 2020,85,24,11,152230,24577254,24729484,3,11,1,24425024,In > Out
Apr 2020,85,28,169,11414051,1181012745,1192426796,61,169,2,1169598694,In > Out
Apr 2020,85,30,25,1908648,74048610,75957258,15,25,2,72139962,In > Out
Apr 2020,85,31,6,322547,338796,661343,2,6,1,16249,In > Out
Apr 2020,85,42,1,185633,18698,204331,1,1,1,166935,Out > In
Apr 2020,85,44,7,1345354,29090669,30436023,7,7,2,27745315,In > Out
Apr 2020,85,48,214,86843786,155467155,242310941,23,214,2,68623369,In > Out
Apr 2020,85,49,1,10607,888574,899181,1,1,1,877967,In > Out
Apr 2020,85,51,149,9095680,1351641456,1360737136,35,149,2,1342545776,In > Out
Apr 2020,85,52,59,4963750,77588844,82552594,21,58,2,72625094,In > Out
Apr 2020,85,53,21,2847920,476009082,478857002,6,21,2,473161162,In > Out
Apr 2020,85,54,4,365172,56699888,57065060,3,4,1,56334716,In > Out
Apr 2020,85,55,149,7904741,76806203,84710944,42,149,2,68901462,In > Out
Apr 2020,85,56,351,22338644,416314763,438653407,148,349,2,393976119,In > Out
Apr 2020,85,59,7,423629,175261919,175685548,4,7,2,174838290,In > Out
Apr 2020,85,6,72,11144483,188285091,199429574,29,71,2,177140608,In > Out
Apr 2020,85,60,15,927754,225199298,226127052,6,15,2,224271544,In > Out
Apr 2020,85,61,22,1145555,15034718,16180273,13,22,2,13889163,In > Out
Apr 2020,85,62,17,290872,12676948,12967820,8,17,2,12386076,In > Out
Apr 2020,85,63,12,145038,6895176,7040214,5,12,2,6750138,In > Out
Apr 2020,85,64,10,909294,40999167,41908461,5,10,2,40089873,In > Out
Apr 2020,85,65,559,26782757,717048181,743830938,81,552,3,690265424,In > Out
Apr 2020,85,66,266,18716088,475128793,493844881,131,265,2,456412705,In > Out
Apr 2020,85,67,58,3868403,234414349,238282752,26,58,2,230545946,In > Out
Apr 2020,85,69,73,4002951,184717983,188720934,33,73,2,180715032,In > Out
Apr 2020,85,7,2,3784,233334,237118,2,2,1,229550,In > Out
Apr 2020,85,75,652,51026987,1010459795,1061486782,235,649,2,959432808,In > Out
Apr 2020,85,77,116,6898660,318592894,325491554,63,116,2,311694234,In > Out
Apr 2020,85,78,3,55858,27891175,27947033,3,3,2,27835317,In > Out
Apr 2020,85,79,17,195819,4179503,4375322,10,17,2,3983684,In > Out
Apr 2020,85,81,22,784638,99690817,100475455,12,22,2,98906179,In > Out
Apr 2020,85,82,5,199506,92516791,92716297,4,5,2,92317285,In > Out
Apr 2020,85,83,6,324638,144930512,145255150,4,6,2,144605874,In > Out
Apr 2020,85,84,7,376760,138011852,138388612,5,7,2,137635092,In > Out
Apr 2020,85,85,5,1488834,11112965,12601799,4,5,2,9624131,In > Out
Apr 2020,85,86,7,807020,1998424,2805444,3,7,1,1191404,In > Out
Apr 2020,85,87,9,267628,71313424,71581052,5,9,2,71045796,In > Out
Apr 2020,85,88,31,1893685,130991722,132885407,14,31,2,129098037,In > Out
Apr 2020,85,89,6,88209,1217093,1305302,3,6,2,1128884,In > Out
Apr 2020,85,93,15,73875,2319548,2393423,12,15,2,2245673,In > Out
Apr 2020,86,198,9,33436,1256404,1289840,1,9,1,1222968,In > Out
Apr 2020,88,22,7,206428,4274537,4480965,1,7,1,4068109,In > Out
Apr 2020,89,100,95,3858652,199128555,202987207,12,95,2,195269903,In > Out
Apr 2020,89,104,1,3675,172809,176484,1,1,1,169134,In > Out
Apr 2020,89,107,292,43677355,825287403,868964758,72,290,2,781610048,In > Out
Apr 2020,89,109,15,7235282,1382512713,1389747995,8,15,2,1375277431,In > Out
Apr 2020,89,111,367,12955639,1914529396,1927485035,45,367,2,1901573757,In > Out
Apr 2020,89,115,374,16293170,2023613638,2039906808,51,369,2,2007320468,In > Out
Apr 2020,89,121,20,2429855,58252827,60682682,12,20,2,55822972,In > Out
Apr 2020,89,127,112,13648819,1219238088,1232886907,38,112,2,1205589269,In > Out
Apr 2020,89,128,83,11623818,382963944,394587762,29,83,2,371340126,In > Out
Apr 2020,89,130,3835,1932891476,10375773332,12308664808,210,3463,3,8442881856,In > Out
Apr 2020,89,131,187,114516607,181642293,296158900,46,187,2,67125686,In > Out
Apr 2020,89,136,430,89694615,1149276244,1238970859,95,426,3,1059581629,In > Out
Apr 2020,89,14,1,15328836,82496,15411332,1,1,1,15246340,Out > In
Apr 2020,89,140,150,62179992,2115463142,2177643134,49,150,2,2053283150,In > Out
Apr 2020,89,141,1174,109731429,824058719,933790148,365,1120,3,714327290,In > Out
Apr 2020,89,20,15,50054,5855339,5905393,4,15,5,5805285,In > Out
Apr 2020,89,21,11,31199,3907018,3938217,5,11,5,3875819,In > Out
Apr 2020,89,50,3,1368427,174694,1543121,3,3,1,1193733,Out > In
Apr 2020,89,51,432,49352120,513125761,562477881,181,425,2,463773641,In > Out
Apr 2020,89,52,358,190493293,1251316194,1441809487,131,356,3,1060822901,In > Out
Apr 2020,89,56,57,10190766,559593528,569784294,23,57,2,549402762,In > Out
Apr 2020,89,57,2,46739,8433405,8480144,2,2,1,8386666,In > Out
Apr 2020,89,59,3,37506,7267661,7305167,2,3,1,7230155,In > Out
Apr 2020,89,60,388,80704960,521476358,602181318,95,387,6,440771398,In > Out
Apr 2020,89,63,1,88121,12722996,12811117,1,1,1,12634875,In > Out
Apr 2020,89,65,102,646292640,254805473,901098113,50,102,2,391487167,Out > In
Apr 2020,89,67,12,1081637,14158711,15240348,9,12,2,13077074,In > Out
Apr 2020,89,70,25,1639617,231561451,233201068,9,25,1,229921834,In > Out
Apr 2020,89,73,65,1374940,188486898,189861838,22,65,2,187111958,In > Out
Apr 2020,89,77,927,754658405,1875690265,2630348670,184,906,2,1121031860,In > Out
Apr 2020,89,79,12,621361,26731957,27353318,4,12,1,26110596,In > Out
Apr 2020,89,80,252,6034986,604047150,610082136,67,251,2,598012164,In > Out
Apr 2020,89,82,1191,464401964,973689905,1438091869,189,1141,3,509287941,In > Out
Apr 2020,89,83,104,11334721,29949689,41284410,36,103,2,18614968,In > Out
Apr 2020,89,85,319,25726754,2571879676,2597606430,46,318,2,2546152922,In > Out
Apr 2020,89,88,43,6835536,17862337,24697873,26,43,2,11026801,In > Out
Apr 2020,89,94,46,2852921,146522995,149375916,16,46,2,143670074,In > Out
Apr 2020,89,98,1668,285161230,687079871,972241101,217,1588,3,401918641,In > Out
Apr 2020,9,153,184,50948889,2564325705,2615274594,67,180,2,2513376816,In > Out
Apr 2020,9,155,149,9120079,159097535,168217614,83,149,3,149977456,In > Out
Apr 2020,9,157,4,192405,17520272,17712677,4,4,2,17327867,In > Out
Apr 2020,9,158,280,5958418,1198838711,1204797129,39,280,2,1192880293,In > Out
Apr 2020,9,162,285,16940494,808842055,825782549,68,285,2,791901561,In > Out
Apr 2020,9,168,12,411219,17629511,18040730,5,12,1,17218292,In > Out
Apr 2020,9,2,1,140036,21646,161682,1,1,1,118390,Out > In
Apr 2020,9,51,74,12256733,91686062,103942795,32,74,3,79429329,In > Out
Apr 2020,9,52,357,12279891,2213540766,2225820657,46,354,2,2201260875,In > Out
Apr 2020,9,56,582,89402139,911042076,1000444215,195,578,4,821639937,In > Out
Apr 2020,9,59,352,8801157,501186732,509987889,23,352,2,492385575,In > Out
Apr 2020,9,61,47,11208521,413058379,424266900,18,47,2,401849858,In > Out
Apr 2020,9,62,10,2183905,58723646,60907551,7,10,2,56539741,In > Out
Apr 2020,90,10,491,59228924,65552376,124781300,29,491,2,6323452,In > Out
Apr 2020,90,100,195,20981189,804628715,825609904,20,192,2,783647526,In > Out
Apr 2020,90,102,181,41162013,2253151450,2294313463,55,179,2,2211989437,In > Out
Apr 2020,90,104,263,8811586,85614469,94426055,26,262,2,76802883,In > Out
Apr 2020,90,117,1,3273,131397,134670,1,1,1,128124,In > Out
Apr 2020,90,118,581,246615747,2142971805,2389587552,37,581,2,1896356058,In > Out
Apr 2020,90,12,577,117496296,5434401933,5551898229,178,561,4,5316905637,In > Out
Apr 2020,90,121,12,134969,4508100,4643069,5,12,1,4373131,In > Out
Apr 2020,90,124,89,257999707,1818125251,2076124958,27,89,1,1560125544,In > Out
Apr 2020,90,126,1203,796808207,3244190987,4040999194,76,1156,3,2447382780,In > Out
Apr 2020,90,127,4,409015,145786854,146195869,3,4,1,145377839,In > Out
Apr 2020,90,136,12,373758,9103104,9476862,6,12,2,8729346,In > Out
Apr 2020,90,14,111,5830426,225940063,231770489,66,111,2,220109637,In > Out
Apr 2020,90,17,112,62009804,2775056416,2837066220,57,111,2,2713046612,In > Out
Apr 2020,90,18,11,618166,36329332,36947498,3,11,1,35711166,In > Out
Apr 2020,90,19,2,7893,240162,248055,2,2,1,232269,In > Out
Apr 2020,90,20,157,16946596,1791583185,1808529781,56,157,2,1774636589,In > Out
Apr 2020,90,214,116,8221512,92813162,101034674,31,116,2,84591650,In > Out
Apr 2020,90,22,156,46707271,1510354237,1557061508,82,156,2,1463646966,In > Out
Apr 2020,90,220,629,118224785,3610196711,3728421496,87,619,2,3491971926,In > Out
Apr 2020,90,230,74,16692461,2028781057,2045473518,12,74,2,2012088596,In > Out
Apr 2020,90,235,605,6052427168,301408527,6353835695,204,129,430,5751018641,Out > In
Apr 2020,90,236,908,2099872915,15917258548,18017131463,145,815,30,13817385633,In > Out
Apr 2020,90,24,1776,168091604,2675440655,2843532259,297,1685,2,2507349051,In > Out
Apr 2020,90,253,4757,2724867754,13889530774,16614398528,599,4342,18,11164663020,In > Out
Apr 2020,90,29,2072,3785770612,5965675485,9751446097,115,2010,7,2179904873,In > Out
Apr 2020,90,3,557,38018011,835528229,873546240,231,557,2,797510218,In > Out
Apr 2020,90,36,37,2133827,67869043,70002870,6,37,2,65735216,In > Out
Apr 2020,90,43,430,229645890,3482205338,3711851228,120,430,23,3252559448,In > Out
Apr 2020,90,44,136,34978348,1535214475,1570192823,63,135,2,1500236127,In > Out
Apr 2020,90,45,885,151701470,333769148,485470618,203,868,2,182067678,In > Out
Apr 2020,90,47,201,215619539,2651175151,2866794690,66,201,4,2435555612,In > Out
Apr 2020,90,48,46,14420379,1232441614,1246861993,23,45,3,1218021235,In > Out
Apr 2020,90,5,712,272037730,1996129751,2268167481,241,703,3,1724092021,In > Out
Apr 2020,90,55,177,228084749,769819492,997904241,10,175,2,541734743,In > Out
Apr 2020,90,58,170,54793522,2664868645,2719662167,55,170,2,2610075123,In > Out
Apr 2020,90,6,393,39594664,1109143824,1148738488,109,384,3,1069549160,In > Out
Apr 2020,90,61,179,33834721,1109286600,1143121321,67,179,2,1075451879,In > Out
Apr 2020,90,62,819,86438199,1434741721,1521179920,271,811,3,1348303522,In > Out
Apr 2020,90,63,389,84136438,3813392719,3897529157,44,389,2,3729256281,In > Out
Apr 2020,90,64,15,5979061,367983419,373962480,7,15,2,362004358,In > Out
Apr 2020,90,66,352,42900006,1998572734,2041472740,45,347,2,1955672728,In > Out
Apr 2020,90,7,785,190915397,2251753332,2442668729,117,776,5,2060837935,In > Out
Apr 2020,90,70,14,1606853,46550836,48157689,4,14,1,44943983,In > Out
Apr 2020,90,74,149,26436786,1444551945,1470988731,40,149,2,1418115159,In > Out
Apr 2020,90,75,93,11084882,1157538281,1168623163,27,93,2,1146453399,In > Out
Apr 2020,90,77,1324,60570700901,1509367138,62080068039,134,1295,2,59061333763,Out > In
Apr 2020,90,8,432,51449822,1338744565,1390194387,55,428,2,1287294743,In > Out
Apr 2020,90,80,138,17523603,470643051,488166654,76,138,3,453119448,In > Out
Apr 2020,90,82,1161,64783967,2713549431,2778333398,63,1122,2,2648765464,In > Out
Apr 2020,90,84,2,87926,3076368,3164294,1,2,1,2988442,In > Out
Apr 2020,91,10,678,60252967,3039849019,3100101986,61,668,2,2979596052,In > Out
Apr 2020,91,11,75,14568843,787971551,802540394,36,75,2,773402708,In > Out
Apr 2020,91,113,179,2748700,91683270,94431970,13,178,2,88934570,In > Out
Apr 2020,91,12,44,3726638,435464331,439190969,28,44,2,431737693,In > Out
Apr 2020,91,14,671,114459975,1931209570,2045669545,114,660,2,1816749595,In > Out
Apr 2020,91,15,199,19543168,621537390,641080558,37,173,3,601994222,In > Out
Apr 2020,91,17,24,8468298,470026105,478494403,8,24,1,461557807,In > Out
Apr 2020,91,19,212,8239886,593836342,602076228,28,210,2,585596456,In > Out
Apr 2020,91,20,619,44953012,1792457323,1837410335,135,619,3,1747504311,In > Out
Apr 2020,91,200,21,3288957,540605407,543894364,8,21,2,537316450,In > Out
Apr 2020,91,21,808,115977370,837212205,953189575,48,799,5,721234835,In > Out
Apr 2020,91,214,41,2724154,97451067,100175221,10,41,2,94726913,In > Out
Apr 2020,91,225,100,72124525,3621139257,3693263782,24,99,2,3549014732,In > Out
Apr 2020,91,226,8,2813358,187559608,190372966,3,8,2,184746250,In > Out
Apr 2020,91,227,104,3510482,122836627,126347109,19,104,2,119326145,In > Out
Apr 2020,91,228,15,697243,164323171,165020414,8,15,1,163625928,In > Out
Apr 2020,91,23,10,137529,8041016,8178545,3,10,2,7903487,In > Out
Apr 2020,91,239,99,5580368,624293164,629873532,23,99,2,618712796,In > Out
Apr 2020,91,27,5,735938,178057576,178793514,4,5,1,177321638,In > Out
Apr 2020,91,28,280,22185460,1572870412,1595055872,88,280,2,1550684952,In > Out
Apr 2020,91,3,200,9924509,1198591004,1208515513,41,200,2,1188666495,In > Out
Apr 2020,91,32,623,52159862,1378290477,1430450339,130,611,2,1326130615,In > Out
Apr 2020,91,34,581,10308005,1877472627,1887780632,5,581,2,1867164622,In > Out
Apr 2020,91,40,90,15805756,2652980050,2668785806,20,89,2,2637174294,In > Out
Apr 2020,91,43,8,3107549,248287158,251394707,6,8,2,245179609,In > Out
Apr 2020,91,44,753,42335054,2495537176,2537872230,127,744,2,2453202122,In > Out
Apr 2020,91,48,78,4056521,210040073,214096594,16,78,2,205983552,In > Out
Apr 2020,91,57,112,14572085,295433216,310005301,17,110,3,280861131,In > Out
Apr 2020,91,58,201,64049579,1873615621,1937665200,58,201,8,1809566042,In > Out
Apr 2020,91,59,362,25095704,917179346,942275050,122,361,4,892083642,In > Out
Apr 2020,91,6,167,20447914,2088576201,2109024115,67,167,4,2068128287,In > Out
Apr 2020,91,62,750,108334718,346216691,454551409,12,743,2,237881973,In > Out
Apr 2020,91,64,90,14298913,445206845,459505758,19,90,2,430907932,In > Out
Apr 2020,91,69,261,12085351,702814401,714899752,19,259,2,690729050,In > Out
Apr 2020,91,8,6,2237247,6792226,9029473,4,6,2,4554979,In > Out
Apr 2020,91,83,319,17584301,2462933364,2480517665,59,312,4,2445349063,In > Out
Apr 2020,91,84,1,199810,20782,220592,1,1,1,179028,Out > In
Apr 2020,91,87,278,19095665,1277108789,1296204454,86,274,2,1258013124,In > Out
Apr 2020,91,89,1085,128579419,2208093955,2336673374,48,1055,2,2079514536,In > Out
Apr 2020,91,90,777,4277551028,2418706770,6696257798,104,773,2,1858844258,Out > In
Apr 2020,91,91,190,30685046,1279121748,1309806794,54,188,5,1248436702,In > Out
Apr 2020,91,93,187,13300979,219343881,232644860,50,186,2,206042902,In > Out
Apr 2020,91,94,5,449521,168325727,168775248,3,5,1,167876206,In > Out
Apr 2020,92,10,21,266628,16380539,16647167,7,21,2,16113911,In > Out
Apr 2020,92,11,566,11858477,1466517320,1478375797,43,564,2,1454658843,In > Out
Apr 2020,92,19,751,15819725,1545722296,1561542021,46,738,2,1529902571,In > Out
Apr 2020,92,21,311,12729130,1931063613,1943792743,38,311,2,1918334483,In > Out
Apr 2020,92,213,21,5450127,54360596,59810723,8,21,2,48910469,In > Out
Apr 2020,92,225,8,1933360,38069877,40003237,7,8,2,36136517,In > Out
Apr 2020,92,227,30,55523548,3335997,58859545,5,30,14,52187551,Out > In
Apr 2020,92,228,128,5635772,201398858,207034630,28,126,2,195763086,In > Out
Apr 2020,92,24,428,7667208,1042027642,1049694850,24,428,2,1034360434,In > Out
Apr 2020,92,250,360,21530200,522112120,543642320,59,358,2,500581920,In > Out
Apr 2020,92,26,193,8592720,458517253,467109973,23,184,2,449924533,In > Out
Apr 2020,92,33,815,19933849,1832530405,1852464254,45,815,2,1812596556,In > Out
Apr 2020,92,34,174,7738895,416648463,424387358,20,174,2,408909568,In > Out
Apr 2020,92,35,492,12153041,1587310820,1599463861,37,467,2,1575157779,In > Out
Apr 2020,92,37,21,239331,4056935,4296266,7,21,2,3817604,In > Out
Apr 2020,92,38,336,4113263,896658294,900771557,28,336,2,892545031,In > Out
Apr 2020,92,4,363,32235589,213880117,246115706,85,362,2,181644528,In > Out
Apr 2020,92,41,406,8946979,1352962854,1361909833,36,404,2,1344015875,In > Out
Apr 2020,92,42,167,1965159,486294533,488259692,18,167,2,484329374,In > Out
Apr 2020,92,43,150,7089149,390073706,397162855,20,150,2,382984557,In > Out
Apr 2020,92,45,375,22824788,467161477,489986265,27,373,2,444336689,In > Out
Apr 2020,92,46,191,9391468,531787269,541178737,18,191,2,522395801,In > Out
Apr 2020,92,47,234,12201937,671120504,683322441,20,234,2,658918567,In > Out
Apr 2020,92,48,55,457210,118610532,119067742,12,55,2,118153322,In > Out
Apr 2020,92,52,723,14199348,1360971180,1375170528,43,723,2,1346771832,In > Out
Apr 2020,92,53,371,13244645,1791792288,1805036933,34,371,2,1778547643,In > Out
Apr 2020,92,54,191,8344956,466715081,475060037,22,191,2,458370125,In > Out
Apr 2020,92,55,200,8065823,455599140,463664963,20,200,2,447533317,In > Out
Apr 2020,92,56,163,9030535,182400795,191431330,32,163,2,173370260,In > Out
Apr 2020,92,58,184,7395708,400452472,407848180,23,177,2,393056764,In > Out
Apr 2020,92,59,191,9188684,477017646,486206330,18,191,2,467828962,In > Out
Apr 2020,92,6,1558,1068089967,30578528380,31646618347,193,1483,9,29510438413,In > Out
Apr 2020,92,62,100,4532531,231176120,235708651,17,100,2,226643589,In > Out
Apr 2020,92,63,179,11355379,561876374,573231753,23,179,2,550520995,In > Out
Apr 2020,92,65,554,10602455,1565217853,1575820308,25,554,2,1554615398,In > Out
Apr 2020,92,67,163,9720320,563405360,573125680,19,162,2,553685040,In > Out
Apr 2020,92,7,26,454979,7637028,8092007,3,26,2,7182049,In > Out
Apr 2020,92,78,281,16169018,858991198,875160216,20,279,2,842822180,In > Out
Apr 2020,92,79,472,9784578,1123121647,1132906225,40,472,2,1113337069,In > Out
Apr 2020,92,8,2005,119748314,439311517,559059831,71,1959,2,319563203,In > Out
Apr 2020,92,88,686,13906371,1424198261,1438104632,23,686,2,1410291890,In > Out
Apr 2020,92,89,483,6683300,1135103514,1141786814,31,483,2,1128420214,In > Out
Apr 2020,92,97,576,13145915,1259817350,1272963265,22,576,2,1246671435,In > Out
Apr 2020,94,21,500,33468041,1954323094,1987791135,359,489,1,1920855053,In > Out
Apr 2020,94,22,687,652425765,30741935,683167700,76,518,619,621683830,Out > In
Apr 2020,94,29,47973,29540765681,181947295693,211488061374,4061,20192,90,152406530012,In > Out
Apr 2020,94,51,946,1311050217,26401264,1337451481,1,934,928,1284648953,Out > In
Apr 2020,96,125,1,509854,51666,561520,1,1,1,458188,Out > In
Apr 2020,96,60,51,356313156,117628679,473941835,26,1,51,238684477,Out > In
Apr 2020,96,78,8,31557458,1078319,32635777,5,2,8,30479139,Out > In
Apr 2020,98,10,48,1365442,47993492,49358934,12,48,1,46628050,In > Out
Apr 2020,98,101,64,23805861,128729284,152535145,29,64,3,104923423,In > Out
Apr 2020,98,102,53,5930707,91393036,97323743,30,53,2,85462329,In > Out
Apr 2020,98,103,2360,496343093,32487760086,32984103179,343,2253,14,31991416993,In > Out
Apr 2020,98,104,54,7703063,688606902,696309965,25,54,2,680903839,In > Out
Apr 2020,98,107,200,24732324,909667092,934399416,66,200,2,884934768,In > Out
Apr 2020,98,108,1074,962387795,3890411703,4852799498,278,1054,23,2928023908,In > Out
Apr 2020,98,11,129,22103236,913104230,935207466,71,129,3,891000994,In > Out
Apr 2020,98,110,1,17669,137656,155325,1,1,1,119987,In > Out
Apr 2020,98,111,38,2851371,55467348,58318719,15,38,2,52615977,In > Out
Apr 2020,98,113,426,755089965,1934823962,2689913927,179,426,4,1179733997,In > Out
Apr 2020,98,114,5,364547,15373537,15738084,4,5,1,15008990,In > Out
Apr 2020,98,115,2965,96232857,4917757397,5013990254,201,2898,5,4821524540,In > Out
Apr 2020,98,12,6,1965851,47722281,49688132,5,6,1,45756430,In > Out
Apr 2020,98,120,83,5479399,239031351,244510750,47,82,2,233551952,In > Out
Apr 2020,98,122,1,4295608,42142046,46437654,1,1,1,37846438,In > Out
Apr 2020,98,123,265,24200417,185628639,209829056,118,265,2,161428222,In > Out
Apr 2020,98,124,175,58329799,2568250151,2626579950,91,175,3,2509920352,In > Out
Apr 2020,98,125,1216,157294409,4454762449,4612056858,135,1186,20,4297468040,In > Out
Apr 2020,98,126,23,3103805,26197463,29301268,18,23,4,23093658,In > Out
Apr 2020,98,128,216,13261787,2226812971,2240074758,39,216,3,2213551184,In > Out
Apr 2020,98,130,4709,5750261085,40076981695,45827242780,609,4192,32,34326720610,In > Out
Apr 2020,98,132,247,129569944,1027983595,1157553539,66,245,5,898413651,In > Out
Apr 2020,98,133,135,396261932,821683388,1217945320,51,135,7,425421456,In > Out
Apr 2020,98,134,177,33280386,392806260,426086646,73,177,15,359525874,In > Out
Apr 2020,98,135,4,68545,1743990,1812535,4,4,1,1675445,In > Out
Apr 2020,98,136,356,119133363,1915711071,2034844434,115,354,4,1796577708,In > Out
Apr 2020,98,137,332,45460763,461922222,507382985,92,325,5,416461459,In > Out
Apr 2020,98,138,40,2371721,26165097,28536818,33,40,3,23793376,In > Out
Apr 2020,98,139,34,3175640,40510799,43686439,23,34,2,37335159,In > Out
Apr 2020,98,14,59,7512436,521671877,529184313,29,59,1,514159441,In > Out
Apr 2020,98,140,678,217312503,2469520501,2686833004,184,672,11,2252207998,In > Out
Apr 2020,98,141,3,143499,372694,516193,3,3,2,229195,In > Out
Apr 2020,98,142,1439,219757859,3779784314,3999542173,335,1411,6,3560026455,In > Out
Apr 2020,98,143,1,8582,602132,610714,1,1,1,593550,In > Out
Apr 2020,98,145,2,5912,208340,214252,1,2,1,202428,In > Out
Apr 2020,98,146,130,345597532,300828860,646426392,39,130,5,44768672,Out > In
Apr 2020,98,147,131,18842793,2389898638,2408741431,77,131,2,2371055845,In > Out
Apr 2020,98,148,11,139191597,44823545,184015142,9,11,4,94368052,Out > In
Apr 2020,98,149,21,4884910,157208301,162093211,11,21,2,152323391,In > Out
Apr 2020,98,15,6,5799454,74459784,80259238,2,6,2,68660330,In > Out
Apr 2020,98,150,306,29986177,1215883647,1245869824,49,302,4,1185897470,In > Out
Apr 2020,98,152,440,115480262,7425497770,7540978032,158,440,2,7310017508,In > Out
Apr 2020,98,153,183,115403577,330230917,445634494,72,183,4,214827340,In > Out
Apr 2020,98,154,315,237853306,2446807267,2684660573,104,311,5,2208953961,In > Out
Apr 2020,98,156,87,8219326,327643541,335862867,48,87,1,319424215,In > Out
Apr 2020,98,157,19,87730059,74766349,162496408,13,18,4,12963710,Out > In
Apr 2020,98,16,669,1013892076,1300154331,2314046407,136,668,6,286262255,In > Out
Apr 2020,98,162,411,62585128,2294068582,2356653710,159,410,2,2231483454,In > Out
Apr 2020,98,163,30,6016578,23888125,29904703,23,30,3,17871547,In > Out
Apr 2020,98,164,325,62147729,1882267937,1944415666,105,325,2,1820120208,In > Out
Apr 2020,98,168,883,295182055,5328954218,5624136273,185,864,53,5033772163,In > Out
Apr 2020,98,169,2,38880,262554,301434,2,2,2,223674,In > Out
Apr 2020,98,17,689,384771976,6750073939,7134845915,166,675,5,6365301963,In > Out
Apr 2020,98,170,497,97897937,2481070553,2578968490,158,496,5,2383172616,In > Out
Apr 2020,98,171,1,7797,132005,139802,1,1,1,124208,In > Out
Apr 2020,98,172,852,47694849,2799623161,2847318010,261,746,137,2751928312,In > Out
Apr 2020,98,173,123,16020061,627023688,643043749,50,123,3,611003627,In > Out
Apr 2020,98,177,27,9948658,214165039,224113697,11,27,1,204216381,In > Out
Apr 2020,98,179,1080,77843524,2155854658,2233698182,115,1068,23,2078011134,In > Out
Apr 2020,98,18,925,128267627,3446840608,3575108235,225,911,6,3318572981,In > Out
Apr 2020,98,180,497,543422490,5065718109,5609140599,140,496,4,4522295619,In > Out
Apr 2020,98,181,74,24628173,737487010,762115183,42,74,4,712858837,In > Out
Apr 2020,98,182,303,689301969,1527322596,2216624565,100,300,10,838020627,In > Out
Apr 2020,98,184,2,100678,222993,323671,2,2,2,122315,In > Out
Apr 2020,98,185,395,27720738,1754674896,1782395634,72,393,3,1726954158,In > Out
Apr 2020,98,186,649,219942356,7348693198,7568635554,166,649,21,7128750842,In > Out
Apr 2020,98,188,607,468282031,6037457415,6505739446,156,603,4,5569175384,In > Out
Apr 2020,98,195,30,2940370,25082112,28022482,13,30,1,22141742,In > Out
Apr 2020,98,196,100,113694382,132662937,246357319,71,100,48,18968555,In > Out
Apr 2020,98,198,282,50987508,347981953,398969461,93,281,7,296994445,In > Out
Apr 2020,98,199,125,19435915,599598482,619034397,52,125,5,580162567,In > Out
Apr 2020,98,20,65,5958346,252890802,258849148,31,65,3,246932456,In > Out
Apr 2020,98,200,180,20273355,511389147,531662502,49,180,3,491115792,In > Out
Apr 2020,98,203,133,15130453,758625845,773756298,54,133,2,743495392,In > Out
Apr 2020,98,204,1341,289299625,1347913681,1637213306,185,1288,10,1058614056,In > Out
Apr 2020,98,206,204,29834085,657032629,686866714,88,202,2,627198544,In > Out
Apr 2020,98,208,420,492324507,1861542565,2353867072,127,420,6,1369218058,In > Out
Apr 2020,98,210,3,852700,166955,1019655,3,3,2,685745,Out > In
Apr 2020,98,211,152,7587279,949628502,957215781,79,152,2,942041223,In > Out
Apr 2020,98,212,847,176658575,2495001426,2671660001,340,837,2,2318342851,In > Out
Apr 2020,98,216,2722,605258036,16716536977,17321795013,394,2557,5,16111278941,In > Out
Apr 2020,98,219,205,16944759,601207365,618152124,25,205,1,584262606,In > Out
Apr 2020,98,22,81,7193938,167879791,175073729,16,81,2,160685853,In > Out
Apr 2020,98,220,193,38310141,2386813690,2425123831,77,191,2,2348503549,In > Out
Apr 2020,98,221,999,258159270,8180557122,8438716392,248,993,7,7922397852,In > Out
Apr 2020,98,222,193,27373858,815819106,843192964,8,193,3,788445248,In > Out
Apr 2020,98,223,42,1082858,10367043,11449901,21,42,2,9284185,In > Out
Apr 2020,98,23,176,95158380,332029313,427187693,81,176,5,236870933,In > Out
Apr 2020,98,26,31,1376370,43585760,44962130,15,31,3,42209390,In > Out
Apr 2020,98,27,175,14092307,308803774,322896081,54,174,3,294711467,In > Out
Apr 2020,98,28,801,214873867,3228398561,3443272428,243,801,4,3013524694,In > Out
Apr 2020,98,29,376,44142405,1627392758,1671535163,168,376,5,1583250353,In > Out
Apr 2020,98,30,40,1923812,65750074,67673886,28,40,5,63826262,In > Out
Apr 2020,98,31,3267,520644306,5340697442,5861341748,405,3094,7,4820053136,In > Out
Apr 2020,98,34,19,1466837,6449758,7916595,15,19,1,4982921,In > Out
Apr 2020,98,35,230,397152809,76661863,473814672,37,227,2,320490946,Out > In
Apr 2020,98,37,307,32790269,462536646,495326915,135,306,1,429746377,In > Out
Apr 2020,98,4,925,51362264,2790938788,2842301052,119,910,17,2739576524,In > Out
Apr 2020,98,40,1,13383,136339,149722,1,1,1,122956,In > Out
Apr 2020,98,43,35,5646104,145948430,151594534,19,35,3,140302326,In > Out
Apr 2020,98,44,585,27407186,637771855,665179041,104,573,20,610364669,In > Out
Apr 2020,98,46,1230,145326883,3609137116,3754463999,309,1217,3,3463810233,In > Out
Apr 2020,98,49,21,3373462,18558415,21931877,12,21,2,15184953,In > Out
Apr 2020,98,51,3049,128654594,6013901197,6142555791,1914,1922,1573,5885246603,In > Out
Apr 2020,98,54,552,120832446,4389632513,4510464959,176,551,3,4268800067,In > Out
Apr 2020,98,56,107,5337553,97177119,102514672,45,107,2,91839566,In > Out
Apr 2020,98,57,3747,785449770,8771698182,9557147952,552,3438,68,7986248412,In > Out
Apr 2020,98,59,33,141400909,803525438,944926347,21,31,4,662124529,In > Out
Apr 2020,98,60,514,50200200,1271426084,1321626284,205,508,4,1221225884,In > Out
Apr 2020,98,61,802,104555077,1976485506,2081040583,108,784,4,1871930429,In > Out
Apr 2020,98,62,988,73741338,5025300058,5099041396,250,968,10,4951558720,In > Out
Apr 2020,98,64,175,50587069,2472545152,2523132221,81,175,6,2421958083,In > Out
Apr 2020,98,65,156,17656470,607559545,625216015,65,156,2,589903075,In > Out
Apr 2020,98,66,58,7287569,817633719,824921288,26,58,2,810346150,In > Out
Apr 2020,98,68,212,63794747,2663954812,2727749559,104,212,4,2600160065,In > Out
Apr 2020,98,70,1477,2826374815,7623333553,10449708368,243,1445,6,4796958738,In > Out
Apr 2020,98,72,453,38724211,1773514683,1812238894,83,447,5,1734790472,In > Out
Apr 2020,98,73,651,90808761,7518949863,7609758624,175,635,2,7428141102,In > Out
Apr 2020,98,75,344,145047159,680556813,825603972,112,342,3,535509654,In > Out
Apr 2020,98,76,1587,465323712,6188238591,6653562303,537,1332,214,5722914879,In > Out
Apr 2020,98,77,232,58971460,4064415859,4123387319,87,230,3,4005444399,In > Out
Apr 2020,98,78,14,381076432,324954143,706030575,9,12,4,56122289,Out > In
Apr 2020,98,79,24,830841,7483564,8314405,14,24,2,6652723,In > Out
Apr 2020,98,8,416,45903682,1347807549,1393711231,124,413,7,1301903867,In > Out
Apr 2020,98,80,2732,235390419,11940307764,12175698183,418,2225,9,11704917345,In > Out
Apr 2020,98,81,256,28484459,623584524,652068983,114,256,3,595100065,In > Out
Apr 2020,98,82,138,7626827,396843231,404470058,77,136,21,389216404,In > Out
Apr 2020,98,83,55,28999014,85781521,114780535,39,55,3,56782507,In > Out
Apr 2020,98,87,2,410006,251347,661353,2,2,1,158659,Out > In
Apr 2020,98,90,299,43982458,2576401173,2620383631,137,290,10,2532418715,In > Out
Apr 2020,98,93,4434,2852962907,26339938799,29192901706,674,3942,8,23486975892,In > Out
Apr 2020,98,94,5431,545877200,28277941868,28823819068,802,4877,9,27732064668,In > Out
Apr 2020,98,96,216,1027169418,985619584,2012789002,103,205,10,41549834,Out > In
Apr 2020,98,97,154,49493921,303394549,352888470,65,152,7,253900628,In > Out
Apr 2020,98,98,141,39339570,749194430,788534000,55,141,1,709854860,In > Out
Apr 2020,98,99,34,10034865,1240149255,1250184120,25,33,2,1230114390,In > Out
Apr 2020,99,105,548,69220593,3503937772,3573158365,14,548,4,3434717179,In > Out
Apr 2020,99,107,50,3682259,71681579,75363838,39,50,3,67999320,In > Out
Apr 2020,99,108,13,527403,5284840,5812243,6,13,3,4757437,In > Out
Apr 2020,99,109,3,276942,2744929,3021871,3,3,1,2467987,In > Out
Apr 2020,99,121,829,54223225,2961519485,3015742710,133,813,5,2907296260,In > Out
Apr 2020,99,123,157,33519403,59010878,92530281,83,92,22,25491475,In > Out
Apr 2020,99,130,1300,58438505,3049943230,3108381735,81,1300,4,2991504725,In > Out
Apr 2020,99,131,3,260516,29954636,30215152,1,3,1,29694120,In > Out
Apr 2020,99,153,188,57608796,7350457040,7408065836,41,187,2,7292848244,In > Out
Apr 2020,99,160,1,12326,842297,854623,1,1,1,829971,In > Out
Apr 2020,99,162,13,754615,54098043,54852658,4,13,1,53343428,In > Out
Apr 2020,99,167,2349,161407778,7458387808,7619795586,548,2175,2,7296980030,In > Out
Apr 2020,99,168,2151,339615241,591292763,930908004,165,2055,14,251677522,In > Out
Apr 2020,99,177,153,27677172,1022803527,1050480699,46,152,1,995126355,In > Out
Apr 2020,99,178,110,14537391,836775858,851313249,19,110,2,822238467,In > Out
Apr 2020,99,182,7,339590,1417785,1757375,6,5,2,1078195,In > Out
Apr 2020,99,188,1,17249,1235363,1252612,1,1,1,1218114,In > Out
Apr 2020,99,209,5,2763755,133691047,136454802,4,5,2,130927292,In > Out
Apr 2020,99,219,384,193770005,7687149043,7880919048,76,384,3,7493379038,In > Out
Apr 2020,99,248,43,71838924,113236333,185075257,29,43,12,41397409,In > Out
Apr 2020,99,51,2176,631889337,5851966695,6483856032,441,2055,8,5220077358,In > Out
Apr 2020,99,75,1008,228289825,2334518215,2562808040,123,997,8,2106228390,In > Out
Apr 2020,99,76,2,32654,1412716,1445370,2,2,1,1380062,In > Out
Apr 2020,99,92,411,43763354,1122786351,1166549705,72,409,6,1079022997,In > Out
Sept 2020,10,200,21,1882986,437110282,438993268,1,21,1,435227296,In > Out
Sept 2020,100,132,2603,523134017,679092112,1202226129,101,2397,30,155958095,In > Out
Sept 2020,100,148,382,160933963,3009846820,3170780783,100,382,4,2848912857,In > Out
Sept 2020,100,161,50,3928559,169368706,173297265,4,50,2,165440147,In > Out
Sept 2020,100,180,67,491606,14558859,15050465,7,67,2,14067253,In > Out
Sept 2020,100,181,1253,135785862,1429926625,1565712487,92,1205,2,1294140763,In > Out
Sept 2020,100,191,441,14608682,1566166711,1580775393,90,441,2,1551558029,In > Out
Sept 2020,100,206,409,14321581,1058716340,1073037921,51,409,2,1044394759,In > Out
Sept 2020,100,229,120,3491595,196584712,200076307,17,120,2,193093117,In > Out
Sept 2020,100,37,14,58361641,150822156,209183797,8,14,2,92460515,In > Out
Sept 2020,100,78,61,84845896,3128810209,3213656105,16,61,2,3043964313,In > Out
Sept 2020,101,102,1549,148199119,1371274221,1519473340,204,1485,3,1223075102,In > Out
Sept 2020,101,105,85,7784791,402367780,410152571,32,85,2,394582989,In > Out
Sept 2020,101,111,628,121736827,4368813287,4490550114,26,628,2,4247076460,In > Out
Sept 2020,101,121,2586,177847813,1210196186,1388043999,97,2387,2,1032348373,In > Out
Sept 2020,101,135,171,11444463,629107820,640552283,40,171,2,617663357,In > Out
Sept 2020,101,160,2261,960356995,5344157209,6304514204,293,1970,96,4383800214,In > Out
Sept 2020,101,175,7,1176849,40654385,41831234,4,7,2,39477536,In > Out
Sept 2020,101,177,865,84627330,3372387526,3457014856,57,846,3,3287760196,In > Out
Sept 2020,101,178,9,78187,12276612,12354799,4,9,2,12198425,In > Out
Sept 2020,101,184,3,70988,21327524,21398512,1,3,1,21256536,In > Out
Sept 2020,101,194,1412,2825054139,222182726,3047236865,25,1412,3,2602871413,Out > In
Sept 2020,101,205,127,10744685,849850279,860594964,58,127,2,839105594,In > Out
Sept 2020,101,208,1,85368,73401,158769,1,1,1,11967,Out > In
Sept 2020,101,213,9,36245,1790823,1827068,6,9,2,1754578,In > Out
Sept 2020,101,223,1406,1369745838,60594376052,61964121890,117,1352,3,59224630214,In > Out
Sept 2020,101,228,186,102890820,3735951402,3838842222,26,186,2,3633060582,In > Out
Sept 2020,101,229,732,438228905,1271369017,1709597922,158,715,9,833140112,In > Out
Sept 2020,101,28,127,122752078,4338234347,4460986425,26,127,2,4215482269,In > Out
Sept 2020,101,33,172,10254438133,255391974,10509830107,68,172,2,9999046159,Out > In
Sept 2020,101,43,40,1562993,19326861,20889854,12,40,1,17763868,In > Out
Sept 2020,101,49,7,369985,43120538,43490523,4,7,2,42750553,In > Out
Sept 2020,101,51,890,139024605,1381641925,1520666530,270,870,2,1242617320,In > Out
Sept 2020,101,77,23,4439125,589614480,594053605,11,23,2,585175355,In > Out
Sept 2020,101,88,728,38792173,364067879,402860052,58,728,2,325275706,In > Out
Sept 2020,101,90,7,652800,180960,833760,1,1,1,471840,Out > In
Sept 2020,101,91,247,32070084,1000298482,1032368566,94,247,4,968228398,In > Out
Sept 2020,102,102,84,5232726,24085599,29318325,2,84,1,18852873,In > Out
Sept 2020,103,233,39985,1476027259,35919771392,37395798651,2640,15100,9,34443744133,In > Out
Sept 2020,103,247,308,27693798,817108263,844802061,101,308,3,789414465,In > Out
Sept 2020,104,102,27,6127266,1181710576,1187837842,8,27,2,1175583310,In > Out
Sept 2020,104,116,1791,260423772,5693953246,5954377018,496,1767,4,5433529474,In > Out
Sept 2020,104,127,194,100448566,3798299738,3898748304,31,193,2,3697851172,In > Out
Sept 2020,104,130,612,16637517,4764242703,4780880220,29,612,2,4747605186,In > Out
Sept 2020,104,132,350,26243483,149678385,175921868,72,350,2,123434902,In > Out
Sept 2020,104,150,972,398256072,32911633169,33309889241,171,972,4,32513377097,In > Out
Sept 2020,104,161,1278,1983069464,95952184747,97935254211,134,1238,3,93969115283,In > Out
Sept 2020,104,167,7,1369734,206272,1576006,1,1,1,1163462,Out > In
Sept 2020,104,171,1103,145453310,5590593648,5736046958,141,1066,3,5445140338,In > Out
Sept 2020,104,172,825,848716784,17085728482,17934445266,267,802,8,16237011698,In > Out
Sept 2020,104,187,32,22940429,90882265,113822694,18,32,3,67941836,In > Out
Sept 2020,104,189,342,713514553,29286335134,29999849687,90,342,3,28572820581,In > Out
Sept 2020,104,194,2269,294126644,5243888475,5538015119,101,2126,3,4949761831,In > Out
Sept 2020,104,216,582,75260518,4593341593,4668602111,40,580,2,4518081075,In > Out
Sept 2020,104,217,45,3724128,586934371,590658499,24,45,2,583210243,In > Out
Sept 2020,104,227,1128,578916550,4064245343,4643161893,97,1093,2,3485328793,In > Out
Sept 2020,104,231,442,11078239,3738596339,3749674578,33,441,2,3727518100,In > Out
Sept 2020,104,232,269,111905487,3393433234,3505338721,57,266,3,3281527747,In > Out
Sept 2020,104,237,1900,1139615170,2443167613,3582782783,243,1816,5,1303552443,In > Out
Sept 2020,104,238,1218,257203531,14207694492,14464898023,232,1176,10,13950490961,In > Out
Sept 2020,104,250,612,50800835,1064185756,1114986591,54,606,2,1013384921,In > Out
Sept 2020,104,47,130,8518746,195265571,203784317,61,130,2,186746825,In > Out
Sept 2020,104,50,12,2181688,462752,2644440,1,2,1,1718936,Out > In
Sept 2020,104,57,736,441942121,7062461582,7504403703,136,725,6,6620519461,In > Out
Sept 2020,104,61,261,105050310,7288011792,7393062102,25,258,2,7182961482,In > Out
Sept 2020,104,76,260,315357312,4156543465,4471900777,89,259,3,3841186153,In > Out
Sept 2020,104,85,289,23261196,4005162786,4028423982,35,288,2,3981901590,In > Out
Sept 2020,104,95,1547,517369498,4952245078,5469614576,170,1471,3,4434875580,In > Out
Sept 2020,104,96,104,59840864,87550331,147391195,55,104,7,27709467,In > Out
Sept 2020,104,97,395,116049004,3264086353,3380135357,96,386,2,3148037349,In > Out
Sept 2020,11,88,108,7419235,349697548,357116783,30,108,2,342278313,In > Out
Sept 2020,11,9,1,3474,196455,199929,1,1,1,192981,In > Out
Sept 2020,110,169,123,27634117,2447591510,2475225627,39,123,2,2419957393,In > Out
Sept 2020,110,212,240,23046986,1875907857,1898954843,44,236,2,1852860871,In > Out
Sept 2020,110,75,373,4143157,195812238,199955395,15,368,2,191669081,In > Out
Sept 2020,111,5,172,28924537,32004762,60929299,2,5,2,3080225,In > Out
Sept 2020,112,10,1927,410468302,24081295775,24491764077,441,1815,15,23670827473,In > Out
Sept 2020,112,100,345,75272036,2641881944,2717153980,118,339,5,2566609908,In > Out
Sept 2020,112,102,542,277931946,3840734699,4118666645,208,528,10,3562802753,In > Out
Sept 2020,112,104,246,50994237,1783060784,1834055021,79,244,4,1732066547,In > Out
Sept 2020,112,105,242,31009838,746262909,777272747,108,241,4,715253071,In > Out
Sept 2020,112,107,1046,98693253,3177240633,3275933886,269,1021,6,3078547380,In > Out
Sept 2020,112,108,699,207762629,2719265652,2927028281,237,693,4,2511503023,In > Out
Sept 2020,112,109,5989,490834907,11213504455,11704339362,783,4886,288,10722669548,In > Out
Sept 2020,112,111,831,180087093,4057301498,4237388591,186,820,6,3877214405,In > Out
Sept 2020,112,112,4214,1180393611,26954936594,28135330205,827,3809,11,25774542983,In > Out
Sept 2020,112,114,93,13355061,518957920,532312981,40,93,1,505602859,In > Out
Sept 2020,112,115,754,1100752904,9282989438,10383742342,290,746,7,8182236534,In > Out
Sept 2020,112,117,1035,916107690,7553663974,8469771664,320,1016,6,6637556284,In > Out
Sept 2020,112,119,82,16496646,126891383,143388029,38,82,3,110394737,In > Out
Sept 2020,112,123,81,39195656,1319527625,1358723281,46,81,5,1280331969,In > Out
Sept 2020,112,125,291,38197609,1087129550,1125327159,111,287,4,1048931941,In > Out
Sept 2020,112,126,357,54382853,1491198534,1545581387,140,346,5,1436815681,In > Out
Sept 2020,112,127,169,58838098,2100463092,2159301190,89,167,4,2041624994,In > Out
Sept 2020,112,128,32,10324443,326794956,337119399,7,32,3,316470513,In > Out
Sept 2020,112,129,327,65947160,8066663630,8132610790,116,327,5,8000716470,In > Out
Sept 2020,112,130,435,42929549,860129158,903058707,176,421,8,817199609,In > Out
Sept 2020,112,131,849,187499992,6100011110,6287511102,232,821,7,5912511118,In > Out
Sept 2020,112,132,3517,380766202,20933342205,21314108407,664,3054,15,20552576003,In > Out
Sept 2020,112,133,546,74208058,2942002587,3016210645,124,537,6,2867794529,In > Out
Sept 2020,112,134,1587,459309616,5398781110,5858090726,394,1521,4,4939471494,In > Out
Sept 2020,112,135,1349,466159625,8121987721,8588147346,176,1295,7,7655828096,In > Out
Sept 2020,112,136,1147,5866110800,10087373899,15953484699,307,1127,12,4221263099,In > Out
Sept 2020,112,137,1236,669203396,7552432086,8221635482,251,1202,5,6883228690,In > Out
Sept 2020,112,138,92,53745842,1607048093,1660793935,37,91,2,1553302251,In > Out
Sept 2020,112,139,287,148393074,1070672164,1219065238,90,283,3,922279090,In > Out
Sept 2020,112,14,668,392215380,11178431528,11570646908,163,650,3,10786216148,In > Out
Sept 2020,112,141,229,236433142,1347262015,1583695157,103,228,5,1110828873,In > Out
Sept 2020,112,142,2105,3403406714,9669270527,13072677241,414,2007,4,6265863813,In > Out
Sept 2020,112,143,706,106924450,2942735559,3049660009,215,678,6,2835811109,In > Out
Sept 2020,112,144,979,191172859,10335433566,10526606425,184,971,6,10144260707,In > Out
Sept 2020,112,145,285,74873251,2366494764,2441368015,138,284,5,2291621513,In > Out
Sept 2020,112,146,471,128731935,7205604158,7334336093,139,469,7,7076872223,In > Out
Sept 2020,112,147,731,310876826,4059020519,4369897345,188,718,6,3748143693,In > Out
Sept 2020,112,148,1782,7901004551,6614542772,14515547323,294,1701,8,1286461779,Out > In
Sept 2020,112,149,477,196429441,1082450440,1278879881,192,471,6,886020999,In > Out
Sept 2020,112,15,438,64354357,2229253192,2293607549,131,436,5,2164898835,In > Out
Sept 2020,112,150,493,63847856,3167860141,3231707997,113,487,5,3104012285,In > Out
Sept 2020,112,151,958,388452721,6693581812,7082034533,305,936,6,6305129091,In > Out
Sept 2020,112,152,459,495963413,3295016678,3790980091,146,455,7,2799053265,In > Out
Sept 2020,112,153,1847,1008178443,14925574047,15933752490,462,1801,9,13917395604,In > Out
Sept 2020,112,154,430,90651908,4344768639,4435420547,174,426,5,4254116731,In > Out
Sept 2020,112,155,259,37249082,971323785,1008572867,71,259,4,934074703,In > Out
Sept 2020,112,156,260,39615030,1610021057,1649636087,112,259,3,1570406027,In > Out
Sept 2020,112,157,1238,197610139,4133555723,4331165862,284,1183,10,3935945584,In > Out
Sept 2020,112,158,782,328248191,6026160067,6354408258,197,759,5,5697911876,In > Out
Sept 2020,112,159,794,434993714,2847643818,3282637532,227,789,8,2412650104,In > Out
Sept 2020,112,160,215,26262083,1802883571,1829145654,61,215,1,1776621488,In > Out
Sept 2020,112,161,1143,145266760,6800641227,6945907987,297,1136,5,6655374467,In > Out
Sept 2020,112,162,541,148787022,3408206720,3556993742,234,532,3,3259419698,In > Out
Sept 2020,112,164,561,58143306,2691192749,2749336055,219,551,6,2633049443,In > Out
Sept 2020,112,165,287,43397974,1228879637,1272277611,126,286,4,1185481663,In > Out
Sept 2020,112,168,1463,134439583,6072270628,6206710211,372,1439,9,5937831045,In > Out
Sept 2020,112,169,805,154948183,9809540106,9964488289,255,795,4,9654591923,In > Out
Sept 2020,112,170,408,36677490,1295598566,1332276056,83,405,1,1258921076,In > Out
Sept 2020,112,173,155,45611533,245490939,291102472,54,153,3,199879406,In > Out
Sept 2020,112,174,1381,387650986,8647732739,9035383725,347,1326,14,8260081753,In > Out
Sept 2020,112,175,247,133450615,422289383,555739998,111,245,6,288838768,In > Out
Sept 2020,112,176,777,683538538,4643692232,5327230770,239,758,5,3960153694,In > Out
Sept 2020,112,177,1103,2217885297,4567499439,6785384736,214,970,10,2349614142,In > Out
Sept 2020,112,178,148,281523844,11554205643,11835729487,56,148,1,11272681799,In > Out
Sept 2020,112,179,683,939898360,1642585487,2582483847,93,674,4,702687127,In > Out
Sept 2020,112,180,1165,124470599,1932156577,2056627176,358,1137,8,1807685978,In > Out
Sept 2020,112,181,91,7846139,193813277,201659416,56,91,2,185967138,In > Out
Sept 2020,112,182,391,42878012,1023104591,1065982603,161,387,6,980226579,In > Out
Sept 2020,112,183,404,61380022,1669169376,1730549398,139,401,4,1607789354,In > Out
Sept 2020,112,184,643,119612962,2652278589,2771891551,157,627,4,2532665627,In > Out
Sept 2020,112,185,719,1144722825,8092863193,9237586018,196,690,5,6948140368,In > Out
Sept 2020,112,186,745,531873328,16446116288,16977989616,306,735,6,15914242960,In > Out
Sept 2020,112,187,272,66608063,626913624,693521687,106,272,3,560305561,In > Out
Sept 2020,112,188,840,929811153,9046526000,9976337153,231,829,8,8116714847,In > Out
Sept 2020,112,189,109,5142070,227121104,232263174,55,109,3,221979034,In > Out
Sept 2020,112,190,608,374173108,8028610627,8402783735,232,592,6,7654437519,In > Out
Sept 2020,112,191,1652,190374294,7846413056,8036787350,367,1611,6,7656038762,In > Out
Sept 2020,112,193,426,77264079,1680397790,1757661869,187,419,5,1603133711,In > Out
Sept 2020,112,199,248,105439855,3265245480,3370685335,113,245,5,3159805625,In > Out
Sept 2020,112,201,339,61670969,2734505897,2796176866,119,339,2,2672834928,In > Out
Sept 2020,112,202,1567,313430175,18874589446,19188019621,284,1545,8,18561159271,In > Out
Sept 2020,112,203,405,43908806,2033433649,2077342455,117,405,3,1989524843,In > Out
Sept 2020,112,204,457,105121276,6332629562,6437750838,176,454,3,6227508286,In > Out
Sept 2020,112,205,243,24174248,1110419793,1134594041,79,243,5,1086245545,In > Out
Sept 2020,112,206,253,43782033,627670803,671452836,94,248,4,583888770,In > Out
Sept 2020,112,207,1125,477026603,27428506387,27905532990,219,1034,28,26951479784,In > Out
Sept 2020,112,208,279,187223952,3202427278,3389651230,95,277,4,3015203326,In > Out
Sept 2020,112,209,534,80060801,1104425836,1184486637,172,534,4,1024365035,In > Out
Sept 2020,112,211,61,6121460,524773994,530895454,36,61,5,518652534,In > Out
Sept 2020,112,212,293,81842414,17631629720,17713472134,92,291,7,17549787306,In > Out
Sept 2020,112,213,461,54957141,1515339276,1570296417,155,454,5,1460382135,In > Out
Sept 2020,112,216,940,324846727,11701639426,12026486153,306,935,6,11376792699,In > Out
Sept 2020,112,219,430,50246921,1813062909,1863309830,146,425,4,1762815988,In > Out
Sept 2020,112,22,403,81490356,5806903851,5888394207,108,402,2,5725413495,In > Out
Sept 2020,112,220,743,178231727,1740151309,1918383036,264,740,8,1561919582,In > Out
Sept 2020,112,223,725,92227552,4859300501,4951528053,243,711,7,4767072949,In > Out
Sept 2020,112,25,269,31037818,841865730,872903548,125,268,3,810827912,In > Out
Sept 2020,112,28,767,90697871,4356925528,4447623399,154,764,5,4266227657,In > Out
Sept 2020,112,31,315,107804140,1619418450,1727222590,103,312,5,1511614310,In > Out
Sept 2020,112,32,541,48310926,1083347678,1131658604,142,528,6,1035036752,In > Out
Sept 2020,112,33,107,2287558,100987083,103274641,38,107,4,98699525,In > Out
Sept 2020,112,36,859,94163098,1627932533,1722095631,242,852,5,1533769435,In > Out
Sept 2020,112,38,343,329856695,1404105148,1733961843,102,342,6,1074248453,In > Out
Sept 2020,112,39,115,33731802,1921304743,1955036545,31,115,1,1887572941,In > Out
Sept 2020,112,40,422,398523028,16205624424,16604147452,188,382,7,15807101396,In > Out
Sept 2020,112,41,168,8733319,212093980,220827299,66,168,5,203360661,In > Out
Sept 2020,112,42,996,633262690,7310358907,7943621597,324,985,6,6677096217,In > Out
Sept 2020,112,45,1589,731318005,10717163236,11448481241,342,1530,13,9985845231,In > Out
Sept 2020,112,49,397,41226767,2208988476,2250215243,124,397,5,2167761709,In > Out
Sept 2020,112,50,818,142720468,6950632095,7093352563,236,754,4,6807911627,In > Out
Sept 2020,112,53,416,184035887,2195684332,2379720219,127,415,2,2011648445,In > Out
Sept 2020,112,54,924,141784814,6276701345,6418486159,189,868,4,6134916531,In > Out
Sept 2020,112,59,783,167148448,3353226928,3520375376,215,771,6,3186078480,In > Out
Sept 2020,112,6,1359,492629655,2956831335,3449460990,337,1321,7,2464201680,In > Out
Sept 2020,112,64,1284,513338245,5779372146,6292710391,357,1239,9,5266033901,In > Out
Sept 2020,112,68,704,110133715,2453043071,2563176786,214,690,7,2342909356,In > Out
Sept 2020,112,71,421,62232700,3109258419,3171491119,154,419,4,3047025719,In > Out
Sept 2020,112,72,469,1995917622,5537900704,7533818326,154,459,12,3541983082,In > Out
Sept 2020,112,73,355,103397233,1595878700,1699275933,120,354,5,1492481467,In > Out
Sept 2020,112,74,1635,1805854931,179232436607,181038291538,274,1541,6,177426581676,In > Out
Sept 2020,112,76,962,319262939,3475168704,3794431643,302,956,3,3155905765,In > Out
Sept 2020,112,78,530,138560753,15624088051,15762648804,163,530,2,15485527298,In > Out
Sept 2020,112,84,1081,409188459,6158012424,6567200883,282,1049,7,5748823965,In > Out
Sept 2020,112,86,598,116586986,2883919014,3000506000,260,591,9,2767332028,In > Out
Sept 2020,112,88,2452,1894473571,44208713984,46103187555,508,2308,9,42314240413,In > Out
Sept 2020,112,9,726,1045356143,2504290573,3549646716,154,721,10,1458934430,In > Out
Sept 2020,112,90,436,122358293,4789117642,4911475935,114,430,2,4666759349,In > Out
Sept 2020,112,91,599,879365052,9398274149,10277639201,254,592,11,8518909097,In > Out
Sept 2020,112,93,78,4909017,234050544,238959561,43,78,2,229141527,In > Out
Sept 2020,112,94,1053,412506827,7542194332,7954701159,380,1043,16,7129687505,In > Out
Sept 2020,112,96,1093,494006233,12788152261,13282158494,280,1065,5,12294146028,In > Out
Sept 2020,112,97,396,97127348,1426696618,1523823966,118,393,3,1329569270,In > Out
Sept 2020,112,99,669,143364121,3354824918,3498189039,266,660,5,3211460797,In > Out
Sept 2020,114,110,11,954398,29508149,30462547,5,11,2,28553751,In > Out
Sept 2020,115,169,3,35023,5496876,5531899,3,3,1,5461853,In > Out
Sept 2020,115,170,5,91047,2147658,2238705,5,5,1,2056611,In > Out
Sept 2020,115,175,23,345660,112249361,112595021,14,23,1,111903701,In > Out
Sept 2020,115,73,28,1400210,283691769,285091979,18,28,2,282291559,In > Out
Sept 2020,115,74,381,101203564,5406493332,5507696896,119,377,2,5305289768,In > Out
Sept 2020,115,75,797,118106127,7827284257,7945390384,61,777,2,7709178130,In > Out
Sept 2020,115,95,1238,190478424,5038477878,5228956302,139,1208,2,4847999454,In > Out
Sept 2020,117,147,1033,55069851,4643914693,4698984544,202,1028,2,4588844842,In > Out
Sept 2020,117,148,1020,16217471,2734736221,2750953692,12,1020,3,2718518750,In > Out
Sept 2020,117,150,145,348476331067,4083365058,352559696125,70,142,2,344392966009,Out > In
Sept 2020,117,152,90,8062060,683119298,691181358,44,71,2,675057238,In > Out
Sept 2020,117,16,676,389941284,18978841229,19368782513,132,671,7,18588899945,In > Out
Sept 2020,117,177,402,53135764,716505587,769641351,143,402,3,663369823,In > Out
Sept 2020,117,183,7,777195,244293,1021488,2,7,1,532902,Out > In
Sept 2020,117,185,7,810680,290503,1101183,2,7,1,520177,Out > In
Sept 2020,117,208,7,919445,93243,1012688,3,7,1,826202,Out > In
Sept 2020,117,209,19051,41251846947,38949877965,80201724912,2078,16490,12,2301968982,Out > In
Sept 2020,117,233,2,320494,101914,422408,2,2,2,218580,Out > In
Sept 2020,117,236,17,18834767,24694262,43529029,2,17,2,5859495,In > Out
Sept 2020,117,254,156,4048611112,122409094,4171020206,72,2,107,3926202018,Out > In
Sept 2020,117,50,641,23948618,65835292,89783910,3,531,4,41886674,In > Out
Sept 2020,117,61,645,151161849,191115812,342277661,46,641,3,39953963,In > Out
Sept 2020,117,76,9,22023476,11061308,33084784,1,1,1,10962168,Out > In
Sept 2020,117,81,6,704207,240232,944439,2,6,1,463975,Out > In
Sept 2020,118,104,782,91604578,5598191269,5689795847,37,777,2,5506586691,In > Out
Sept 2020,118,108,2247,803384104,8325214590,9128598694,665,2130,5,7521830486,In > Out
Sept 2020,118,116,593,70097434,2253740209,2323837643,116,593,2,2183642775,In > Out
Sept 2020,118,119,285,76723719,3265959074,3342682793,93,282,3,3189235355,In > Out
Sept 2020,118,120,235,8443642,171839825,180283467,58,235,2,163396183,In > Out
Sept 2020,118,124,1078,145737497,120865203,266602700,59,1061,3,24872294,Out > In
Sept 2020,118,128,279,16458717,4224307347,4240766064,56,279,2,4207848630,In > Out
Sept 2020,118,130,1401,119999682,1159359042,1279358724,244,1347,2,1039359360,In > Out
Sept 2020,118,132,162,56776394,3640870340,3697646734,47,162,2,3584093946,In > Out
Sept 2020,118,133,284,34416143,609250281,643666424,96,283,3,574834138,In > Out
Sept 2020,118,140,1105,253230948,4897195453,5150426401,80,1077,2,4643964505,In > Out
Sept 2020,118,143,4,370192,961744,1331936,1,1,1,591552,In > Out
Sept 2020,118,144,283,473118938,637435559,1110554497,65,283,4,164316621,In > Out
Sept 2020,118,157,37,3765474,74535592,78301066,24,37,2,70770118,In > Out
Sept 2020,118,160,752,43442061,330649210,374091271,150,742,2,287207149,In > Out
Sept 2020,118,162,900,324832624,7333709811,7658542435,86,875,2,7008877187,In > Out
Sept 2020,118,163,983,154698876,4233141676,4387840552,205,957,2,4078442800,In > Out
Sept 2020,118,168,3042,330150587,13923036707,14253187294,332,2730,4,13592886120,In > Out
Sept 2020,118,171,16,98782,6044045,6142827,5,16,2,5945263,In > Out
Sept 2020,118,173,17,1001738,13023930,14025668,9,17,2,12022192,In > Out
Sept 2020,118,177,138,116289728,3746363898,3862653626,54,138,2,3630074170,In > Out
Sept 2020,118,179,4525,2463976589,6810446760,9274423349,563,3993,7,4346470171,In > Out
Sept 2020,118,182,7,399578,416750,816328,1,7,1,17172,In > Out
Sept 2020,118,184,85,3420436,6731565,10152001,6,85,1,3311129,In > Out
Sept 2020,118,185,72,7003351,262818259,269821610,41,72,2,255814908,In > Out
Sept 2020,118,187,22,3724502,17255617,20980119,14,22,2,13531115,In > Out
Sept 2020,118,19,750,145902717,3861219615,4007122332,245,737,2,3715316898,In > Out
Sept 2020,118,191,549,34347904,340237002,374584906,171,526,2,305889098,In > Out
Sept 2020,118,207,274,31945179,891328339,923273518,90,274,3,859383160,In > Out
Sept 2020,118,21,67,11338426,524311115,535649541,16,67,2,512972689,In > Out
Sept 2020,118,210,6358,3722831021,4102399494,7825230515,64,3927,2,379568473,In > Out
Sept 2020,118,213,218,29052266,36078398,65130664,15,217,2,7026132,In > Out
Sept 2020,118,216,94,6426214,200635251,207061465,42,94,2,194209037,In > Out
Sept 2020,118,218,261,21553741,130167699,151721440,53,261,2,108613958,In > Out
Sept 2020,118,225,1397,195673692,885116288,1080789980,62,1379,2,689442596,In > Out
Sept 2020,118,226,24,247786,35304101,35551887,2,24,1,35056315,In > Out
Sept 2020,118,228,206,143422158,126275476,269697634,53,204,2,17146682,Out > In
Sept 2020,118,229,33,6164441,286225961,292390402,21,33,2,280061520,In > Out
Sept 2020,118,230,1663,186310474,5274519924,5460830398,315,1586,2,5088209450,In > Out
Sept 2020,118,231,137,38362568,1980537032,2018899600,43,137,2,1942174464,In > Out
Sept 2020,118,232,86,44486991,3167337076,3211824067,25,86,2,3122850085,In > Out
Sept 2020,118,233,242,32004357,1188236564,1220240921,65,242,2,1156232207,In > Out
Sept 2020,118,237,825,179762354,389372643,569134997,155,810,2,209610289,In > Out
Sept 2020,118,239,4137,861263930,6913830708,7775094638,888,3730,7,6052566778,In > Out
Sept 2020,118,240,13,68848,4384066,4452914,1,13,13,4315218,In > Out
Sept 2020,118,246,79,11071655,601812334,612883989,17,79,2,590740679,In > Out
Sept 2020,118,247,2,206025,153496,359521,1,1,1,52529,Out > In
Sept 2020,118,250,577,40221614,1139966108,1180187722,76,574,5,1099744494,In > Out
Sept 2020,118,254,1187,154089042,7365282106,7519371148,44,1136,2,7211193064,In > Out
Sept 2020,118,26,1061,157647542,95989434,253636976,38,1026,2,61658108,Out > In
Sept 2020,118,33,515,642593788,5205925093,5848518881,73,511,3,4563331305,In > Out
Sept 2020,118,34,224,57163290,3845231444,3902394734,23,224,2,3788068154,In > Out
Sept 2020,118,46,175,10456366,79516953,89973319,41,175,5,69060587,In > Out
Sept 2020,118,47,182,25087115,361452573,386539688,58,181,4,336365458,In > Out
Sept 2020,118,48,306,7128852,406849491,413978343,28,304,2,399720639,In > Out
Sept 2020,118,51,32,3092197,320329585,323421782,16,32,2,317237388,In > Out
Sept 2020,118,53,1012,343527403,10088172193,10431699596,425,986,5,9744644790,In > Out
Sept 2020,118,54,5,1209037,692079,1901116,4,5,1,516958,Out > In
Sept 2020,118,56,44,1330207,181357398,182687605,8,44,2,180027191,In > Out
Sept 2020,118,58,7,605542,423003,1028545,7,7,2,182539,Out > In
Sept 2020,118,63,205,11828276,1085426954,1097255230,54,175,3,1073598678,In > Out
Sept 2020,118,65,400,13651842,583975914,597627756,90,397,2,570324072,In > Out
Sept 2020,118,70,95,6547996,266718997,273266993,33,95,2,260171001,In > Out
Sept 2020,118,71,2444,2047359204,25636239828,27683599032,545,2280,3,23588880624,In > Out
Sept 2020,118,73,45,2167228,34252879,36420107,26,45,2,32085651,In > Out
Sept 2020,118,76,14,82245,5280607,5362852,4,14,1,5198362,In > Out
Sept 2020,118,80,82,4216850,296089727,300306577,14,81,2,291872877,In > Out
Sept 2020,118,81,62,10700036,5962502,16662538,29,62,2,4737534,Out > In
Sept 2020,118,82,1444,144400165,1790433205,1934833370,113,1383,3,1646033040,In > Out
Sept 2020,118,83,190,7742285,3361107747,3368850032,13,190,2,3353365462,In > Out
Sept 2020,118,85,294,7898238,3447914843,3455813081,45,293,2,3440016605,In > Out
Sept 2020,118,99,481,13616856,801477093,815093949,50,477,2,787860237,In > Out
Sept 2020,119,102,9,265402,34795807,35061209,9,9,2,34530405,In > Out
Sept 2020,119,105,4,58284,5076395,5134679,3,4,1,5018111,In > Out
Sept 2020,119,108,342,232083989,3730215431,3962299420,99,340,3,3498131442,In > Out
Sept 2020,119,109,309,107006622,3583334217,3690340839,96,304,2,3476327595,In > Out
Sept 2020,119,111,282,94226571,4019431081,4113657652,39,282,2,3925204510,In > Out
Sept 2020,119,114,3,1239831,51151211,52391042,3,3,2,49911380,In > Out
Sept 2020,119,120,2327,1896532397,2296459088,4192991485,437,2159,7,399926691,In > Out
Sept 2020,119,122,430,67535239,4657942844,4725478083,62,417,2,4590407605,In > Out
Sept 2020,119,125,2206,523882579,2240917204,2764799783,463,2099,3,1717034625,In > Out
Sept 2020,119,128,1601,410812660,3057893191,3468705851,79,1554,3,2647080531,In > Out
Sept 2020,119,135,95,84364213,6297199997,6381564210,23,95,2,6212835784,In > Out
Sept 2020,119,141,447,119720358,1076926687,1196647045,78,442,3,957206329,In > Out
Sept 2020,119,146,417,131541376,5139439117,5270980493,45,416,2,5007897741,In > Out
Sept 2020,119,148,457,122152646,3936267278,4058419924,71,451,3,3814114632,In > Out
Sept 2020,119,150,491,147117951,4692052243,4839170194,180,481,2,4544934292,In > Out
Sept 2020,119,151,13,702811,39951453,40654264,7,13,2,39248642,In > Out
Sept 2020,119,154,353,146553072,2910069808,3056622880,59,349,2,2763516736,In > Out
Sept 2020,119,156,205,49514009,289257443,338771452,84,205,4,239743434,In > Out
Sept 2020,119,159,349,189779309,3248025812,3437805121,92,346,2,3058246503,In > Out
Sept 2020,119,16,3,8591,514834,523425,2,3,1,506243,In > Out
Sept 2020,119,161,54,3950027,94057834,98007861,32,54,2,90107807,In > Out
Sept 2020,119,162,2638,595031724,4469505001,5064536725,102,2433,2,3874473277,In > Out
Sept 2020,119,165,183,104306128,3586921540,3691227668,35,183,2,3482615412,In > Out
Sept 2020,119,168,62,353048979,71915236,424964215,26,8,46,281133743,Out > In
Sept 2020,119,174,108,98529145,3420364830,3518893975,27,108,2,3321835685,In > Out
Sept 2020,119,18,5,213573,32736612,32950185,4,5,2,32523039,In > Out
Sept 2020,119,183,326,210556668,6510463209,6721019877,77,321,2,6299906541,In > Out
Sept 2020,119,184,196,25472165,264381964,289854129,30,196,2,238909799,In > Out
Sept 2020,119,185,3156,41513223653,9390598208,50903821861,654,2777,5,32122625445,Out > In
Sept 2020,119,188,876,242297537,5837345102,6079642639,294,857,8,5595047565,In > Out
Sept 2020,119,189,133,100882608,3506992946,3607875554,27,130,2,3406110338,In > Out
Sept 2020,119,201,22,339859,133153279,133493138,13,22,2,132813420,In > Out
Sept 2020,119,211,9,199641,4782944,4982585,4,9,1,4583303,In > Out
Sept 2020,119,214,168,144801127,3689224484,3834025611,56,168,4,3544423357,In > Out
Sept 2020,119,27,277,66698534,309697909,376396443,96,274,2,242999375,In > Out
Sept 2020,119,29,223,29173936,3839417653,3868591589,25,223,2,3810243717,In > Out
Sept 2020,119,46,122,92834942,3248592440,3341427382,48,121,2,3155757498,In > Out
Sept 2020,119,51,1,182772,27882854,28065626,1,1,1,27700082,In > Out
Sept 2020,119,57,472,154633745,4091772646,4246406391,58,467,2,3937138901,In > Out
Sept 2020,119,58,365,116561838,4553544040,4670105878,50,364,2,4436982202,In > Out
Sept 2020,119,64,154,67133926,4093953541,4161087467,35,153,2,4026819615,In > Out
Sept 2020,119,74,448,218156493,3042749839,3260906332,121,445,2,2824593346,In > Out
Sept 2020,119,75,35,89552415,2988509728,3078062143,5,35,1,2898957313,In > Out
Sept 2020,119,77,1521,260401284,2802767866,3063169150,52,1463,2,2542366582,In > Out
Sept 2020,119,85,175,85342804,3121854856,3207197660,24,175,2,3036512052,In > Out
Sept 2020,119,91,392,103663484,4179492017,4283155501,28,388,2,4075828533,In > Out
Sept 2020,119,93,1232,216506694,1021769582,1238276276,130,1174,3,805262888,In > Out
Sept 2020,120,101,203,62443973,4382858232,4445302205,33,202,2,4320414259,In > Out
Sept 2020,120,126,704,147596601,1347428695,1495025296,61,688,2,1199832094,In > Out
Sept 2020,120,54,152,57269556,1721049446,1778319002,70,152,2,1663779890,In > Out
Sept 2020,120,71,99,7383684,342202118,349585802,14,99,2,334818434,In > Out
Sept 2020,120,85,274,103190938,3882945326,3986136264,96,274,2,3779754388,In > Out
Sept 2020,122,103,4069,970484348,6077710557,7048194905,409,3758,13,5107226209,In > Out
Sept 2020,122,117,122,9252912,156086322,165339234,63,105,20,146833410,In > Out
Sept 2020,122,160,695,107432910,6962282656,7069715566,138,687,3,6854849746,In > Out
Sept 2020,122,161,1,631776,1791,633567,1,1,1,629985,Out > In
Sept 2020,122,165,249,41811499,1217348403,1259159902,72,248,1,1175536904,In > Out
Sept 2020,122,183,3397,127680135982,395015191556,522695327538,1088,2826,599,267335055574,In > Out
Sept 2020,122,205,341,41090356,491253445,532343801,126,333,4,450163089,In > Out
Sept 2020,122,214,58,200414060,64818226,265232286,26,1,41,135595834,Out > In
Sept 2020,122,232,36,7906720,136318353,144225073,14,36,3,128411633,In > Out
Sept 2020,122,237,50,1012450076,1714574241,2727024317,28,32,21,702124165,In > Out
Sept 2020,122,76,253,4658140,57728221,62386361,22,251,4,53070081,In > Out
Sept 2020,122,78,2164,469185539,443222974,912408513,83,2164,4,25962565,Out > In
Sept 2020,123,101,1375,408784709,26059252879,26468037588,383,1356,5,25650468170,In > Out
Sept 2020,123,103,1105,101966796,3088496155,3190462951,310,1020,46,2986529359,In > Out
Sept 2020,123,104,365,89957545,1866095897,1956053442,149,359,7,1776138352,In > Out
Sept 2020,123,105,162,23411573,1206406005,1229817578,37,162,3,1182994432,In > Out
Sept 2020,123,107,176,35179684,1336649974,1371829658,59,175,3,1301470290,In > Out
Sept 2020,123,11,870,891879649,10891378239,11783257888,328,866,4,9999498590,In > Out
Sept 2020,123,110,67,7994688,463919943,471914631,32,67,1,455925255,In > Out
Sept 2020,123,111,1434,787082478,6577249562,7364332040,341,1199,106,5790167084,In > Out
Sept 2020,123,112,544,192925227,3929102613,4122027840,141,539,3,3736177386,In > Out
Sept 2020,123,113,685,285875178,23144543488,23430418666,300,674,5,22858668310,In > Out
Sept 2020,123,116,74,126465465,1062083410,1188548875,38,74,3,935617945,In > Out
Sept 2020,123,117,55,9842200,503979306,513821506,20,55,1,494137106,In > Out
Sept 2020,123,119,365,211123915,6821450833,7032574748,123,361,6,6610326918,In > Out
Sept 2020,123,124,54,8755085,364565038,373320123,24,53,3,355809953,In > Out
Sept 2020,123,126,1144,256147576,11378491823,11634639399,319,1137,2,11122344247,In > Out
Sept 2020,123,128,806,207869681,2026534559,2234404240,230,785,7,1818664878,In > Out
Sept 2020,123,129,400,105933329,1621245832,1727179161,133,397,6,1515312503,In > Out
Sept 2020,123,130,518,427797382,4647232844,5075030226,144,514,5,4219435462,In > Out
Sept 2020,123,131,1377,713781829,4425392910,5139174739,271,1330,3,3711611081,In > Out
Sept 2020,123,132,395,76888497,1860501031,1937389528,75,374,4,1783612534,In > Out
Sept 2020,123,133,2182,6361889455,10960321426,17322210881,296,2054,16,4598431971,In > Out
Sept 2020,123,134,822,593971522,4467405172,5061376694,307,821,4,3873433650,In > Out
Sept 2020,123,135,451,1447888408,1536914994,2984803402,172,449,4,89026586,In > Out
Sept 2020,123,136,247,1361616558,4629616954,5991233512,136,247,5,3268000396,In > Out
Sept 2020,123,137,1243,258719638,12104224078,12362943716,316,1204,10,11845504440,In > Out
Sept 2020,123,138,363,651700819,2146460320,2798161139,132,363,6,1494759501,In > Out
Sept 2020,123,139,804,442690466,12785663957,13228354423,228,788,5,12342973491,In > Out
Sept 2020,123,140,411,70598345,1572503061,1643101406,129,406,7,1501904716,In > Out
Sept 2020,123,141,928,125261945,4574701863,4699963808,314,911,5,4449439918,In > Out
Sept 2020,123,142,177,23550316,879526847,903077163,74,176,1,855976531,In > Out
Sept 2020,123,143,569,183706705,18731208885,18914915590,191,563,3,18547502180,In > Out
Sept 2020,123,144,752,84847149,6246887767,6331734916,149,751,4,6162040618,In > Out
Sept 2020,123,145,59,16592345,651959899,668552244,14,59,2,635367554,In > Out
Sept 2020,123,146,1948,121762500,6595385960,6717148460,234,1932,3,6473623460,In > Out
Sept 2020,123,148,635,150237668,7613344728,7763582396,232,628,7,7463107060,In > Out
Sept 2020,123,149,142,18340670,896258199,914598869,71,142,2,877917529,In > Out
Sept 2020,123,150,1782,3190020036,39506572745,42696592781,425,1733,17,36316552709,In > Out
Sept 2020,123,151,850,70906144,2330603674,2401509818,176,838,6,2259697530,In > Out
Sept 2020,123,152,323,34940985,2067153482,2102094467,133,319,5,2032212497,In > Out
Sept 2020,123,153,2465,394193116,9355188620,9749381736,577,2293,9,8960995504,In > Out
Sept 2020,123,154,267,44769698,623632135,668401833,135,266,3,578862437,In > Out
Sept 2020,123,155,1213,438477201,8276384500,8714861701,223,1185,3,7837907299,In > Out
Sept 2020,123,156,506,202854619,6706705176,6909559795,153,497,4,6503850557,In > Out
Sept 2020,123,157,544,813625181,2232340640,3045965821,205,537,7,1418715459,In > Out
Sept 2020,123,158,1246,1016518260,53978424633,54994942893,411,1242,5,52961906373,In > Out
Sept 2020,123,159,158,373017639,298289874,671307513,92,158,4,74727765,Out > In
Sept 2020,123,16,513,153901355,4207048144,4360949499,199,500,6,4053146789,In > Out
Sept 2020,123,163,1247,118555345,5223329166,5341884511,150,1227,4,5104773821,In > Out
Sept 2020,123,164,1143,229600906,7967149147,8196750053,379,1110,12,7737548241,In > Out
Sept 2020,123,166,499,110775505,4035495249,4146270754,184,478,3,3924719744,In > Out
Sept 2020,123,167,414,44344690,1301885093,1346229783,120,411,2,1257540403,In > Out
Sept 2020,123,168,1355,166650950,6342555150,6509206100,299,1316,7,6175904200,In > Out
Sept 2020,123,169,547,374728420,3207678536,3582406956,200,539,6,2832950116,In > Out
Sept 2020,123,17,270,47865716,368363647,416229363,141,270,4,320497931,In > Out
Sept 2020,123,170,122,8458630,302895828,311354458,80,122,4,294437198,In > Out
Sept 2020,123,171,1387,261080349,13448890773,13709971122,404,1349,5,13187810424,In > Out
Sept 2020,123,172,568,168072429,6738056262,6906128691,143,565,4,6569983833,In > Out
Sept 2020,123,173,8,675032,8587914,9262946,5,8,2,7912882,In > Out
Sept 2020,123,174,289,62630468,3701928015,3764558483,87,283,3,3639297547,In > Out
Sept 2020,123,177,560,133732576,2848690179,2982422755,184,548,3,2714957603,In > Out
Sept 2020,123,178,162,147274379,6320268756,6467543135,83,162,3,6172994377,In > Out
Sept 2020,123,179,300,32126153,1656325378,1688451531,129,300,4,1624199225,In > Out
Sept 2020,123,180,731,236303088,11211554936,11447858024,202,710,5,10975251848,In > Out
Sept 2020,123,183,620,679143069,6200191308,6879334377,217,611,8,5521048239,In > Out
Sept 2020,123,187,1556,322973259,9349051236,9672024495,318,1512,6,9026077977,In > Out
Sept 2020,123,189,2782,8242024538,50752089008,58994113546,585,2647,9,42510064470,In > Out
Sept 2020,123,190,808,203691870,7255011126,7458702996,244,793,3,7051319256,In > Out
Sept 2020,123,191,772,207345399,3013663217,3221008616,237,753,7,2806317818,In > Out
Sept 2020,123,192,859,110084842,8786330492,8896415334,130,822,4,8676245650,In > Out
Sept 2020,123,197,309,64761715,1409656774,1474418489,91,309,2,1344895059,In > Out
Sept 2020,123,198,243,71323913,691632480,762956393,95,241,3,620308567,In > Out
Sept 2020,123,199,685,59653202,2158560694,2218213896,123,684,3,2098907492,In > Out
Sept 2020,123,20,487,112565432,9722521893,9835087325,140,476,2,9609956461,In > Out
Sept 2020,123,200,888,264261922,5078173425,5342435347,247,851,4,4813911503,In > Out
Sept 2020,123,201,224,28648728,932940973,961589701,107,224,2,904292245,In > Out
Sept 2020,123,203,597,76663211,1591244884,1667908095,121,588,5,1514581673,In > Out
Sept 2020,123,204,177,23955810,635439335,659395145,78,176,5,611483525,In > Out
Sept 2020,123,206,773,308978716,5161301269,5470279985,277,757,7,4852322553,In > Out
Sept 2020,123,208,881,408848890,7178437190,7587286080,287,873,8,6769588300,In > Out
Sept 2020,123,21,439,80068474,1601905083,1681973557,172,439,5,1521836609,In > Out
Sept 2020,123,211,1077,964970710,41733274689,42698245399,209,989,5,40768303979,In > Out
Sept 2020,123,212,62,29461212,129864375,159325587,48,62,3,100403163,In > Out
Sept 2020,123,216,952,241851322,10443565763,10685417085,229,952,4,10201714441,In > Out
Sept 2020,123,217,463,68333504,3210872964,3279206468,176,452,6,3142539460,In > Out
Sept 2020,123,219,809,549452403,11575403606,12124856009,303,794,7,11025951203,In > Out
Sept 2020,123,22,1279,325260129,15299701835,15624961964,303,1235,7,14974441706,In > Out
Sept 2020,123,221,476,61447200,1726521253,1787968453,155,472,3,1665074053,In > Out
Sept 2020,123,222,1007,189202464,4226942990,4416145454,273,916,9,4037740526,In > Out
Sept 2020,123,223,609,533565372,3595805858,4129371230,270,602,18,3062240486,In > Out
Sept 2020,123,23,1420,325688875,14681149360,15006838235,153,1382,5,14355460485,In > Out
Sept 2020,123,24,398,31379781,1741813351,1773193132,203,396,4,1710433570,In > Out
Sept 2020,123,25,380,442110758,1218072670,1660183428,103,379,7,775961912,In > Out
Sept 2020,123,27,321,38181663,1118391141,1156572804,107,321,4,1080209478,In > Out
Sept 2020,123,28,536,633209360,2165497171,2798706531,150,522,11,1532287811,In > Out
Sept 2020,123,31,278,170916076,554729611,725645687,118,278,3,383813535,In > Out
Sept 2020,123,33,726,415681140,4816575125,5232256265,217,694,7,4400893985,In > Out
Sept 2020,123,35,163,19968852,1286845199,1306814051,94,163,3,1266876347,In > Out
Sept 2020,123,36,686,82812057,2814089652,2896901709,130,683,4,2731277595,In > Out
Sept 2020,123,37,18,1687413,41776107,43463520,9,18,2,40088694,In > Out
Sept 2020,123,38,270,302844929,617069024,919913953,81,269,5,314224095,In > Out
Sept 2020,123,39,1593,290767340,10457570237,10748337577,449,1557,14,10166802897,In > Out
Sept 2020,123,4,1046,932818593,12589141320,13521959913,313,1036,5,11656322727,In > Out
Sept 2020,123,40,1380,3532846684,5999159999,9532006683,340,1340,4,2466313315,In > Out
Sept 2020,123,42,129,29460156,2253052586,2282512742,59,129,4,2223592430,In > Out
Sept 2020,123,43,100,13161622,545709735,558871357,38,100,2,532548113,In > Out
Sept 2020,123,45,905,75681830,6922888879,6998570709,231,904,6,6847207049,In > Out
Sept 2020,123,48,1876,2261109873,6898329200,9159439073,226,1839,4,4637219327,In > Out
Sept 2020,123,5,21,3682790,162618948,166301738,14,21,2,158936158,In > Out
Sept 2020,123,53,4,130721,452700,583421,4,4,2,321979,In > Out
Sept 2020,123,54,648,119355460,3708079763,3827435223,253,643,9,3588724303,In > Out
Sept 2020,123,55,171,38233538,1226679196,1264912734,79,171,6,1188445658,In > Out
Sept 2020,123,56,589,159632537,4389715755,4549348292,119,580,4,4230083218,In > Out
Sept 2020,123,57,122,10008753,229511631,239520384,86,122,4,219502878,In > Out
Sept 2020,123,58,577,1912968892,3636400506,5549369398,131,566,7,1723431614,In > Out
Sept 2020,123,59,8,606157,101940045,102546202,7,8,2,101333888,In > Out
Sept 2020,123,60,325,41268382,2202173931,2243442313,95,325,5,2160905549,In > Out
Sept 2020,123,61,961,591054148,7326351379,7917405527,169,947,8,6735297231,In > Out
Sept 2020,123,62,1378,936581650,11244999374,12181581024,377,1300,7,10308417724,In > Out
Sept 2020,123,63,950,3674834461,14028530956,17703365417,203,836,13,10353696495,In > Out
Sept 2020,123,64,252,14338634,549166022,563504656,98,245,4,534827388,In > Out
Sept 2020,123,65,903,1092783474,8242057454,9334840928,269,854,4,7149273980,In > Out
Sept 2020,123,66,484,440578492,2998224684,3438803176,175,479,6,2557646192,In > Out
Sept 2020,123,68,80,11895024,128187594,140082618,64,80,3,116292570,In > Out
Sept 2020,123,70,2738,493251439,4832622527,5325873966,390,2501,6,4339371088,In > Out
Sept 2020,123,72,20,476784,5440105,5916889,12,20,2,4963321,In > Out
Sept 2020,123,74,2825,1422333918,22966561655,24388895573,603,2668,6,21544227737,In > Out
Sept 2020,123,75,1344,328175028,16011631397,16339806425,321,1316,9,15683456369,In > Out
Sept 2020,123,77,477,195812946,8956647762,9152460708,185,471,4,8760834816,In > Out
Sept 2020,123,79,234,52411066,607315788,659726854,77,233,4,554904722,In > Out
Sept 2020,123,81,3649,683539902,34657820309,35341360211,728,3526,1,33974280407,In > Out
Sept 2020,123,82,2330,1339474971,24912295539,26251770510,381,2210,7,23572820568,In > Out
Sept 2020,123,86,812,234596468,10863460768,11098057236,264,808,5,10628864300,In > Out
Sept 2020,123,87,1024,539116131,6533901360,7073017491,251,1019,6,5994785229,In > Out
Sept 2020,123,89,1039,585964144,4147719115,4733683259,286,1000,8,3561754971,In > Out
Sept 2020,123,90,788,440209307,2581497447,3021706754,220,765,8,2141288140,In > Out
Sept 2020,123,92,559,272143465,12144941119,12417084584,138,557,5,11872797654,In > Out
Sept 2020,123,93,1835,1210826880,8181898676,9392725556,323,1751,11,6971071796,In > Out
Sept 2020,123,94,834,175614320,8774132962,8949747282,177,820,2,8598518642,In > Out
Sept 2020,123,96,351,37675164,1809229685,1846904849,98,350,4,1771554521,In > Out
Sept 2020,123,97,813,1011092234,4829535626,5840627860,292,793,10,3818443392,In > Out
Sept 2020,123,98,919,467079022,6868752823,7335831845,337,906,8,6401673801,In > Out
Sept 2020,123,99,1228,160276492,7748450842,7908727334,279,1210,5,7588174350,In > Out
Sept 2020,124,10,635,61582907,2102808025,2164390932,142,629,4,2041225118,In > Out
Sept 2020,124,100,159,97342863,796587502,893930365,66,159,4,699244639,In > Out
Sept 2020,124,101,89,9033636,408012553,417046189,41,89,1,398978917,In > Out
Sept 2020,124,104,429,61356298,591424766,652781064,152,428,4,530068468,In > Out
Sept 2020,124,105,196,28757963,462106951,490864914,120,193,4,433348988,In > Out
Sept 2020,124,106,1697,391187056,15861607185,16252794241,381,1623,11,15470420129,In > Out
Sept 2020,124,108,1528,3297800968,8878205958,12176006926,258,1430,12,5580404990,In > Out
Sept 2020,124,109,541,57210597,1663391959,1720602556,213,531,4,1606181362,In > Out
Sept 2020,124,11,475,2500796856,5476300219,7977097075,195,460,5,2975503363,In > Out
Sept 2020,124,110,308,177611985,1887316079,2064928064,111,305,4,1709704094,In > Out
Sept 2020,124,112,594,256656608,7778004755,8034661363,215,588,5,7521348147,In > Out
Sept 2020,124,113,552,72262986,2881906101,2954169087,191,535,4,2809643115,In > Out
Sept 2020,124,115,519,87375717,3757176485,3844552202,225,506,3,3669800768,In > Out
Sept 2020,124,116,586,591943808,24001217826,24593161634,257,573,5,23409274018,In > Out
Sept 2020,124,117,637,395170955,17822382862,18217553817,230,632,5,17427211907,In > Out
Sept 2020,124,118,551,149473680,5245835047,5395308727,122,551,5,5096361367,In > Out
Sept 2020,124,120,1260,323980326,10243977155,10567957481,389,1212,10,9919996829,In > Out
Sept 2020,124,121,212,24198279,4995690081,5019888360,116,207,5,4971491802,In > Out
Sept 2020,124,124,175,34517033,1188666369,1223183402,82,175,5,1154149336,In > Out
Sept 2020,124,125,578,156843515,2852755361,3009598876,175,576,9,2695911846,In > Out
Sept 2020,124,126,841,149082966,11164423810,11313506776,208,829,3,11015340844,In > Out
Sept 2020,124,128,314,66450627,1081776280,1148226907,113,314,4,1015325653,In > Out
Sept 2020,124,129,911,1195626389,8061183823,9256810212,321,902,7,6865557434,In > Out
Sept 2020,124,130,1731,373802630,3099449075,3473251705,263,1700,5,2725646445,In > Out
Sept 2020,124,131,272,37389761,1089451886,1126841647,129,271,4,1052062125,In > Out
Sept 2020,124,132,348,99910950,6502308525,6602219475,114,347,5,6402397575,In > Out
Sept 2020,124,133,164,109295040,1481286251,1590581291,75,163,5,1371991211,In > Out
Sept 2020,124,134,195,24665350,952683042,977348392,84,193,3,928017692,In > Out
Sept 2020,124,135,339,42276480,839662580,881939060,121,329,5,797386100,In > Out
Sept 2020,124,136,442,299438259,6583866055,6883304314,163,441,6,6284427796,In > Out
Sept 2020,124,137,353,639265907,33123948954,33763214861,105,352,3,32484683047,In > Out
Sept 2020,124,138,520,96777245,1316209059,1412986304,119,515,4,1219431814,In > Out
Sept 2020,124,139,510,196343466,4566739012,4763082478,213,506,6,4370395546,In > Out
Sept 2020,124,14,122,217725621,371827265,589552886,75,121,3,154101644,In > Out
Sept 2020,124,140,1837,628871787,8014022784,8642894571,509,1772,5,7385150997,In > Out
Sept 2020,124,141,1170,536054218,57806254306,58342308524,477,1139,7,57270200088,In > Out
Sept 2020,124,142,1709,606616644,37979285932,38585902576,516,1683,7,37372669288,In > Out
Sept 2020,124,143,322,63128503,1827571067,1890699570,100,320,7,1764442564,In > Out
Sept 2020,124,144,748,96721124,3203630622,3300351746,201,733,11,3106909498,In > Out
Sept 2020,124,145,559,479652899,3980420600,4460073499,113,554,4,3500767701,In > Out
Sept 2020,124,146,1235,239450993,7769187148,8008638141,240,1207,5,7529736155,In > Out
Sept 2020,124,147,619,2497909610,3671418156,6169327766,164,608,9,1173508546,In > Out
Sept 2020,124,148,134,14926792,520580133,535506925,54,132,4,505653341,In > Out
Sept 2020,124,149,654,992308620,4103190678,5095499298,109,654,6,3110882058,In > Out
Sept 2020,124,150,392,655253868,3963817675,4619071543,171,382,3,3308563807,In > Out
Sept 2020,124,151,281,52026176,580168196,632194372,136,280,3,528142020,In > Out
Sept 2020,124,152,202,19971655,471918129,491889784,132,202,2,451946474,In > Out
Sept 2020,124,153,643,270145398,13648053948,13918199346,198,621,4,13377908550,In > Out
Sept 2020,124,154,1152,298476835,4871929794,5170406629,181,1114,8,4573452959,In > Out
Sept 2020,124,155,808,90342857,9156759995,9247102852,174,801,6,9066417138,In > Out
Sept 2020,124,156,600,132316343,4377534709,4509851052,199,591,6,4245218366,In > Out
Sept 2020,124,157,588,1073253999,3921604333,4994858332,148,583,7,2848350334,In > Out
Sept 2020,124,158,1090,244751433,24531507801,24776259234,356,1087,4,24286756368,In > Out
Sept 2020,124,159,82,4670763,195185907,199856670,42,82,3,190515144,In > Out
Sept 2020,124,16,147,8392548,88564320,96956868,52,147,4,80171772,In > Out
Sept 2020,124,160,692,211976435,5965494602,6177471037,259,692,11,5753518167,In > Out
Sept 2020,124,161,1290,267744626,9572641772,9840386398,340,1244,3,9304897146,In > Out
Sept 2020,124,162,58,2824054,47344836,50168890,38,58,2,44520782,In > Out
Sept 2020,124,163,258,255717400,310688685,566406085,101,258,5,54971285,In > Out
Sept 2020,124,164,92,6963650,110543089,117506739,38,92,2,103579439,In > Out
Sept 2020,124,165,809,237251408,3824779163,4062030571,201,807,5,3587527755,In > Out
Sept 2020,124,166,1333,171269331,5718420339,5889689670,342,1297,6,5547151008,In > Out
Sept 2020,124,167,1654,781179135,5184561285,5965740420,296,1569,7,4403382150,In > Out
Sept 2020,124,168,385,36556225,936931390,973487615,166,383,4,900375165,In > Out
Sept 2020,124,169,605,99253042,3805324467,3904577509,167,589,3,3706071425,In > Out
Sept 2020,124,17,1212,1773961781,31636309373,33410271154,398,1192,6,29862347592,In > Out
Sept 2020,124,170,249,23097703,1075423824,1098521527,97,248,4,1052326121,In > Out
Sept 2020,124,171,93,12237864,250186229,262424093,49,93,3,237948365,In > Out
Sept 2020,124,172,1668,466905756,3883869773,4350775529,380,1628,8,3416964017,In > Out
Sept 2020,124,173,87,6599505,181210723,187810228,42,87,3,174611218,In > Out
Sept 2020,124,174,466,845648909,3818082483,4663731392,126,463,4,2972433574,In > Out
Sept 2020,124,176,122,29129503,615207581,644337084,61,122,5,586078078,In > Out
Sept 2020,124,177,375,120054854,1143618194,1263673048,110,374,5,1023563340,In > Out
Sept 2020,124,178,312,217394044,1475690187,1693084231,145,310,3,1258296143,In > Out
Sept 2020,124,179,436,663419102,2850962652,3514381754,109,407,4,2187543550,In > Out
Sept 2020,124,18,274,3162703545,2853970407,6016673952,76,272,4,308733138,Out > In
Sept 2020,124,181,42,2050885,102654078,104704963,3,42,1,100603193,In > Out
Sept 2020,124,182,1165,664590036,23135760806,23800350842,355,1121,7,22471170770,In > Out
Sept 2020,124,183,420,104819248,1816166372,1920985620,156,417,6,1711347124,In > Out
Sept 2020,124,184,781,155363964,5202919477,5358283441,285,769,4,5047555513,In > Out
Sept 2020,124,185,909,518538201,20834456501,21352994702,356,894,10,20315918300,In > Out
Sept 2020,124,186,300,61075862,2262468965,2323544827,79,297,3,2201393103,In > Out
Sept 2020,124,187,275,219778194,6181397077,6401175271,123,275,7,5961618883,In > Out
Sept 2020,124,188,1346,460108495,12514450554,12974559049,373,1299,9,12054342059,In > Out
Sept 2020,124,189,932,135709695,2154915519,2290625214,319,919,5,2019205824,In > Out
Sept 2020,124,19,376,95577108,2659804883,2755381991,116,370,5,2564227775,In > Out
Sept 2020,124,190,1238,2801251737,2507251745,5308503482,190,1207,6,293999992,Out > In
Sept 2020,124,191,729,767324240,2039900302,2807224542,173,709,5,1272576062,In > Out
Sept 2020,124,192,884,1438572257,3107741478,4546313735,237,862,4,1669169221,In > Out
Sept 2020,124,193,21,1743651,39497658,41241309,19,21,1,37754007,In > Out
Sept 2020,124,195,343,37640827,1080882242,1118523069,86,341,4,1043241415,In > Out
Sept 2020,124,197,123,10513233,152971081,163484314,42,123,3,142457848,In > Out
Sept 2020,124,199,381,86829235,1794416820,1881246055,188,378,6,1707587585,In > Out
Sept 2020,124,20,277,30850871,802596864,833447735,110,275,2,771745993,In > Out
Sept 2020,124,200,150,543789188,1767462187,2311251375,61,150,4,1223672999,In > Out
Sept 2020,124,201,945,320125938,7013035873,7333161811,352,927,7,6692909935,In > Out
Sept 2020,124,202,1011,464200104,5754800501,6219000605,342,995,5,5290600397,In > Out
Sept 2020,124,203,252,267559805,847882849,1115442654,97,246,8,580323044,In > Out
Sept 2020,124,204,219,32241215,1146327131,1178568346,73,219,4,1114085916,In > Out
Sept 2020,124,205,326,50608219,2489864223,2540472442,143,326,6,2439256004,In > Out
Sept 2020,124,206,1023,142696919,3718743965,3861440884,288,997,7,3576047046,In > Out
Sept 2020,124,207,504,8679020746,3649232231,12328252977,168,501,3,5029788515,Out > In
Sept 2020,124,208,252,28547663,820468857,849016520,107,247,6,791921194,In > Out
Sept 2020,124,21,824,1442332827,4607680365,6050013192,188,814,8,3165347538,In > Out
Sept 2020,124,211,1077,1259395830,111945048567,113204444397,326,1066,5,110685652737,In > Out
Sept 2020,124,212,523,97780411,1035073153,1132853564,166,512,7,937292742,In > Out
Sept 2020,124,213,622,105448080,7707778589,7813226669,118,621,5,7602330509,In > Out
Sept 2020,124,214,473,146487682,3456678029,3603165711,135,468,5,3310190347,In > Out
Sept 2020,124,215,422,742787521,3216910818,3959698339,171,418,12,2474123297,In > Out
Sept 2020,124,216,424,127722403,6220801307,6348523710,181,405,5,6093078904,In > Out
Sept 2020,124,219,1168,495902883,6700670611,7196573494,396,1148,8,6204767728,In > Out
Sept 2020,124,22,2766,1224931923,58788462126,60013394049,560,2727,7,57563530203,In > Out
Sept 2020,124,221,423,75234971,1762343901,1837578872,127,418,5,1687108930,In > Out
Sept 2020,124,223,507,131133930,4542268911,4673402841,103,502,10,4411134981,In > Out
Sept 2020,124,23,374,281692153,3544200567,3825892720,78,372,3,3262508414,In > Out
Sept 2020,124,24,487,74158627,3400794028,3474952655,160,484,9,3326635401,In > Out
Sept 2020,124,25,758,48343529,2776020692,2824364221,134,758,3,2727677163,In > Out
Sept 2020,124,26,514,143140221,2980215582,3123355803,260,513,6,2837075361,In > Out
Sept 2020,124,27,82,16348956,434799959,451148915,46,82,3,418451003,In > Out
Sept 2020,124,29,861,77028039,3305366499,3382394538,241,834,3,3228338460,In > Out
Sept 2020,124,32,456,301097728,4690992410,4992090138,152,453,6,4389894682,In > Out
Sept 2020,124,33,751,253538256,2976367723,3229905979,121,742,6,2722829467,In > Out
Sept 2020,124,35,293,34608097,602620609,637228706,124,293,6,568012512,In > Out
Sept 2020,124,36,344,72936717,1353746493,1426683210,124,344,5,1280809776,In > Out
Sept 2020,124,37,134,13434026,169631364,183065390,43,133,3,156197338,In > Out
Sept 2020,124,39,533,66864528,2479088370,2545952898,198,520,4,2412223842,In > Out
Sept 2020,124,41,642,166140648,6535107379,6701248027,212,635,5,6368966731,In > Out
Sept 2020,124,43,308,111217705,9634390297,9745608002,78,307,5,9523172592,In > Out
Sept 2020,124,44,372,53941732,1346287374,1400229106,151,371,6,1292345642,In > Out
Sept 2020,124,45,1174,270789846,11936457114,12207246960,259,1130,3,11665667268,In > Out
Sept 2020,124,46,18,1400198,32721265,34121463,15,18,2,31321067,In > Out
Sept 2020,124,48,506,29752023,1288584776,1318336799,142,506,3,1258832753,In > Out
Sept 2020,124,5,215,37136097,1511593328,1548729425,69,213,4,1474457231,In > Out
Sept 2020,124,51,1963,4273624026,3835118689,8108742715,262,1927,5,438505337,Out > In
Sept 2020,124,52,815,1212902809,3917558488,5130461297,160,806,12,2704655679,In > Out
Sept 2020,124,53,1749,283051458,11659935453,11942986911,436,1707,4,11376883995,In > Out
Sept 2020,124,54,160,16509722,296980691,313490413,57,160,2,280470969,In > Out
Sept 2020,124,55,905,199324144,8652250777,8851574921,166,896,2,8452926633,In > Out
Sept 2020,124,56,1840,1611719024,4447747243,6059466267,210,1113,22,2836028219,In > Out
Sept 2020,124,58,944,627240903,5969486438,6596727341,240,935,7,5342245535,In > Out
Sept 2020,124,59,338,107275740,6770283603,6877559343,147,333,5,6663007863,In > Out
Sept 2020,124,60,28,5046019,142785040,147831059,22,28,2,137739021,In > Out
Sept 2020,124,64,1149,295127067,7074561159,7369688226,292,1129,6,6779434092,In > Out
Sept 2020,124,65,1241,390437400,24251908571,24642345971,384,1224,6,23861471171,In > Out
Sept 2020,124,67,390,119305011,4794994709,4914299720,120,389,4,4675689698,In > Out
Sept 2020,124,68,1400,1254429327,17287699398,18542128725,387,1350,7,16033270071,In > Out
Sept 2020,124,69,755,1057354237,6071743722,7129097959,208,745,11,5014389485,In > Out
Sept 2020,124,70,316,535716748,2744955338,3280672086,134,313,6,2209238590,In > Out
Sept 2020,124,71,1116,162382352,6604268758,6766651110,230,1064,4,6441886406,In > Out
Sept 2020,124,73,536,543425038,1950613492,2494038530,231,532,4,1407188454,In > Out
Sept 2020,124,74,229,70286020,1600596785,1670882805,72,223,5,1530310765,In > Out
Sept 2020,124,77,186,45841743,2869443437,2915285180,74,184,2,2823601694,In > Out
Sept 2020,124,78,1207,3309728039,6469422897,9779150936,294,1177,11,3159694858,In > Out
Sept 2020,124,79,40,13925964,2155192359,2169118323,23,40,2,2141266395,In > Out
Sept 2020,124,8,170,45990712,301676645,347667357,63,168,8,255685933,In > Out
Sept 2020,124,81,985,169391974,6727131279,6896523253,272,966,3,6557739305,In > Out
Sept 2020,124,82,131,12915814,438681526,451597340,76,116,22,425765712,In > Out
Sept 2020,124,83,525,141290741,2707365421,2848656162,225,516,5,2566074680,In > Out
Sept 2020,124,85,3,453446,1530978,1984424,3,3,1,1077532,In > Out
Sept 2020,124,87,38,65986014,72699086,138685100,25,38,2,6713072,In > Out
Sept 2020,124,9,1024,1382640837,7038814042,8421454879,308,1018,16,5656173205,In > Out
Sept 2020,124,91,288,66285138,1369797376,1436082514,127,284,4,1303512238,In > Out
Sept 2020,124,96,1608,1251070627,20252886933,21503957560,405,1554,9,19001816306,In > Out
Sept 2020,124,97,468,120993971,4101698687,4222692658,182,465,6,3980704716,In > Out
Sept 2020,124,98,331,450596521,5063756849,5514353370,146,326,8,4613160328,In > Out
Sept 2020,125,152,221,5297508873,1045074149,6342583022,59,221,2,4252434724,Out > In
Sept 2020,125,185,330,14895407,777779289,792674696,44,330,2,762883882,In > Out
Sept 2020,125,210,69,4607012,134576708,139183720,26,69,3,129969696,In > Out
Sept 2020,125,212,239,26676866,289898199,316575065,10,239,2,263221333,In > Out
Sept 2020,125,43,26,1448932,65059173,66508105,11,26,2,63610241,In > Out
Sept 2020,125,69,345,15922344,202812796,218735140,29,345,2,186890452,In > Out
Sept 2020,126,25,3,135785,30786707,30922492,2,3,2,30650922,In > Out
Sept 2020,127,10,220,25735039,273879973,299615012,79,219,2,248144934,In > Out
Sept 2020,127,100,494,62274612,1950660103,2012934715,230,475,4,1888385491,In > Out
Sept 2020,127,103,113,9014158,296467584,305481742,80,113,3,287453426,In > Out
Sept 2020,127,105,267,16214571,298175766,314390337,143,267,3,281961195,In > Out
Sept 2020,127,106,1164,266321913,9860759309,10127081222,282,1101,5,9594437396,In > Out
Sept 2020,127,109,603,388025356,20537750043,20925775399,226,598,4,20149724687,In > Out
Sept 2020,127,11,1003,605538270,4583491716,5189029986,332,987,4,3977953446,In > Out
Sept 2020,127,111,1488,956545147,10858169952,11814715099,298,1429,5,9901624805,In > Out
Sept 2020,127,114,49,3541866,309539103,313080969,15,49,2,305997237,In > Out
Sept 2020,127,117,3910,1268315961,23577292317,24845608278,413,3392,32,22308976356,In > Out
Sept 2020,127,119,7873,734472017,10267802412,11002274429,671,6158,7,9533330395,In > Out
Sept 2020,127,121,409,586424421,2494290945,3080715366,104,405,6,1907866524,In > Out
Sept 2020,127,122,217,21716165,377430397,399146562,113,216,5,355714232,In > Out
Sept 2020,127,123,1512,175712830,5438913337,5614626167,282,1471,10,5263200507,In > Out
Sept 2020,127,124,359,421983335,1589126186,2011109521,162,358,9,1167142851,In > Out
Sept 2020,127,126,847,203713542,5249596545,5453310087,194,841,7,5045883003,In > Out
Sept 2020,127,128,95,15101218,488131240,503232458,30,95,2,473030022,In > Out
Sept 2020,127,129,532,401884237,4411772010,4813656247,227,523,7,4009887773,In > Out
Sept 2020,127,13,329,21066138,894527114,915593252,115,328,5,873460976,In > Out
Sept 2020,127,130,239,98716296,1528668124,1627384420,89,239,3,1429951828,In > Out
Sept 2020,127,131,634,211017193,6604183697,6815200890,259,630,5,6393166504,In > Out
Sept 2020,127,132,332,638772326,4909801642,5548573968,86,329,3,4271029316,In > Out
Sept 2020,127,133,991,1303143973,4394720562,5697864535,244,976,7,3091576589,In > Out
Sept 2020,127,134,466,175633523,4006960975,4182594498,204,466,2,3831327452,In > Out
Sept 2020,127,135,142,15505356,419601961,435107317,67,142,3,404096605,In > Out
Sept 2020,127,136,62,5590168,133665167,139255335,26,62,1,128074999,In > Out
Sept 2020,127,137,495,222487044,8430021363,8652508407,202,493,3,8207534319,In > Out
Sept 2020,127,139,595,92565749,3811746535,3904312284,150,590,11,3719180786,In > Out
Sept 2020,127,14,947,1467367385,9790070654,11257438039,253,922,5,8322703269,In > Out
Sept 2020,127,140,24,852262,32785141,33637403,10,24,1,31932879,In > Out
Sept 2020,127,141,258,46028357,2662376495,2708404852,95,256,4,2616348138,In > Out
Sept 2020,127,142,400,171808711,1682152071,1853960782,106,394,6,1510343360,In > Out
Sept 2020,127,143,384,135543652,2326704811,2462248463,158,380,5,2191161159,In > Out
Sept 2020,127,145,1242,131726716,1803475161,1935201877,181,1222,7,1671748445,In > Out
Sept 2020,127,146,58,2058042,38644714,40702756,16,58,1,36586672,In > Out
Sept 2020,127,147,597,304205166,1890374444,2194579610,199,568,4,1586169278,In > Out
Sept 2020,127,148,604,123435624,5003155782,5126591406,233,596,4,4879720158,In > Out
Sept 2020,127,149,1715,415705618,16779437103,17195142721,297,1651,5,16363731485,In > Out
Sept 2020,127,150,23,1087394,28797123,29884517,15,23,1,27709729,In > Out
Sept 2020,127,151,181,53633894,726089882,779723776,62,180,3,672455988,In > Out
Sept 2020,127,152,744,207706816,3511910412,3719617228,153,726,5,3304203596,In > Out
Sept 2020,127,154,918,425941630,5025061316,5451002946,246,872,6,4599119686,In > Out
Sept 2020,127,155,1519,139792156,8520285559,8660077715,187,1472,7,8380493403,In > Out
Sept 2020,127,156,52,4671528,269023988,273695516,37,52,2,264352460,In > Out
Sept 2020,127,157,11,2571663,139966574,142538237,9,11,2,137394911,In > Out
Sept 2020,127,158,198,173348488,15887728444,16061076932,86,197,4,15714379956,In > Out
Sept 2020,127,159,457,90067610,5674916136,5764983746,164,452,6,5584848526,In > Out
Sept 2020,127,160,1,389578,29398,418976,1,1,1,360180,Out > In
Sept 2020,127,161,637,582668479,3418440867,4001109346,147,628,6,2835772388,In > Out
Sept 2020,127,162,521,219943844,3414432153,3634375997,195,520,8,3194488309,In > Out
Sept 2020,127,163,384,170630432,10281026383,10451656815,139,384,3,10110395951,In > Out
Sept 2020,127,164,661,73745050,3758510018,3832255068,109,652,4,3684764968,In > Out
Sept 2020,127,165,564,216835173,2213035275,2429870448,91,562,2,1996200102,In > Out
Sept 2020,127,166,256,96327218,1445360661,1541687879,89,255,7,1349033443,In > Out
Sept 2020,127,167,885,102583330,6372290480,6474873810,333,878,4,6269707150,In > Out
Sept 2020,127,168,50,4713789,156851693,161565482,20,50,2,152137904,In > Out
Sept 2020,127,169,150,89509530,4281764496,4371274026,43,150,4,4192254966,In > Out
Sept 2020,127,17,1909,381196248,25273963512,25655159760,333,1821,6,24892767264,In > Out
Sept 2020,127,170,49,150734388,2315843659,2466578047,21,49,2,2165109271,In > Out
Sept 2020,127,172,353,94136415,4440166515,4534302930,148,351,3,4346030100,In > Out
Sept 2020,127,173,1325,493336951,23396936519,23890273470,399,1248,5,22903599568,In > Out
Sept 2020,127,174,151,151704367,1005239607,1156943974,73,150,10,853535240,In > Out
Sept 2020,127,175,838,143621157,2414670524,2558291681,222,825,6,2271049367,In > Out
Sept 2020,127,176,253,110684264,8883607998,8994292262,126,253,4,8772923734,In > Out
Sept 2020,127,177,1171,1169601544,5905938165,7075539709,311,1148,18,4736336621,In > Out
Sept 2020,127,178,768,414212054,6919557856,7333769910,200,757,2,6505345802,In > Out
Sept 2020,127,179,467,71636128,2268895517,2340531645,133,464,4,2197259389,In > Out
Sept 2020,127,180,723,170591878,8200445180,8371037058,217,707,4,8029853302,In > Out
Sept 2020,127,181,216,60056693,3513997493,3574054186,85,216,5,3453940800,In > Out
Sept 2020,127,182,773,190146985,2887825294,3077972279,168,757,3,2697678309,In > Out
Sept 2020,127,183,1810,322186191,4466563690,4788749881,354,1791,4,4144377499,In > Out
Sept 2020,127,184,1095,494777218,6694566020,7189343238,312,1082,8,6199788802,In > Out
Sept 2020,127,185,204,33454255,900463047,933917302,84,204,2,867008792,In > Out
Sept 2020,127,186,170,9685879,376019080,385704959,53,170,3,366333201,In > Out
Sept 2020,127,187,261,626349219,16901336942,17527686161,100,261,5,16274987723,In > Out
Sept 2020,127,188,1194,192487896,9026114826,9218602722,328,1165,10,8833626930,In > Out
Sept 2020,127,189,37,2486200,29267697,31753897,18,37,1,26781497,In > Out
Sept 2020,127,190,4741,4233807269,52861995263,57095802532,949,4164,34,48628187994,In > Out
Sept 2020,127,191,686,140896178,3618800245,3759696423,155,665,6,3477904067,In > Out
Sept 2020,127,192,155,40308736,2247840075,2288148811,56,153,6,2207531339,In > Out
Sept 2020,127,193,36,3543574,187552203,191095777,24,36,1,184008629,In > Out
Sept 2020,127,194,371,123560778,4529218841,4652779619,112,367,2,4405658063,In > Out
Sept 2020,127,195,536,1092495038,1531414944,2623909982,152,525,5,438919906,In > Out
Sept 2020,127,196,521,109180609,5336198810,5445379419,123,517,3,5227018201,In > Out
Sept 2020,127,197,1277,261552756,6970124933,7231677689,253,1245,15,6708572177,In > Out
Sept 2020,127,198,616,1519184096,4341355888,5860539984,235,609,12,2822171792,In > Out
Sept 2020,127,199,202,39427268,747208366,786635634,83,198,6,707781098,In > Out
Sept 2020,127,200,376,68555372,2919486188,2988041560,197,376,4,2850930816,In > Out
Sept 2020,127,201,867,128406271,3314106976,3442513247,221,849,4,3185700705,In > Out
Sept 2020,127,202,141,41949387,397039825,438989212,84,141,2,355090438,In > Out
Sept 2020,127,203,80,10036618,645488616,655525234,43,80,2,635451998,In > Out
Sept 2020,127,204,473,710485155,1906106953,2616592108,178,463,9,1195621798,In > Out
Sept 2020,127,205,326,2103382545,5649525482,7752908027,122,322,7,3546142937,In > Out
Sept 2020,127,206,871,257600121,3484552929,3742153050,286,857,6,3226952808,In > Out
Sept 2020,127,207,1817,1616271985,11106261947,12722533932,295,1665,12,9489989962,In > Out
Sept 2020,127,208,602,316866908,9238460138,9555327046,194,598,6,8921593230,In > Out
Sept 2020,127,209,1318,282319066,11291745480,11574064546,237,1290,2,11009426414,In > Out
Sept 2020,127,21,305,333174721,937852260,1271026981,113,305,5,604677539,In > Out
Sept 2020,127,210,266,434140816,1456399317,1890540133,124,262,5,1022258501,In > Out
Sept 2020,127,211,1523,1194950908,58636802838,59831753746,249,1467,7,57441851930,In > Out
Sept 2020,127,212,229,16537863,623803603,640341466,126,229,3,607265740,In > Out
Sept 2020,127,213,92,11485818,66991534,78477352,48,92,2,55505716,In > Out
Sept 2020,127,214,1192,174773942,12676297055,12851070997,374,1134,29,12501523113,In > Out
Sept 2020,127,215,122,15349541,223357168,238706709,60,120,6,208007627,In > Out
Sept 2020,127,216,813,342055417,4197752477,4539807894,227,806,8,3855697060,In > Out
Sept 2020,127,217,26,1621060,39558955,41180015,11,26,2,37937895,In > Out
Sept 2020,127,218,517,125866080,2407286611,2533152691,113,509,5,2281420531,In > Out
Sept 2020,127,219,91,14639791,86418266,101058057,7,91,2,71778475,In > Out
Sept 2020,127,220,785,1143961305,4299490854,5443452159,215,782,8,3155529549,In > Out
Sept 2020,127,221,178,37660375,2815507087,2853167462,69,175,2,2777846712,In > Out
Sept 2020,127,222,764,714488411,6159785369,6874273780,240,756,8,5445296958,In > Out
Sept 2020,127,223,544,183883353,4545750013,4729633366,184,536,6,4361866660,In > Out
Sept 2020,127,23,852,138931363,3754158660,3893090023,286,838,3,3615227297,In > Out
Sept 2020,127,24,520,259828231,1854449293,2114277524,166,519,5,1594621062,In > Out
Sept 2020,127,26,173,18077541,710166119,728243660,83,173,6,692088578,In > Out
Sept 2020,127,27,786,265555729,3980861133,4246416862,165,784,3,3715305404,In > Out
Sept 2020,127,28,844,1326249264,9113869971,10440119235,287,835,8,7787620707,In > Out
Sept 2020,127,29,450,173245406,781949596,955195002,108,447,6,608704190,In > Out
Sept 2020,127,31,1786,548722973,32868455839,33417178812,536,1726,3,32319732866,In > Out
Sept 2020,127,32,448,55198009,2090819517,2146017526,188,440,3,2035621508,In > Out
Sept 2020,127,35,1322,185134119,8591706144,8776840263,364,1302,6,8406572025,In > Out
Sept 2020,127,36,36,12974291,123690765,136665056,31,36,3,110716474,In > Out
Sept 2020,127,37,222,18194706,1150708178,1168902884,86,219,4,1132513472,In > Out
Sept 2020,127,39,1850,383793975,7695417648,8079211623,323,1752,9,7311623673,In > Out
Sept 2020,127,40,194,111339431,1967014483,2078353914,96,193,5,1855675052,In > Out
Sept 2020,127,41,1724,791414571,7810912250,8602326821,299,1645,5,7019497679,In > Out
Sept 2020,127,42,669,133539532,16870171721,17003711253,238,667,7,16736632189,In > Out
Sept 2020,127,44,53,4276886,434697841,438974727,13,53,1,430420955,In > Out
Sept 2020,127,45,524,329697077,4609140558,4938837635,186,516,4,4279443481,In > Out
Sept 2020,127,48,987,562170200,4974788909,5536959109,266,946,6,4412618709,In > Out
Sept 2020,127,5,307,24514392,499781724,524296116,71,305,5,475267332,In > Out
Sept 2020,127,50,139,270409881,829049466,1099459347,65,138,5,558639585,In > Out
Sept 2020,127,52,57,1634869,77127796,78762665,28,57,2,75492927,In > Out
Sept 2020,127,54,394,56797611,1423619998,1480417609,137,393,2,1366822387,In > Out
Sept 2020,127,55,625,128816419,5451782618,5580599037,158,621,5,5322966199,In > Out
Sept 2020,127,56,1648,190084658,17082250183,17272334841,166,1622,5,16892165525,In > Out
Sept 2020,127,59,246,28661887,1075375926,1104037813,90,246,3,1046714039,In > Out
Sept 2020,127,62,720,114062326,4591016705,4705079031,169,695,3,4476954379,In > Out
Sept 2020,127,63,184,22067657,523466854,545534511,59,180,3,501399197,In > Out
Sept 2020,127,64,220,49009741,802925787,851935528,86,218,5,753916046,In > Out
Sept 2020,127,65,948,1537909683,1454400231,2992309914,193,937,6,83509452,Out > In
Sept 2020,127,66,1587,475357039,5630587465,6105944504,372,1537,12,5155230426,In > Out
Sept 2020,127,67,124,433780247,1182346515,1616126762,79,124,5,748566268,In > Out
Sept 2020,127,7,247,23732204,2141688585,2165420789,66,247,2,2117956381,In > Out
Sept 2020,127,71,697,92436241,5027928133,5120364374,278,680,3,4935491892,In > Out
Sept 2020,127,73,92,17068768,369966744,387035512,56,92,3,352897976,In > Out
Sept 2020,127,74,152,84806445,2904332325,2989138770,88,151,5,2819525880,In > Out
Sept 2020,127,76,639,376658329,20951753366,21328411695,191,621,7,20575095037,In > Out
Sept 2020,127,77,1080,4636616781,21743553279,26380170060,320,1047,10,17106936498,In > Out
Sept 2020,127,8,153,18992252,871845315,890837567,81,153,4,852853063,In > Out
Sept 2020,127,80,370,63000005,2170354254,2233354259,106,368,4,2107354249,In > Out
Sept 2020,127,81,17,737438,18902322,19639760,9,17,1,18164884,In > Out
Sept 2020,127,82,905,172224024,4299814138,4472038162,198,893,8,4127590114,In > Out
Sept 2020,127,83,331,215667132,1024513147,1240180279,114,317,4,808846015,In > Out
Sept 2020,127,84,316,893954175,1630846276,2524800451,150,315,4,736892101,In > Out
Sept 2020,127,88,36,2718205,199666764,202384969,15,35,1,196948559,In > Out
Sept 2020,127,89,923,511470834,4729287216,5240758050,194,905,6,4217816382,In > Out
Sept 2020,127,90,115,51450641,281801370,333252011,41,115,2,230350729,In > Out
Sept 2020,127,92,391,45802046,925745311,971547357,108,390,5,879943265,In > Out
Sept 2020,127,93,336,63782916,843277703,907060619,114,335,4,779494787,In > Out
Sept 2020,127,94,490,1048633339,7799432055,8848065394,243,489,6,6750798716,In > Out
Sept 2020,127,95,2922,895555423,53143234452,54038789875,364,2746,4,52247679029,In > Out
Sept 2020,127,98,110,12061150,571606502,583667652,34,109,3,559545352,In > Out
Sept 2020,127,99,4251,532514325,22434976988,22967491313,880,3957,15,21902462663,In > Out
Sept 2020,128,101,1314,159847947,4817257825,4977105772,402,1279,4,4657409878,In > Out
Sept 2020,128,102,77,12890900,335369658,348260558,36,77,4,322478758,In > Out
Sept 2020,128,103,941,409044415,5545145766,5954190181,264,923,8,5136101351,In > Out
Sept 2020,128,105,553,46662244,1071674212,1118336456,127,546,5,1025011968,In > Out
Sept 2020,128,107,407,39898424,3375176155,3415074579,150,406,4,3335277731,In > Out
Sept 2020,128,110,1559,675397720,5167931257,5843328977,353,1528,9,4492533537,In > Out
Sept 2020,128,111,562,195444095,2523247337,2718691432,208,556,6,2327803242,In > Out
Sept 2020,128,112,724,230513051,2209835952,2440349003,179,698,7,1979322901,In > Out
Sept 2020,128,116,1983,1241837832,6912630167,8154467999,412,1851,11,5670792335,In > Out
Sept 2020,128,118,1560,606324701,3323124847,3929449548,306,1476,6,2716800146,In > Out
Sept 2020,128,12,591,129007890,3013668353,3142676243,157,581,9,2884660463,In > Out
Sept 2020,128,120,449,810261738,6212078307,7022340045,182,441,6,5401816569,In > Out
Sept 2020,128,121,802,64367229,2183520760,2247887989,187,773,3,2119153531,In > Out
Sept 2020,128,124,1723,630939105,11156825442,11787764547,482,1623,8,10525886337,In > Out
Sept 2020,128,125,319,804136476,3427829588,4231966064,132,318,7,2623693112,In > Out
Sept 2020,128,126,458,63162095,1131564055,1194726150,180,452,8,1068401960,In > Out
Sept 2020,128,127,7733,7213311686,74435922646,81649234332,1048,6249,7,67222610960,In > Out
Sept 2020,128,129,517,391998648,2834054531,3226053179,176,517,6,2442055883,In > Out
Sept 2020,128,13,1095,1485979214,10372076649,11858055863,284,1069,8,8886097435,In > Out
Sept 2020,128,130,157,47880755,1587319145,1635199900,88,157,4,1539438390,In > Out
Sept 2020,128,132,2304,887889656,11219546159,12107435815,622,2150,7,10331656503,In > Out
Sept 2020,128,135,2983,2285754819,22632512133,24918266952,724,2715,11,20346757314,In > Out
Sept 2020,128,138,1075,179917080,5390950771,5570867851,146,1050,3,5211033691,In > Out
Sept 2020,128,139,1957,882767079,18008695730,18891462809,558,1903,6,17125928651,In > Out
Sept 2020,128,14,709,141403321,4159058498,4300461819,252,706,6,4017655177,In > Out
Sept 2020,128,141,721,182346526,4373734135,4556080661,218,711,6,4191387609,In > Out
Sept 2020,128,142,409,125017227,3857376631,3982393858,138,407,7,3732359404,In > Out
Sept 2020,128,146,1326,11963891781,16299299995,28263191776,437,1210,16,4335408214,In > Out
Sept 2020,128,147,587,319700699,1074515714,1394216413,143,577,7,754815015,In > Out
Sept 2020,128,149,630,350787750,2238574419,2589362169,218,620,9,1887786669,In > Out
Sept 2020,128,151,828,273381257,17240428359,17513809616,257,819,10,16967047102,In > Out
Sept 2020,128,152,1142,416377298,4297917530,4714294828,245,1100,9,3881540232,In > Out
Sept 2020,128,153,601,400732091,9448127106,9848859197,178,596,7,9047395015,In > Out
Sept 2020,128,154,225,70882620,267493881,338376501,55,225,2,196611261,In > Out
Sept 2020,128,155,1127,358257261,4723411732,5081668993,235,1076,12,4365154471,In > Out
Sept 2020,128,156,2834,1876750333,20182466778,22059217111,679,2637,5,18305716445,In > Out
Sept 2020,128,157,263,84166720,5157832854,5241999574,104,262,4,5073666134,In > Out
Sept 2020,128,159,467,102451107,1164478337,1266929444,191,466,3,1062027230,In > Out
Sept 2020,128,16,44,11838694,270466028,282304722,26,44,4,258627334,In > Out
Sept 2020,128,162,752,96704825,3566116306,3662821131,281,745,8,3469411481,In > Out
Sept 2020,128,163,458,358745148,2566857067,2925602215,175,456,5,2208111919,In > Out
Sept 2020,128,165,1246,220266237,4499399888,4719666125,255,1201,9,4279133651,In > Out
Sept 2020,128,171,885,189483381,3729328259,3918811640,187,862,6,3539844878,In > Out
Sept 2020,128,177,2572,58055701937,17034426316,75090128253,335,2539,9,41021275621,Out > In
Sept 2020,128,178,292,193063661,5304578432,5497642093,106,291,5,5111514771,In > Out
Sept 2020,128,18,947,278093178,17394104709,17672197887,256,939,7,17116011531,In > Out
Sept 2020,128,181,319,50679103,1546273206,1596952309,145,319,5,1495594103,In > Out
Sept 2020,128,182,876,302469408,9825763653,10128233061,281,867,7,9523294245,In > Out
Sept 2020,128,186,2137,247467108,20784931859,21032398967,280,2019,3,20537464751,In > Out
Sept 2020,128,187,169,30853610,1648235209,1679088819,63,169,4,1617381599,In > Out
Sept 2020,128,189,33,2299128,58435989,60735117,19,33,3,56136861,In > Out
Sept 2020,128,19,1351,2097004688,9115628174,11212632862,324,1315,16,7018623486,In > Out
Sept 2020,128,191,823,154252297,7211083650,7365335947,228,816,10,7056831353,In > Out
Sept 2020,128,192,255,50608948,672074533,722683481,52,253,4,621465585,In > Out
Sept 2020,128,193,539,75544908,5408952725,5484497633,149,536,5,5333407817,In > Out
Sept 2020,128,194,695,3689532756,7863525614,11553058370,223,668,18,4173992858,In > Out
Sept 2020,128,195,638,878889224,4154444405,5033333629,210,631,6,3275555181,In > Out
Sept 2020,128,197,504,124402438,3510700383,3635102821,194,496,6,3386297945,In > Out
Sept 2020,128,198,579,140125721,7166453051,7306578772,181,570,9,7026327330,In > Out
Sept 2020,128,199,401,52720793,2521513886,2574234679,163,396,7,2468793093,In > Out
Sept 2020,128,200,200,16726879,655716168,672443047,90,199,5,638989289,In > Out
Sept 2020,128,202,1831,760849763,12105100944,12865950707,383,1802,6,11344251181,In > Out
Sept 2020,128,204,377,59127129,2176346252,2235473381,79,374,5,2117219123,In > Out
Sept 2020,128,206,229,60310846,1688945434,1749256280,86,224,4,1628634588,In > Out
Sept 2020,128,21,575,210084339,5495399940,5705484279,139,567,5,5285315601,In > Out
Sept 2020,128,210,974,291146345,11728885622,12020031967,267,968,6,11437739277,In > Out
Sept 2020,128,211,125,24459463,256719477,281178940,75,124,4,232260014,In > Out
Sept 2020,128,212,1902,795629065,5337789161,6133418226,318,1808,6,4542160096,In > Out
Sept 2020,128,214,492,93555435,1501294544,1594849979,163,490,3,1407739109,In > Out
Sept 2020,128,215,553,519848877,7260850962,7780699839,204,550,7,6741002085,In > Out
Sept 2020,128,216,431,227481964,4802533823,5030015787,150,420,6,4575051859,In > Out
Sept 2020,128,219,2485,663604650,19809590208,20473194858,335,2386,7,19145985558,In > Out
Sept 2020,128,22,1739,293865021,9765477444,10059342465,357,1624,4,9471612423,In > Out
Sept 2020,128,220,1059,878989473,7585292278,8464281751,168,1058,7,6706302805,In > Out
Sept 2020,128,223,1385,3373742019,21252370116,24626112135,431,1354,9,17878628097,In > Out
Sept 2020,128,23,217,14979589,409048985,424028574,76,215,3,394069396,In > Out
Sept 2020,128,25,335,56969717,1911327204,1968296921,100,334,3,1854357487,In > Out
Sept 2020,128,27,5773,1503328329,16887114287,18390442616,700,4753,239,15383785958,In > Out
Sept 2020,128,29,381,21687550,624450882,646138432,78,380,3,602763332,In > Out
Sept 2020,128,31,1137,478319574,2392137201,2870456775,189,1122,8,1913817627,In > Out
Sept 2020,128,36,362,27893378,1352791481,1380684859,94,362,4,1324898103,In > Out
Sept 2020,128,37,1920,480030875,11528712075,12008742950,392,1836,5,11048681200,In > Out
Sept 2020,128,38,1594,656771681,13385478606,14042250287,502,1579,34,12728706925,In > Out
Sept 2020,128,4,1087,188515856,5046423197,5234939053,285,1051,8,4857907341,In > Out
Sept 2020,128,44,1210,438749575,31674998609,32113748184,304,1133,4,31236249034,In > Out
Sept 2020,128,45,439,71254953,2246907601,2318162554,109,435,4,2175652648,In > Out
Sept 2020,128,46,233,222652543,5911822438,6134474981,110,233,3,5689169895,In > Out
Sept 2020,128,48,1923,35135829,1401722557,1436858386,62,1869,2,1366586728,In > Out
Sept 2020,128,50,249,38078057,1900157911,1938235968,88,249,5,1862079854,In > Out
Sept 2020,128,51,698,181391670,12369451807,12550843477,237,687,5,12188060137,In > Out
Sept 2020,128,54,589,2427006274,3734039741,6161046015,114,570,8,1307033467,In > Out
Sept 2020,128,57,949,3633964608,8216393293,11850357901,142,947,7,4582428685,In > Out
Sept 2020,128,60,1368,252116913,7110150734,7362267647,367,1341,8,6858033821,In > Out
Sept 2020,128,62,1027,1685133270,8657153724,10342286994,329,1002,6,6972020454,In > Out
Sept 2020,128,65,485,107091166,2045629843,2152721009,159,485,5,1938538677,In > Out
Sept 2020,128,68,422,116674922,15527940249,15644615171,155,422,2,15411265327,In > Out
Sept 2020,128,69,873,417962970,13242587500,13660550470,157,802,11,12824624530,In > Out
Sept 2020,128,70,1607,330459647,7451524699,7781984346,338,1548,6,7121065052,In > Out
Sept 2020,128,71,1182,340263638,11761711487,12101975125,263,1164,5,11421447849,In > Out
Sept 2020,128,72,635,85773710,1390938598,1476712308,130,619,9,1305164888,In > Out
Sept 2020,128,76,1230,856506459,18277078297,19133584756,296,1215,7,17420571838,In > Out
Sept 2020,128,77,1448,742992756,32079502041,32822494797,320,1434,10,31336509285,In > Out
Sept 2020,128,79,1185,678908515,9112158299,9791066814,299,1155,7,8433249784,In > Out
Sept 2020,128,8,421,697634816,3672979372,4370614188,195,416,10,2975344556,In > Out
Sept 2020,128,80,1484,513529934,14866234678,15379764612,525,1409,17,14352704744,In > Out
Sept 2020,128,84,806,760783131,19021164325,19781947456,212,799,6,18260381194,In > Out
Sept 2020,128,87,1608,3479983470,9079545424,12559528894,298,1576,12,5599561954,In > Out
Sept 2020,128,89,3068,588353959,22246637128,22834991087,387,2796,11,21658283169,In > Out
Sept 2020,128,94,397,118369388,4357746353,4476115741,192,397,4,4239376965,In > Out
Sept 2020,128,96,1319,233098949,4582666625,4815765574,283,1287,8,4349567676,In > Out
Sept 2020,128,99,593,89201244,3420792560,3509993804,208,591,3,3331591316,In > Out
Sept 2020,129,128,11,398855,23984831,24383686,5,11,1,23585976,In > Out
Sept 2020,129,129,869,977680959,7889008540,8866689499,331,855,4,6911327581,In > Out
Sept 2020,129,130,647,217214773,31857866249,32075081022,261,636,3,31640651476,In > Out
Sept 2020,129,134,303,382422408,1920016339,2302438747,137,302,6,1537593931,In > Out
Sept 2020,129,135,299,515179940,915919851,1431099791,104,295,6,400739911,In > Out
Sept 2020,129,137,548,68666809,1807149827,1875816636,126,536,3,1738483018,In > Out
Sept 2020,129,138,565,99499324,4015786969,4115286293,241,562,2,3916287645,In > Out
Sept 2020,129,140,111,56917413,133149984,190067397,33,111,3,76232571,In > Out
Sept 2020,129,141,1898,189734693,750363608,940098301,86,1786,2,560628915,In > Out
Sept 2020,129,142,232,76405568,930900041,1007305609,100,232,2,854494473,In > Out
Sept 2020,129,147,2,30030,7218299,7248329,2,2,1,7188269,In > Out
Sept 2020,129,148,41,591136,11209725,11800861,14,41,1,10618589,In > Out
Sept 2020,129,153,2709,161357524,3365690791,3527048315,478,2553,2,3204333267,In > Out
Sept 2020,129,154,48,6471701,303307318,309779019,14,48,2,296835617,In > Out
Sept 2020,129,155,7,5436155,176005,5612160,1,7,1,5260150,Out > In
Sept 2020,129,156,46,26275397,1820759401,1847034798,27,46,2,1794484004,In > Out
Sept 2020,129,161,782,174661897,3434180884,3608842781,101,771,3,3259518987,In > Out
Sept 2020,129,168,8,282230,10655454,10937684,1,8,1,10373224,In > Out
Sept 2020,129,174,600,217495966,2329124420,2546620386,162,597,8,2111628454,In > Out
Sept 2020,129,175,558,176451766,3858791123,4035242889,84,553,3,3682339357,In > Out
Sept 2020,129,186,1619,235421663,9317768263,9553189926,451,1571,4,9082346600,In > Out
Sept 2020,129,187,929,133048642,2126900496,2259949138,88,915,3,1993851854,In > Out
Sept 2020,129,189,1,507604,42564,550168,1,1,1,465040,Out > In
Sept 2020,129,196,5,186479,6942722,7129201,2,5,1,6756243,In > Out
Sept 2020,129,201,6,114912,2351058,2465970,2,6,1,2236146,In > Out
Sept 2020,129,202,1,92623,108282,200905,1,1,1,15659,In > Out
Sept 2020,129,21,143,2428569913,264269858,2692839771,1,143,1,2164300055,Out > In
Sept 2020,129,216,5,6805811,4624607,11430418,1,2,2,2181204,Out > In
Sept 2020,129,218,12,1243411,341375,1584786,7,12,2,902036,Out > In
Sept 2020,129,225,64,4612468,89141172,93753640,24,64,2,84528704,In > Out
Sept 2020,129,230,18,1177415,5101093,6278508,5,15,15,3923678,In > Out
Sept 2020,129,236,15,300845,5427283,5728128,5,15,2,5126438,In > Out
Sept 2020,129,242,14,74372,2221670,2296042,9,14,1,2147298,In > Out
Sept 2020,129,243,780,225199480,9894026850,10119226330,104,778,2,9668827370,In > Out
Sept 2020,129,249,4,143962,5389758,5533720,3,4,1,5245796,In > Out
Sept 2020,129,29,2930,368141911,9232272432,9600414343,777,2682,2,8864130521,In > Out
Sept 2020,129,30,4,159421,6047872,6207293,2,4,1,5888451,In > Out
Sept 2020,129,31,952,94064088,5580414329,5674478417,329,920,2,5486350241,In > Out
Sept 2020,129,33,1042,108707515,10801876200,10910583715,130,1024,2,10693168685,In > Out
Sept 2020,129,36,4,57061,2093878,2150939,4,4,2,2036817,In > Out
Sept 2020,129,44,515,28576216,3249929686,3278505902,49,515,2,3221353470,In > Out
Sept 2020,129,46,1002,37375161,3143153515,3180528676,62,961,2,3105778354,In > Out
Sept 2020,129,51,3,14355,1103186,1117541,3,3,1,1088831,In > Out
Sept 2020,129,61,1,78712,83179,161891,1,1,1,4467,In > Out
Sept 2020,129,80,153,101225797,523710593,624936390,71,151,8,422484796,In > Out
Sept 2020,129,97,1641,475994777,40764741907,41240736684,372,1560,6,40288747130,In > Out
Sept 2020,13,17,9,2117868,691823,2809691,5,9,1,1426045,Out > In
Sept 2020,130,101,2181,326453439,4489687728,4816141167,244,2057,2,4163234289,In > Out
Sept 2020,130,103,1577,211386630,992758196,1204144826,187,1508,2,781371566,In > Out
Sept 2020,130,107,220,39348770,532143376,571492146,83,220,3,492794606,In > Out
Sept 2020,130,114,1,19965,668601,688566,1,1,1,648636,In > Out
Sept 2020,130,116,256,80489181,3371372488,3451861669,28,256,2,3290883307,In > Out
Sept 2020,130,119,15,19410700,2467640910,2487051610,2,15,15,2448230210,In > Out
Sept 2020,130,121,459,172345094,7385798455,7558143549,28,459,2,7213453361,In > Out
Sept 2020,130,123,449,136169759,4356165653,4492335412,88,446,3,4219995894,In > Out
Sept 2020,130,135,360,430817763,8303658667,8734476430,123,359,3,7872840904,In > Out
Sept 2020,130,138,807,173147798,6599057257,6772205055,185,787,3,6425909459,In > Out
Sept 2020,130,139,665,123349832,3650029824,3773379656,37,653,2,3526679992,In > Out
Sept 2020,130,169,21,1215884,36765114,37980998,4,21,2,35549230,In > Out
Sept 2020,130,174,1708,382967352,4113977131,4496944483,173,1649,2,3731009779,In > Out
Sept 2020,130,190,31,3460075,60139446,63599521,12,31,2,56679371,In > Out
Sept 2020,130,3,61,3829053,92673865,96502918,22,61,2,88844812,In > Out
Sept 2020,130,51,128,13784845,176437244,190222089,83,128,2,162652399,In > Out
Sept 2020,130,52,444,18487263,82000996,100488259,19,438,1,63513733,In > Out
Sept 2020,130,53,1143,293744445,5164219177,5457963622,235,1111,3,4870474732,In > Out
Sept 2020,130,54,539,36303763,1985841240,2022145003,67,535,2,1949537477,In > Out
Sept 2020,130,55,1827,305802717,11056568337,11362371054,287,1736,2,10750765620,In > Out
Sept 2020,130,56,77,12899657,417238947,430138604,50,73,2,404339290,In > Out
Sept 2020,130,57,13,75199,2901848,2977047,8,13,1,2826649,In > Out
Sept 2020,130,58,2533,502736831,4418566545,4921303376,260,2338,4,3915829714,In > Out
Sept 2020,130,59,121,10585438,376863102,387448540,58,121,2,366277664,In > Out
Sept 2020,130,60,823,1115797516,2415788552,3531586068,233,807,3,1299991036,In > Out
Sept 2020,130,61,9,5149678,507034892,512184570,6,9,2,501885214,In > Out
Sept 2020,130,62,1553,242380086,4783808791,5026188877,176,1489,6,4541428705,In > Out
Sept 2020,130,63,1779,402720350,7200306047,7603026397,210,1676,4,6797585697,In > Out
Sept 2020,130,64,471,33921626,2932259016,2966180642,68,471,2,2898337390,In > Out
Sept 2020,130,66,2644,1850758366,4804347934,6655106300,162,2604,5,2953589568,In > Out
Sept 2020,130,67,298,45748425,2087785839,2133534264,52,296,2,2042037414,In > Out
Sept 2020,130,68,27,3169683,28941320,32111003,8,27,2,25771637,In > Out
Sept 2020,130,69,353,62813135,3915565444,3978378579,153,353,2,3852752309,In > Out
Sept 2020,130,71,354,82296177,3534263016,3616559193,67,353,2,3451966839,In > Out
Sept 2020,130,72,213,33670065,1625192716,1658862781,104,213,3,1591522651,In > Out
Sept 2020,130,74,2491,791387490,8599997990,9391385480,306,2356,5,7808610500,In > Out
Sept 2020,130,75,47,12710859,650935918,663646777,17,47,2,638225059,In > Out
Sept 2020,130,76,132,16500362,333711137,350211499,83,131,2,317210775,In > Out
Sept 2020,130,77,338,21314084,1093063984,1114378068,33,337,2,1071749900,In > Out
Sept 2020,130,78,1147,188769947,10931654068,11120424015,211,1123,2,10742884121,In > Out
Sept 2020,130,79,3076,1584538651,11014967681,12599506332,519,2849,9,9430429030,In > Out
Sept 2020,130,82,259,16325279,890016877,906342156,26,259,2,873691598,In > Out
Sept 2020,130,86,3032,342565137,1811548432,2154113569,290,2773,4,1468983295,In > Out
Sept 2020,130,90,60,5030949,84175355,89206304,24,60,2,79144406,In > Out
Sept 2020,130,93,40,1795936,102294670,104090606,25,40,2,100498734,In > Out
Sept 2020,130,96,153,357810859,3272306075,3630116934,66,152,2,2914495216,In > Out
Sept 2020,131,100,2246,544287424,24151649139,24695936563,306,2097,8,23607361715,In > Out
Sept 2020,131,102,2991,894311942,42894520170,43788832112,369,2735,4,42000208228,In > Out
Sept 2020,131,104,287,146042649,11833462080,11979504729,112,287,3,11687419431,In > Out
Sept 2020,131,105,3347,3340961358,24734446250,28075407608,629,3133,15,21393484892,In > Out
Sept 2020,131,108,3056,2212058030,23678675419,25890733449,790,2825,18,21466617389,In > Out
Sept 2020,131,110,998,710226558,16372745981,17082972539,288,960,10,15662519423,In > Out
Sept 2020,131,111,638,96780260,2445669643,2542449903,240,631,4,2348889383,In > Out
Sept 2020,131,112,415,52259970,2063178665,2115438635,149,413,4,2010918695,In > Out
Sept 2020,131,113,802,77191681,4561873946,4639065627,286,790,3,4484682265,In > Out
Sept 2020,131,114,793,1203278932,1748688088,2951967020,175,788,8,545409156,In > Out
Sept 2020,131,115,405,102624175,6147549564,6250173739,94,404,2,6044925389,In > Out
Sept 2020,131,118,424,59098787,2125808145,2184906932,139,418,4,2066709358,In > Out
Sept 2020,131,12,379,982448997,439733199,1422182196,116,378,5,542715798,Out > In
Sept 2020,131,122,2615,176792463,4437454500,4614246963,264,2470,8,4260662037,In > Out
Sept 2020,131,123,1111,201354597,6285391352,6486745949,226,1096,8,6084036755,In > Out
Sept 2020,131,124,744,4252728077,9310341515,13563069592,242,716,12,5057613438,In > Out
Sept 2020,131,125,959,251818487,3200535837,3452354324,542,554,231,2948717350,In > Out
Sept 2020,131,127,464,61692324,2022083990,2083776314,178,464,2,1960391666,In > Out
Sept 2020,131,128,514,282268453,6705248960,6987517413,169,504,4,6422980507,In > Out
Sept 2020,131,129,203,101410960,1656479977,1757890937,89,203,5,1555069017,In > Out
Sept 2020,131,130,695,415974735,3748304464,4164279199,262,692,6,3332329729,In > Out
Sept 2020,131,131,156,58728044,3635203821,3693931865,67,155,3,3576475777,In > Out
Sept 2020,131,132,632,1001600740,84252392533,85253993273,57,632,2,83250791793,In > Out
Sept 2020,131,133,231,129064494,1688545097,1817609591,112,231,17,1559480603,In > Out
Sept 2020,131,134,592,82988691,3128304907,3211293598,138,580,6,3045316216,In > Out
Sept 2020,131,136,471,649780625,1955938898,2605719523,162,468,4,1306158273,In > Out
Sept 2020,131,137,282,326675062,5540049345,5866724407,93,280,3,5213374283,In > Out
Sept 2020,131,138,263,62827975,824502096,887330071,102,209,18,761674121,In > Out
Sept 2020,131,139,598,240407986,4188266339,4428674325,200,588,6,3947858353,In > Out
Sept 2020,131,14,41,4927893,35516291,40444184,29,41,3,30588398,In > Out
Sept 2020,131,140,409,194770433,3027817961,3222588394,171,403,4,2833047528,In > Out
Sept 2020,131,141,597,982489552,2164665248,3147154800,129,587,3,1182175696,In > Out
Sept 2020,131,142,434,59740689,2074585186,2134325875,168,433,4,2014844497,In > Out
Sept 2020,131,143,253,76090124,3920116828,3996206952,104,252,3,3844026704,In > Out
Sept 2020,131,145,1406,168835605,5321511678,5490347283,141,1347,3,5152676073,In > Out
Sept 2020,131,147,413,93382177,3192620783,3286002960,145,412,4,3099238606,In > Out
Sept 2020,131,150,645,12530480796,2131975600,14662456396,226,634,5,10398505196,Out > In
Sept 2020,131,151,119,21129657,551679849,572809506,50,118,3,530550192,In > Out
Sept 2020,131,152,1032,189045132,8148100916,8337146048,189,1008,5,7959055784,In > Out
Sept 2020,131,154,444,66556390,2379880628,2446437018,153,420,4,2313324238,In > Out
Sept 2020,131,155,686,263742933,4628127434,4891870367,298,677,15,4364384501,In > Out
Sept 2020,131,156,260,187539721,1872267566,2059807287,86,257,4,1684727845,In > Out
Sept 2020,131,159,856,200954151,2553746369,2754700520,154,848,7,2352792218,In > Out
Sept 2020,131,162,417,44655297,2142123008,2186778305,124,410,4,2097467711,In > Out
Sept 2020,131,163,467,66024172,1506804219,1572828391,173,460,5,1440780047,In > Out
Sept 2020,131,167,575,170118694,2705950089,2876068783,239,569,5,2535831395,In > Out
Sept 2020,131,171,254,115004921,1629077502,1744082423,146,254,6,1514072581,In > Out
Sept 2020,131,172,874,168765133,3306555749,3475320882,273,845,6,3137790616,In > Out
Sept 2020,131,175,1318,1044281378,5422269996,6466551374,442,1276,5,4377988618,In > Out
Sept 2020,131,176,1800,614346354,3069028257,3683374611,51,1800,5,2454681903,In > Out
Sept 2020,131,177,186,13834390,787013764,800848154,82,186,3,773179374,In > Out
Sept 2020,131,178,121,5418088,86237815,91655903,50,121,2,80819727,In > Out
Sept 2020,131,179,870,218814723,2759225991,2978040714,198,809,7,2540411268,In > Out
Sept 2020,131,18,3376,278163628,8537429885,8815593513,542,3006,51,8259266257,In > Out
Sept 2020,131,180,240,32259380,1362809874,1395069254,78,240,2,1330550494,In > Out
Sept 2020,131,181,174,85168424,4334974427,4420142851,60,174,1,4249806003,In > Out
Sept 2020,131,183,125,8710154,565658754,574368908,60,124,4,556948600,In > Out
Sept 2020,131,184,292,1166334764,1761758796,2928093560,138,291,4,595424032,In > Out
Sept 2020,131,185,517,370963451,1729184009,2100147460,191,513,10,1358220558,In > Out
Sept 2020,131,186,660,418016229,2997790361,3415806590,228,652,3,2579774132,In > Out
Sept 2020,131,188,1216,140628545,4648848293,4789476838,279,1195,5,4508219748,In > Out
Sept 2020,131,189,85,144891093,960844531,1105735624,42,85,5,815953438,In > Out
Sept 2020,131,192,427,170522737,4478466928,4648989665,123,424,4,4307944191,In > Out
Sept 2020,131,193,123,10115254,102719352,112834606,47,123,2,92604098,In > Out
Sept 2020,131,194,810,289830072,5351653946,5641484018,282,808,5,5061823874,In > Out
Sept 2020,131,196,2392,236201273,9725996877,9962198150,488,2260,27,9489795604,In > Out
Sept 2020,131,197,2129,1770232789,5710852566,7481085355,393,2068,7,3940619777,In > Out
Sept 2020,131,198,933,481881010,6959207135,7441088145,299,924,7,6477326125,In > Out
Sept 2020,131,199,106,54085499,3454614405,3508699904,35,106,3,3400528906,In > Out
Sept 2020,131,20,718,96764776,3856575894,3953340670,186,715,6,3759811118,In > Out
Sept 2020,131,200,209,122315110,1694582369,1816897479,103,209,5,1572267259,In > Out
Sept 2020,131,201,104,12797490,976753210,989550700,48,104,3,963955720,In > Out
Sept 2020,131,203,97,17610406,1808048230,1825658636,45,94,2,1790437824,In > Out
Sept 2020,131,204,64,6104805,84296289,90401094,33,64,2,78191484,In > Out
Sept 2020,131,205,355,230332580,547503380,777835960,100,352,8,317170800,In > Out
Sept 2020,131,206,168,27625612,2016083171,2043708783,88,168,2,1988457559,In > Out
Sept 2020,131,207,927,663453052,1751746100,2415199152,294,900,6,1088293048,In > Out
Sept 2020,131,208,296,159728142,2659943180,2819671322,135,296,7,2500215038,In > Out
Sept 2020,131,21,2307,959856959,58947774680,59907631639,476,2229,6,57987917721,In > Out
Sept 2020,131,210,84,190536578,1282076985,1472613563,45,84,3,1091540407,In > Out
Sept 2020,131,211,639,222204929,2055220805,2277425734,153,634,5,1833015876,In > Out
Sept 2020,131,212,133,13532673,729365251,742897924,57,133,3,715832578,In > Out
Sept 2020,131,214,1336,1448629068,18622473606,20071102674,429,1277,12,17173844538,In > Out
Sept 2020,131,217,201,40060692,867453340,907514032,57,201,4,827392648,In > Out
Sept 2020,131,218,1265,371118405,14939627746,15310746151,361,1233,6,14568509341,In > Out
Sept 2020,131,219,1318,263108775,11468436797,11731545572,280,1291,8,11205328022,In > Out
Sept 2020,131,220,1313,722643845,16697394795,17420038640,349,1309,4,15974750950,In > Out
Sept 2020,131,222,822,533305165,39750345262,40283650427,253,816,6,39217040097,In > Out
Sept 2020,131,23,282,80678884,280428779,361107663,108,277,3,199749895,In > Out
Sept 2020,131,24,1023,153703029,5133418482,5287121511,294,996,7,4979715453,In > Out
Sept 2020,131,27,198,21572024,488912482,510484506,116,197,5,467340458,In > Out
Sept 2020,131,28,632,166616345,3606334900,3772951245,181,625,6,3439718555,In > Out
Sept 2020,131,29,690,459816457,3271013256,3730829713,183,476,19,2811196799,In > Out
Sept 2020,131,30,1965,2527493141,274732204509,277259697650,197,1878,3,272204711368,In > Out
Sept 2020,131,32,10,614442,10017312,10631754,7,10,1,9402870,In > Out
Sept 2020,131,33,1467,1506454382,12070731009,13577185391,273,1408,11,10564276627,In > Out
Sept 2020,131,34,938,325784776,4453525051,4779309827,342,922,7,4127740275,In > Out
Sept 2020,131,35,935,1971644835,5770948346,7742593181,221,907,17,3799303511,In > Out
Sept 2020,131,36,920,378517169,30672979786,31051496955,188,906,6,30294462617,In > Out
Sept 2020,131,37,842,284106732,12601341948,12885448680,196,828,3,12317235216,In > Out
Sept 2020,131,39,467,109010163,1524375312,1633385475,164,462,4,1415365149,In > Out
Sept 2020,131,40,348,75031775,2477922093,2552953868,94,344,4,2402890318,In > Out
Sept 2020,131,41,1759,236945132,6440957687,6677902819,196,1644,6,6204012555,In > Out
Sept 2020,131,42,191,896531340,2657412131,3553943471,98,191,6,1760880791,In > Out
Sept 2020,131,45,405,383203604,1877139115,2260342719,118,404,4,1493935511,In > Out
Sept 2020,131,46,1570,214740767,8589346963,8804087730,393,1493,4,8374606196,In > Out
Sept 2020,131,48,805,343403363,4832095925,5175499288,204,785,10,4488692562,In > Out
Sept 2020,131,49,2211,1273224453,22556638748,23829863201,428,1948,38,21283414295,In > Out
Sept 2020,131,52,61,4855256,18788852,23644108,29,61,2,13933596,In > Out
Sept 2020,131,53,2686,6115338964,3692830492,9808169456,345,2466,6,2422508472,Out > In
Sept 2020,131,54,719,2068743708,3941634975,6010378683,161,701,8,1872891267,In > Out
Sept 2020,131,55,1589,1408285804,8855625559,10263911363,373,1525,10,7447339755,In > Out
Sept 2020,131,56,120,43751418,323848639,367600057,57,120,2,280097221,In > Out
Sept 2020,131,57,284,86804280,2033426780,2120231060,97,282,4,1946622500,In > Out
Sept 2020,131,59,184,117485298,6845752818,6963238116,68,183,2,6728267520,In > Out
Sept 2020,131,61,639,86304283,906737731,993042014,228,620,5,820433448,In > Out
Sept 2020,131,62,299,70569536,4590929541,4661499077,107,299,1,4520360005,In > Out
Sept 2020,131,64,543,86299719,8068276743,8154576462,284,534,9,7981977024,In > Out
Sept 2020,131,66,577,68698886,1069478655,1138177541,187,563,3,1000779769,In > Out
Sept 2020,131,67,857,2610668463,21592454273,24203122736,295,838,15,18981785810,In > Out
Sept 2020,131,72,776,446465052,12268201860,12714666912,264,766,8,11821736808,In > Out
Sept 2020,131,73,4111,2554199590,50997855763,53552055353,947,3780,14,48443656173,In > Out
Sept 2020,131,74,753,2709173805,5242176328,7951350133,223,749,9,2533002523,In > Out
Sept 2020,131,75,968,157712933,8472994346,8630707279,247,926,4,8315281413,In > Out
Sept 2020,131,76,355,82863591,1259638781,1342502372,100,347,3,1176775190,In > Out
Sept 2020,131,77,597,112419909,5690398398,5802818307,182,578,3,5577978489,In > Out
Sept 2020,131,78,114,10391390,339956379,350347769,43,114,2,329564989,In > Out
Sept 2020,131,79,738,226773417,13812937678,14039711095,211,718,4,13586164261,In > Out
Sept 2020,131,8,143,89246668,332688616,421935284,59,143,1,243441948,In > Out
Sept 2020,131,83,421,78273159,4114245418,4192518577,174,411,6,4035972259,In > Out
Sept 2020,131,85,748,1592269735,7664666624,9256936359,238,734,11,6072396889,In > Out
Sept 2020,131,86,193,56910223,2332686399,2389596622,95,193,5,2275776176,In > Out
Sept 2020,131,87,821,1211602979,3915959161,5127562140,237,802,8,2704356182,In > Out
Sept 2020,131,90,536,212826654,20341180024,20554006678,190,535,3,20128353370,In > Out
Sept 2020,131,91,156,19241964,689351468,708593432,61,156,2,670109504,In > Out
Sept 2020,131,92,174,15111412,383625949,398737361,54,174,3,368514537,In > Out
Sept 2020,131,94,75,23203898,2249035604,2272239502,31,75,1,2225831706,In > Out
Sept 2020,131,97,1774,533030741,5648429222,6181459963,387,1747,6,5115398481,In > Out
Sept 2020,131,98,522,988561230,40934848707,41923409937,160,518,4,39946287477,In > Out
Sept 2020,132,10,92,30869630,1713079598,1743949228,50,92,4,1682209968,In > Out
Sept 2020,132,100,601,91145809,3940670097,4031815906,155,599,3,3849524288,In > Out
Sept 2020,132,101,796,425753156,4151300601,4577053757,189,790,4,3725547445,In > Out
Sept 2020,132,102,220,19659337,487754234,507413571,80,220,4,468094897,In > Out
Sept 2020,132,105,3936,1556467841,81549630217,83106098058,809,3566,33,79993162376,In > Out
Sept 2020,132,106,424,33039652,1083843769,1116883421,119,421,3,1050804117,In > Out
Sept 2020,132,108,221,77575251,1166040311,1243615562,85,221,5,1088465060,In > Out
Sept 2020,132,11,467,3176499719,1148015898,4324515617,169,467,4,2028483821,Out > In
Sept 2020,132,110,177,18443151,1021262313,1039705464,46,177,2,1002819162,In > Out
Sept 2020,132,113,732,147248430,2424988133,2572236563,253,729,8,2277739703,In > Out
Sept 2020,132,115,614,303983150,2014915969,2318899119,140,610,5,1710932819,In > Out
Sept 2020,132,116,377,49940208,1276751532,1326691740,150,371,4,1226811324,In > Out
Sept 2020,132,117,2407,320657114,14136796705,14457453819,479,2322,8,13816139591,In > Out
Sept 2020,132,118,1398,266480497,10138811999,10405292496,367,1316,16,9872331502,In > Out
Sept 2020,132,119,495,86796795,821863330,908660125,187,489,6,735066535,In > Out
Sept 2020,132,12,183,103764361,4429650252,4533414613,98,183,3,4325885891,In > Out
Sept 2020,132,120,205,282646306,1421726030,1704372336,82,204,2,1139079724,In > Out
Sept 2020,132,121,448,72470521,1455495017,1527965538,159,447,4,1383024496,In > Out
Sept 2020,132,122,1221,924424637,3094228880,4018653517,252,1200,4,2169804243,In > Out
Sept 2020,132,123,277,1729411639,2366700192,4096111831,80,276,4,637288553,In > Out
Sept 2020,132,124,288,51326565,573727983,625054548,100,288,6,522401418,In > Out
Sept 2020,132,127,17,41940123,52762959,94703082,11,17,4,10822836,In > Out
Sept 2020,132,128,94,10971199,276504033,287475232,32,94,5,265532834,In > Out
Sept 2020,132,129,206,392862977,596259537,989122514,84,205,4,203396560,In > Out
Sept 2020,132,132,1562,6653982208,13556657534,20210639742,404,1528,8,6902675326,In > Out
Sept 2020,132,134,629,108089560,4199502669,4307592229,134,622,5,4091413109,In > Out
Sept 2020,132,135,369,633848196,2318900735,2952748931,129,367,7,1685052539,In > Out
Sept 2020,132,137,615,569043935,3222585633,3791629568,205,585,13,2653541698,In > Out
Sept 2020,132,139,2396,923852796,16760011183,17683863979,577,2303,37,15836158387,In > Out
Sept 2020,132,14,2115,644271890,29119607277,29763879167,452,2026,7,28475335387,In > Out
Sept 2020,132,140,147,72897387,1664447337,1737344724,81,147,2,1591549950,In > Out
Sept 2020,132,141,25,12527679,96923445,109451124,21,25,1,84395766,In > Out
Sept 2020,132,143,1062,79083273,2951802721,3030885994,441,1042,4,2872719448,In > Out
Sept 2020,132,145,731,176177060,3523047350,3699224410,191,729,5,3346870290,In > Out
Sept 2020,132,147,19,1664604,85702189,87366793,8,19,1,84037585,In > Out
Sept 2020,132,148,63,5450912,238852445,244303357,40,63,4,233401533,In > Out
Sept 2020,132,150,298,64243474,1506584260,1570827734,121,298,6,1442340786,In > Out
Sept 2020,132,151,176,718349199,10047246975,10765596174,91,176,4,9328897776,In > Out
Sept 2020,132,152,1288,343389043,16168818092,16512207135,287,1273,9,15825429049,In > Out
Sept 2020,132,153,112,43809702,69821935,113631637,64,111,3,26012233,In > Out
Sept 2020,132,154,131,313378101,4964600090,5277978191,104,131,3,4651221989,In > Out
Sept 2020,132,155,220,2443266567,5563218439,8006485006,134,220,7,3119951872,In > Out
Sept 2020,132,157,10,1717625,160954656,162672281,4,10,1,159237031,In > Out
Sept 2020,132,158,391,3594550962,7528301238,11122852200,133,390,6,3933750276,In > Out
Sept 2020,132,162,10,136400,3558064,3694464,6,10,1,3421664,In > Out
Sept 2020,132,164,273,75311602,3364046505,3439358107,120,273,3,3288734903,In > Out
Sept 2020,132,165,191,24889799,397531536,422421335,87,191,4,372641737,In > Out
Sept 2020,132,166,605,132531289,5873748527,6006279816,186,599,5,5741217238,In > Out
Sept 2020,132,168,312,79459526,2793128726,2872588252,147,311,5,2713669200,In > Out
Sept 2020,132,169,2283,964646180,27809275088,28773921268,509,2192,5,26844628908,In > Out
Sept 2020,132,17,403,47113418,1767916919,1815030337,132,399,3,1720803501,In > Out
Sept 2020,132,170,94,8099390,436674408,444773798,32,94,2,428575018,In > Out
Sept 2020,132,171,722,1326326863,10652044618,11978371481,210,707,12,9325717755,In > Out
Sept 2020,132,172,174,42551887,775856961,818408848,84,174,4,733305074,In > Out
Sept 2020,132,173,235,447970550,3564450862,4012421412,118,233,6,3116480312,In > Out
Sept 2020,132,174,701,1826161954,29541745016,31367906970,248,677,7,27715583062,In > Out
Sept 2020,132,175,994,1789201443,6731493768,8520695211,308,987,5,4942292325,In > Out
Sept 2020,132,176,4,455873,24897462,25353335,3,4,1,24441589,In > Out
Sept 2020,132,178,1309,561791168,12340825913,12902617081,281,1276,7,11779034745,In > Out
Sept 2020,132,179,174,13759717,647968139,661727856,66,174,3,634208422,In > Out
Sept 2020,132,18,23,127677517,1294508572,1422186089,11,23,1,1166831055,In > Out
Sept 2020,132,181,65,8073339,99651105,107724444,20,64,2,91577766,In > Out
Sept 2020,132,182,1559,187886890,6769342950,6957229840,202,1526,4,6581456060,In > Out
Sept 2020,132,183,85,204860680,997767515,1202628195,40,85,4,792906835,In > Out
Sept 2020,132,184,785,74920382,3044755159,3119675541,103,773,2,2969834777,In > Out
Sept 2020,132,185,349,162760744,15088830723,15251591467,120,342,3,14926069979,In > Out
Sept 2020,132,186,394,64008337,6138791618,6202799955,152,393,5,6074783281,In > Out
Sept 2020,132,187,1212,989700454,11223447586,12213148040,240,1173,4,10233747132,In > Out
Sept 2020,132,19,488,283623373,3634237029,3917860402,231,488,4,3350613656,In > Out
Sept 2020,132,190,1679,677901203,20234510141,20912411344,317,1655,10,19556608938,In > Out
Sept 2020,132,191,1391,168944415,4878450444,5047394859,358,1356,7,4709506029,In > Out
Sept 2020,132,193,184,55220158,1008307706,1063527864,107,183,15,953087548,In > Out
Sept 2020,132,194,3040,2526052145,59612692313,62138744458,382,2907,5,57086640168,In > Out
Sept 2020,132,196,278,47310154,2349459731,2396769885,61,278,4,2302149577,In > Out
Sept 2020,132,197,308,111802693,12745181495,12856984188,121,307,5,12633378802,In > Out
Sept 2020,132,20,772,468940719,9032116667,9501057386,351,769,7,8563175948,In > Out
Sept 2020,132,200,13,244436,3993792,4238228,10,13,1,3749356,In > Out
Sept 2020,132,201,1186,192376144,6786260273,6978636417,250,1133,4,6593884129,In > Out
Sept 2020,132,202,161,24722988,1786953235,1811676223,100,161,2,1762230247,In > Out
Sept 2020,132,203,1315,953399316,15069938893,16023338209,323,1285,11,14116539577,In > Out
Sept 2020,132,204,2487,787197071,20396882702,21184079773,620,2343,6,19609685631,In > Out
Sept 2020,132,205,415,108538781,9045002310,9153541091,75,412,3,8936463529,In > Out
Sept 2020,132,206,846,619153182,9847275504,10466428686,303,837,9,9228122322,In > Out
Sept 2020,132,214,665,115869322,6928899325,7044768647,154,641,3,6813030003,In > Out
Sept 2020,132,215,781,210673865,6493766781,6704440646,269,773,4,6283092916,In > Out
Sept 2020,132,216,35,4126642,146809030,150935672,20,35,4,142682388,In > Out
Sept 2020,132,219,683,1580780277,5193477875,6774258152,262,682,4,3612697598,In > Out
Sept 2020,132,22,259,30029545,549463796,579493341,82,255,2,519434251,In > Out
Sept 2020,132,220,119,283355710,287140950,570496660,64,119,2,3785240,In > Out
Sept 2020,132,221,1519,387730226,7654724374,8042454600,279,1472,9,7266994148,In > Out
Sept 2020,132,222,211,234638993,823174542,1057813535,72,211,3,588535549,In > Out
Sept 2020,132,223,487,344916243,17498700033,17843616276,214,475,3,17153783790,In > Out
Sept 2020,132,23,1555,2237428215,10781302602,13018730817,384,1506,10,8543874387,In > Out
Sept 2020,132,25,904,151705889,9139008023,9290713912,214,897,6,8987302134,In > Out
Sept 2020,132,26,304,1483508867,468936150,1952445017,61,303,4,1014572717,Out > In
Sept 2020,132,27,413,104043406,8149485731,8253529137,142,413,5,8045442325,In > Out
Sept 2020,132,28,241,25788811,833940255,859729066,81,241,2,808151444,In > Out
Sept 2020,132,29,1704,218868674,12391657711,12610526385,320,1654,7,12172789037,In > Out
Sept 2020,132,30,92,24612084,1540271676,1564883760,49,92,3,1515659592,In > Out
Sept 2020,132,31,421,54152423,1592793030,1646945453,157,420,8,1538640607,In > Out
Sept 2020,132,32,41,6647772,457861441,464509213,21,41,2,451213669,In > Out
Sept 2020,132,33,217,91211423,9431894995,9523106418,64,217,3,9340683572,In > Out
Sept 2020,132,34,1042,1528849793,5803244171,7332093964,400,1019,28,4274394378,In > Out
Sept 2020,132,35,919,124723676,2540240839,2664964515,152,918,17,2415517163,In > Out
Sept 2020,132,36,371,57908021,4585597847,4643505868,158,366,4,4527689826,In > Out
Sept 2020,132,4,553,62922579,2178543781,2241466360,156,552,6,2115621202,In > Out
Sept 2020,132,40,226,40709772,363834938,404544710,79,225,8,323125166,In > Out
Sept 2020,132,41,289,40935142,1491993646,1532928788,93,288,4,1451058504,In > Out
Sept 2020,132,42,228,25839294,1192701145,1218540439,92,227,4,1166861851,In > Out
Sept 2020,132,43,233,95106797,2708565479,2803672276,86,233,3,2613458682,In > Out
Sept 2020,132,44,141,12441639,308359086,320800725,79,140,4,295917447,In > Out
Sept 2020,132,46,201,263168056,626257930,889425986,102,201,7,363089874,In > Out
Sept 2020,132,48,2116,2356673424,12841967252,15198640676,502,1979,7,10485293828,In > Out
Sept 2020,132,49,322,30086420,1362764783,1392851203,123,318,4,1332678363,In > Out
Sept 2020,132,5,595,188410395,1529268927,1717679322,155,590,7,1340858532,In > Out
Sept 2020,132,50,878,1316826561,1904286805,3221113366,187,849,10,587460244,In > Out
Sept 2020,132,51,585,114490933,6124630831,6239121764,138,585,4,6010139898,In > Out
Sept 2020,132,54,166,17476003,1134488027,1151964030,48,164,3,1117012024,In > Out
Sept 2020,132,55,1,12374,262300,274674,1,1,1,249926,In > Out
Sept 2020,132,56,197,40196631,1489069334,1529265965,122,197,2,1448872703,In > Out
Sept 2020,132,57,641,144571052,2235721848,2380292900,236,629,5,2091150796,In > Out
Sept 2020,132,58,413,82359526,1749215122,1831574648,122,409,4,1666855596,In > Out
Sept 2020,132,59,806,119488698,4325325217,4444813915,270,797,4,4205836519,In > Out
Sept 2020,132,6,108,7141787,144898866,152040653,78,108,3,137757079,In > Out
Sept 2020,132,60,150,19404495,1201867287,1221271782,56,150,4,1182462792,In > Out
Sept 2020,132,61,493,94348946,5156410574,5250759520,141,489,5,5062061628,In > Out
Sept 2020,132,62,800,148168115,3105526697,3253694812,198,794,4,2957358582,In > Out
Sept 2020,132,63,1284,328738782,12708505142,13037243924,374,1252,9,12379766360,In > Out
Sept 2020,132,65,1990,1013634464,5186252555,6199887019,396,1908,8,4172618091,In > Out
Sept 2020,132,66,1201,366304090,3435234032,3801538122,371,1193,5,3068929942,In > Out
Sept 2020,132,67,832,814055815,2965766244,3779822059,199,818,6,2151710429,In > Out
Sept 2020,132,68,811,65994316,2537849712,2603844028,154,810,4,2471855396,In > Out
Sept 2020,132,7,61,2857966,101439581,104297547,30,61,2,98581615,In > Out
Sept 2020,132,70,1733,4116230041,19499558709,23615788750,381,1684,9,15383328668,In > Out
Sept 2020,132,71,897,568961791,44020096837,44589058628,282,893,7,43451135046,In > Out
Sept 2020,132,72,551,169497353,1899897327,2069394680,237,527,6,1730399974,In > Out
Sept 2020,132,73,62,5089275,169035449,174124724,31,62,1,163946174,In > Out
Sept 2020,132,74,144,16579846,1201572224,1218152070,68,143,3,1184992378,In > Out
Sept 2020,132,75,548,63727323,2204480937,2268208260,153,537,5,2140753614,In > Out
Sept 2020,132,76,165,45739618,3721786683,3767526301,48,164,4,3676047065,In > Out
Sept 2020,132,77,611,271801102,4036033671,4307834773,179,607,7,3764232569,In > Out
Sept 2020,132,78,165,28638264,689852677,718490941,88,164,3,661214413,In > Out
Sept 2020,132,79,734,181821366,10710682326,10892503692,196,724,4,10528860960,In > Out
Sept 2020,132,80,1055,121449216,2155990094,2277439310,202,1055,7,2034540878,In > Out
Sept 2020,132,82,644,835387329,4056843519,4892230848,222,640,11,3221456190,In > Out
Sept 2020,132,83,621,178030987,2059365340,2237396327,114,617,2,1881334353,In > Out
Sept 2020,132,85,94,17495009,92133367,109628376,62,93,7,74638358,In > Out
Sept 2020,132,86,950,75206982,5110107842,5185314824,163,941,4,5034900860,In > Out
Sept 2020,132,87,83,15955255,333869970,349825225,22,83,1,317914715,In > Out
Sept 2020,132,88,808,1012431776,6232529360,7244961136,227,789,5,5220097584,In > Out
Sept 2020,132,89,158,38523136,1609318609,1647841745,94,158,4,1570795473,In > Out
Sept 2020,132,9,662,3463338070,5937001884,9400339954,165,639,12,2473663814,In > Out
Sept 2020,132,93,568,131552401,1896479634,2028032035,163,561,8,1764927233,In > Out
Sept 2020,132,95,1790,2110953982,180586593692,182697547674,231,1778,3,178475639710,In > Out
Sept 2020,132,96,856,97766205,3871546560,3969312765,173,823,3,3773780355,In > Out
Sept 2020,132,97,210,160085659,5381378117,5541463776,104,210,3,5221292458,In > Out
Sept 2020,132,98,61,75899257,286167884,362067141,38,61,3,210268627,In > Out
Sept 2020,132,99,24,6553335,665351835,671905170,22,24,2,658798500,In > Out
Sept 2020,133,100,2744,1359613799,27676994564,29036608363,459,2601,15,26317380765,In > Out
Sept 2020,133,103,262,82288180,1224083985,1306372165,86,262,3,1141795805,In > Out
Sept 2020,133,104,182,20359496,640916304,661275800,103,181,3,620556808,In > Out
Sept 2020,133,106,604,231990577,14683362195,14915352772,270,586,5,14451371618,In > Out
Sept 2020,133,107,934,137808387,3624756135,3762564522,216,907,5,3486947748,In > Out
Sept 2020,133,11,1087,285860787,17010933154,17296793941,190,1068,6,16725072367,In > Out
Sept 2020,133,112,27,3089291,18132019,21221310,16,27,3,15042728,In > Out
Sept 2020,133,113,475,222813990,1670406553,1893220543,145,469,4,1447592563,In > Out
Sept 2020,133,114,246,39557536,2431053273,2470610809,126,246,5,2391495737,In > Out
Sept 2020,133,116,858,105666341,3260396474,3366062815,274,833,7,3154730133,In > Out
Sept 2020,133,118,1423,360511212,14331496474,14692007686,289,1385,3,13970985262,In > Out
Sept 2020,133,119,342,100660969,1729997947,1830658916,123,332,12,1629336978,In > Out
Sept 2020,133,120,236,293462438,2308481809,2601944247,101,236,5,2015019371,In > Out
Sept 2020,133,121,840,343581423,17173640176,17517221599,279,837,21,16830058753,In > Out
Sept 2020,133,123,466,224730629,5558216134,5782946763,117,462,7,5333485505,In > Out
Sept 2020,133,125,1910,2266163778,5694561636,7960725414,372,1851,11,3428397858,In > Out
Sept 2020,133,126,486,65906323,2544780107,2610686430,207,482,7,2478873784,In > Out
Sept 2020,133,127,520,108675004,1621583461,1730258465,154,512,5,1512908457,In > Out
Sept 2020,133,128,756,669148974,12590903089,13260052063,273,738,6,11921754115,In > Out
Sept 2020,133,129,2250,2665458512,26205575951,28871034463,536,2122,8,23540117439,In > Out
Sept 2020,133,130,235,34730276,1027716147,1062446423,116,232,5,992985871,In > Out
Sept 2020,133,131,1779,1100474099,38329566241,39430040340,444,1745,4,37229092142,In > Out
Sept 2020,133,132,1404,294671231,16995270824,17289942055,300,1342,12,16700599593,In > Out
Sept 2020,133,135,906,192538290,3624042721,3816581011,180,883,5,3431504431,In > Out
Sept 2020,133,136,643,77723800,2589233927,2666957727,93,642,2,2511510127,In > Out
Sept 2020,133,137,261,53257704,3362154040,3415411744,90,254,3,3308896336,In > Out
Sept 2020,133,138,836,4104943522,3301292855,7406236377,148,833,4,803650667,Out > In
Sept 2020,133,139,806,211253285,10329684970,10540938255,262,801,5,10118431685,In > Out
Sept 2020,133,14,910,473088946,6503170940,6976259886,290,888,6,6030081994,In > Out
Sept 2020,133,140,328,1698513934,1052713902,2751227836,153,325,6,645800032,Out > In
Sept 2020,133,142,2550,460952923,9907991368,10368944291,481,2389,76,9447038445,In > Out
Sept 2020,133,147,1090,134611998,4452861678,4587473676,292,1077,8,4318249680,In > Out
Sept 2020,133,149,2750,332106074,5461842748,5793948822,396,2513,52,5129736674,In > Out
Sept 2020,133,15,2003,504621986,17389104471,17893726457,392,1936,8,16884482485,In > Out
Sept 2020,133,150,1100,2167109142,7554804054,9721913196,295,1078,11,5387694912,In > Out
Sept 2020,133,152,430,67003620,4070113262,4137116882,133,421,4,4003109642,In > Out
Sept 2020,133,153,381,459596173,5236281048,5695877221,134,379,3,4776684875,In > Out
Sept 2020,133,155,715,93018214,5017780203,5110798417,201,694,9,4924761989,In > Out
Sept 2020,133,156,2621,600311892,20585337981,21185649873,433,2535,11,19985026089,In > Out
Sept 2020,133,157,1863,875087867,18468633664,19343721531,366,1829,10,17593545797,In > Out
Sept 2020,133,159,631,360247162,1798120149,2158367311,152,606,17,1437872987,In > Out
Sept 2020,133,16,555,79038236,5894597376,5973635612,137,555,2,5815559140,In > Out
Sept 2020,133,160,61,27734270,419448157,447182427,27,61,6,391713887,In > Out
Sept 2020,133,163,171,18691761,784699465,803391226,60,170,5,766007704,In > Out
Sept 2020,133,164,849,473174462,2697408779,3170583241,322,834,5,2224234317,In > Out
Sept 2020,133,165,1000,235510391,19390929312,19626439703,290,981,14,19155418921,In > Out
Sept 2020,133,168,650,1184004355,3384624116,4568628471,199,639,8,2200619761,In > Out
Sept 2020,133,169,1187,1022423620,5482794637,6505218257,324,1151,5,4460371017,In > Out
Sept 2020,133,17,503,167843622,1550840429,1718684051,153,498,3,1382996807,In > Out
Sept 2020,133,171,2598,820714845,6467406725,7288121570,527,2462,51,5646691880,In > Out
Sept 2020,133,172,455,256716966,18370753866,18627470832,164,453,4,18114036900,In > Out
Sept 2020,133,175,978,150049971,3950170069,4100220040,249,949,19,3800120098,In > Out
Sept 2020,133,176,722,1700602840,29878435068,31579037908,225,717,6,28177832228,In > Out
Sept 2020,133,177,873,630087468,2373290461,3003377929,285,856,4,1743202993,In > Out
Sept 2020,133,178,149,18281224,426504386,444785610,51,149,4,408223162,In > Out
Sept 2020,133,179,2303,362676119,18223588962,18586265081,250,2158,3,17860912843,In > Out
Sept 2020,133,18,652,479307376,8622742399,9102049775,256,647,6,8143435023,In > Out
Sept 2020,133,183,427,770755435,3456931485,4227686920,128,415,7,2686176050,In > Out
Sept 2020,133,186,325,46790673,4397278298,4444068971,106,325,4,4350487625,In > Out
Sept 2020,133,188,187,66928083,3361213366,3428141449,54,187,3,3294285283,In > Out
Sept 2020,133,189,1010,449649571,4654253628,5103903199,259,992,5,4204604057,In > Out
Sept 2020,133,19,795,435657100,7122061026,7557718126,216,770,6,6686403926,In > Out
Sept 2020,133,191,718,383712795,1002891815,1386604610,118,714,6,619179020,In > Out
Sept 2020,133,192,171,13845709,467363645,481209354,50,171,1,453517936,In > Out
Sept 2020,133,193,1000,3005143507,5406372919,8411516426,224,970,12,2401229412,In > Out
Sept 2020,133,194,1108,452198139,3264392980,3716591119,267,1084,19,2812194841,In > Out
Sept 2020,133,195,414,63325882,1308428165,1371754047,164,410,5,1245102283,In > Out
Sept 2020,133,198,608,235234155,6375301873,6610536028,164,607,5,6140067718,In > Out
Sept 2020,133,199,99,1880516445,1876888181,3757404626,50,98,4,3628264,Out > In
Sept 2020,133,201,432,41504407,2102534564,2144038971,158,431,2,2061030157,In > Out
Sept 2020,133,203,1877,516138403,19351272612,19867411015,515,1778,8,18835134209,In > Out
Sept 2020,133,204,1464,532274547,6740725737,7273000284,260,1321,7,6208451190,In > Out
Sept 2020,133,206,399,40412732,1427387097,1467799829,143,396,5,1386974365,In > Out
Sept 2020,133,207,251,50586792,1834112979,1884699771,89,251,3,1783526187,In > Out
Sept 2020,133,208,134,13607529,365833367,379440896,54,134,3,352225838,In > Out
Sept 2020,133,21,523,462517120,3051621548,3514138668,154,515,7,2589104428,In > Out
Sept 2020,133,211,738,95202608,3869213664,3964416272,241,725,4,3774011056,In > Out
Sept 2020,133,213,452,767018787,2811766020,3578784807,157,451,7,2044747233,In > Out
Sept 2020,133,215,76,7774115,501928643,509702758,38,76,4,494154528,In > Out
Sept 2020,133,216,1820,322824120,8103196181,8426020301,353,1780,7,7780372061,In > Out
Sept 2020,133,217,137,76604007,6331683476,6408287483,64,137,6,6255079469,In > Out
Sept 2020,133,218,652,164669446,4523868928,4688538374,191,642,6,4359199482,In > Out
Sept 2020,133,220,1384,1528686907,8915528666,10444215573,270,1331,9,7386841759,In > Out
Sept 2020,133,221,1291,188607176,8926720094,9115327270,325,1257,6,8738112918,In > Out
Sept 2020,133,222,467,841426711,2960443577,3801870288,166,467,5,2119016866,In > Out
Sept 2020,133,223,1517,234907603,7889267121,8124174724,456,1485,5,7654359518,In > Out
Sept 2020,133,25,947,172066773,6551898864,6723965637,309,919,6,6379832091,In > Out
Sept 2020,133,26,713,1431368480,6046182443,7477550923,259,707,5,4614813963,In > Out
Sept 2020,133,27,2142,2612967122,8857988682,11470955804,338,2075,11,6245021560,In > Out
Sept 2020,133,28,735,248461452,1488405409,1736866861,227,732,5,1239943957,In > Out
Sept 2020,133,30,428,524042979,29799322482,30323365461,179,428,7,29275279503,In > Out
Sept 2020,133,31,1062,2232529428,5652808048,7885337476,321,1032,4,3420278620,In > Out
Sept 2020,133,32,717,730108474,3865888862,4595997336,247,711,5,3135780388,In > Out
Sept 2020,133,33,567,178847997,8611738343,8790586340,259,560,10,8432890346,In > Out
Sept 2020,133,36,167,26364426,523038740,549403166,75,166,4,496674314,In > Out
Sept 2020,133,37,552,718969674,4304230882,5023200556,182,551,6,3585261208,In > Out
Sept 2020,133,4,666,165896730,1262731290,1428628020,290,661,9,1096834560,In > Out
Sept 2020,133,40,2078,528516671,40455724188,40984240859,605,1834,8,39927207517,In > Out
Sept 2020,133,44,780,161720178,2540040520,2701760698,192,766,5,2378320342,In > Out
Sept 2020,133,45,581,329702205,3057659199,3387361404,165,573,5,2727956994,In > Out
Sept 2020,133,46,1831,1217006998,5425345935,6642352933,225,1766,11,4208338937,In > Out
Sept 2020,133,47,255,16529206,773470594,789999800,107,254,3,756941388,In > Out
Sept 2020,133,48,30,2804925,70577011,73381936,14,30,3,67772086,In > Out
Sept 2020,133,54,1412,468703983,3394520928,3863224911,280,1342,9,2925816945,In > Out
Sept 2020,133,55,50,6597472,530151801,536749273,24,50,5,523554329,In > Out
Sept 2020,133,56,676,146600011,3049902134,3196502145,245,659,5,2903302123,In > Out
Sept 2020,133,57,771,421819407,4292477805,4714297212,297,757,4,3870658398,In > Out
Sept 2020,133,59,845,757278942,4761591712,5518870654,302,841,9,4004312770,In > Out
Sept 2020,133,60,3,103640,1083430,1187070,2,3,2,979790,In > Out
Sept 2020,133,61,168,16381690,903356553,919738243,49,168,4,886974863,In > Out
Sept 2020,133,62,459,100008471,3956334354,4056342825,142,458,4,3856325883,In > Out
Sept 2020,133,63,1014,82106520,3884633293,3966739813,470,913,288,3802526773,In > Out
Sept 2020,133,64,1061,697244552,7434184487,8131429039,352,1043,6,6736939935,In > Out
Sept 2020,133,65,382,44827307,2690576804,2735404111,155,382,6,2645749497,In > Out
Sept 2020,133,69,430,2398568757,3291818682,5690387439,141,424,6,893249925,In > Out
Sept 2020,133,70,979,965720209,5565657944,6531378153,274,952,6,4599937735,In > Out
Sept 2020,133,74,235,147165331,1934452794,2081618125,116,233,4,1787287463,In > Out
Sept 2020,133,75,729,130091346,5183360533,5313451879,339,706,3,5053269187,In > Out
Sept 2020,133,77,567,55047368,1294860381,1349907749,197,557,3,1239813013,In > Out
Sept 2020,133,81,350,141330599,1956398839,2097729438,70,350,4,1815068240,In > Out
Sept 2020,133,84,403,404222492,2154782946,2559005438,140,401,3,1750560454,In > Out
Sept 2020,133,86,448,147919729,6167700941,6315620670,152,444,6,6019781212,In > Out
Sept 2020,133,87,556,51218064,3475666270,3526884334,179,554,5,3424448206,In > Out
Sept 2020,133,92,1133,206653244,11686997886,11893651130,219,1103,5,11480344642,In > Out
Sept 2020,133,93,673,340990326,10999896687,11340887013,133,660,4,10658906361,In > Out
Sept 2020,133,95,1068,4406933628,12827992747,17234926375,283,1023,13,8421059119,In > Out
Sept 2020,133,98,120,8253550,149698104,157951654,47,120,4,141444554,In > Out
Sept 2020,134,102,24,13082040,46986122,60068162,19,24,2,33904082,In > Out
Sept 2020,134,103,231,74218644,1974052944,2048271588,112,228,3,1899834300,In > Out
Sept 2020,134,105,201,33109455,754036843,787146298,72,200,3,720927388,In > Out
Sept 2020,134,107,429,153130108,946919917,1100050025,135,420,2,793789809,In > Out
Sept 2020,134,109,552,151037635,3421793565,3572831200,219,546,4,3270755930,In > Out
Sept 2020,134,11,358,82414250,3038887794,3121302044,142,358,3,2956473544,In > Out
Sept 2020,134,110,1288,153950643,4830264581,4984215224,351,1251,5,4676313938,In > Out
Sept 2020,134,113,190,97599161,1933012381,2030611542,94,189,3,1835413220,In > Out
Sept 2020,134,114,85,11010143,181416771,192426914,52,85,3,170406628,In > Out
Sept 2020,134,115,472,88330663,811045823,899376486,253,468,3,722715160,In > Out
Sept 2020,134,116,420,328768175,2565390224,2894158399,117,418,7,2236622049,In > Out
Sept 2020,134,117,685,385342164,9124771446,9510113610,143,681,3,8739429282,In > Out
Sept 2020,134,12,870,100525085,4695960319,4796485404,307,862,7,4595435234,In > Out
Sept 2020,134,120,178,24950245,997462313,1022412558,96,178,5,972512068,In > Out
Sept 2020,134,121,810,337579479,29709267236,30046846715,359,784,4,29371687757,In > Out
Sept 2020,134,122,145,13027432,258959314,271986746,93,144,3,245931882,In > Out
Sept 2020,134,123,2052,22015564679,15667625461,37683190140,361,1929,22,6347939218,Out > In
Sept 2020,134,124,117,29272179,853532311,882804490,66,116,3,824260132,In > Out
Sept 2020,134,125,388,612843048,7506021239,8118864287,113,388,3,6893178191,In > Out
Sept 2020,134,126,1141,1580410961,6101230667,7681641628,410,1120,11,4520819706,In > Out
Sept 2020,134,127,1214,240740463,8822957455,9063697918,260,1194,6,8582216992,In > Out
Sept 2020,134,128,528,216176800,2377278029,2593454829,217,519,5,2161101229,In > Out
Sept 2020,134,129,583,814155655,2202789138,3016944793,214,582,6,1388633483,In > Out
Sept 2020,134,13,754,336577949,2773211904,3109789853,207,735,4,2436633955,In > Out
Sept 2020,134,130,207,27781225,611192456,638973681,64,207,3,583411231,In > Out
Sept 2020,134,131,2589,4430194274,15301648081,19731842355,341,2532,12,10871453807,In > Out
Sept 2020,134,132,218,837290076,5673921545,6511211621,92,218,4,4836631469,In > Out
Sept 2020,134,133,260,47324816,547212963,594537779,121,259,6,499888147,In > Out
Sept 2020,134,134,77,5725052,161605365,167330417,28,77,4,155880313,In > Out
Sept 2020,134,135,1550,376120688,6519492264,6895612952,435,1503,4,6143371576,In > Out
Sept 2020,134,136,150,209624250,794374429,1003998679,83,150,5,584750179,In > Out
Sept 2020,134,137,252,26749031,1501480951,1528229982,74,252,5,1474731920,In > Out
Sept 2020,134,138,235,41988925,1068132862,1110121787,98,235,4,1026143937,In > Out
Sept 2020,134,139,2329,331076920,16108405099,16439482019,463,2222,6,15777328179,In > Out
Sept 2020,134,141,376,59769137,2621525855,2681294992,147,370,3,2561756718,In > Out
Sept 2020,134,142,1658,1565305448,8862141825,10427447273,171,1628,5,7296836377,In > Out
Sept 2020,134,143,3859,1265756732,42873919437,44139676169,398,3562,7,41608162705,In > Out
Sept 2020,134,144,351,31377999,677848427,709226426,140,349,4,646470428,In > Out
Sept 2020,134,145,40,2208427,22683131,24891558,24,40,2,20474704,In > Out
Sept 2020,134,146,296,95538464,3592786594,3688325058,86,289,2,3497248130,In > Out
Sept 2020,134,147,204,65207713,3117975592,3183183305,66,204,2,3052767879,In > Out
Sept 2020,134,150,823,140852028,4537822270,4678674298,229,818,7,4396970242,In > Out
Sept 2020,134,152,306,48990426,1394075610,1443066036,150,306,2,1345085184,In > Out
Sept 2020,134,153,1416,231518738,9497725730,9729244468,415,1388,7,9266206992,In > Out
Sept 2020,134,154,530,81333292,2861335222,2942668514,212,528,5,2780001930,In > Out
Sept 2020,134,155,378,159001848,16305417901,16464419749,87,374,2,16146416053,In > Out
Sept 2020,134,156,1039,191894285,3645781164,3837675449,244,1006,6,3453886879,In > Out
Sept 2020,134,157,124,24539681,721687299,746226980,86,123,3,697147618,In > Out
Sept 2020,134,158,849,1353062932,13209486392,14562549324,198,827,10,11856423460,In > Out
Sept 2020,134,159,31,10040479,259703874,269744353,20,31,3,249663395,In > Out
Sept 2020,134,162,239,85709177,1013295409,1099004586,102,239,4,927586232,In > Out
Sept 2020,134,163,317,60652262,1858639548,1919291810,49,316,6,1797987286,In > Out
Sept 2020,134,164,785,172879744,5028727477,5201607221,154,770,6,4855847733,In > Out
Sept 2020,134,167,148,94122601,978703619,1072826220,73,148,4,884581018,In > Out
Sept 2020,134,168,514,311201535,2879232329,3190433864,184,510,5,2568030794,In > Out
Sept 2020,134,174,546,431629769,4327839589,4759469358,207,545,4,3896209820,In > Out
Sept 2020,134,175,1284,346056738,10259179750,10605236488,302,1251,6,9913123012,In > Out
Sept 2020,134,176,692,317712842,3977404051,4295116893,160,682,3,3659691209,In > Out
Sept 2020,134,178,71,5893994,252377550,258271544,24,71,2,246483556,In > Out
Sept 2020,134,179,113,8753789,511204178,519957967,51,112,4,502450389,In > Out
Sept 2020,134,180,1391,311307365,10080933821,10392241186,302,1362,8,9769626456,In > Out
Sept 2020,134,181,2263,1984763928,10507939141,12492703069,519,2136,15,8523175213,In > Out
Sept 2020,134,182,1757,234398890,11090593517,11324992407,230,1700,4,10856194627,In > Out
Sept 2020,134,185,267,39771434,720104077,759875511,81,259,5,680332643,In > Out
Sept 2020,134,187,377,162070102,1364616197,1526686299,115,372,6,1202546095,In > Out
Sept 2020,134,188,572,139903157,3195487454,3335390611,217,567,10,3055584297,In > Out
Sept 2020,134,19,84,21556948,229302427,250859375,39,83,4,207745479,In > Out
Sept 2020,134,190,1858,1078503931,15451125820,16529629751,470,1801,33,14372621889,In > Out
Sept 2020,134,192,794,219853118,10856298260,11076151378,268,790,6,10636445142,In > Out
Sept 2020,134,194,221,25535996,1494523996,1520059992,85,221,3,1468988000,In > Out
Sept 2020,134,196,984,393164485,2459433990,2852598475,249,968,6,2066269505,In > Out
Sept 2020,134,198,97,15156195,667936541,683092736,51,97,5,652780346,In > Out
Sept 2020,134,201,132,278071547,1240099835,1518171382,47,132,4,962028288,In > Out
Sept 2020,134,202,624,82840676,2062891704,2145732380,150,613,4,1980051028,In > Out
Sept 2020,134,204,731,117710212,6024293229,6142003441,194,711,4,5906583017,In > Out
Sept 2020,134,205,202,220449934,3150469253,3370919187,91,199,6,2930019319,In > Out
Sept 2020,134,206,288,65222483,2942017478,3007239961,112,287,2,2876794995,In > Out
Sept 2020,134,209,370,1075558557,3644078272,4719636829,122,366,5,2568519715,In > Out
Sept 2020,134,212,1472,456425678,4606463576,5062889254,333,1457,4,4150037898,In > Out
Sept 2020,134,213,848,83705732,2294070366,2377776098,223,832,5,2210364634,In > Out
Sept 2020,134,214,312,133673616,9465206218,9598879834,102,312,5,9331532602,In > Out
Sept 2020,134,215,1030,226147926,6023424380,6249572306,224,1005,5,5797276454,In > Out
Sept 2020,134,216,490,297278410,2730502456,3027780866,114,486,2,2433224046,In > Out
Sept 2020,134,217,682,1091545299,2208843742,3300389041,238,673,6,1117298443,In > Out
Sept 2020,134,218,2154,695020081,6232854085,6927874166,317,2074,4,5537834004,In > Out
Sept 2020,134,220,164,635892250,1694570350,2330462600,63,163,5,1058678100,In > Out
Sept 2020,134,222,75,1896382,22663072,24559454,14,75,3,20766690,In > Out
Sept 2020,134,223,656,210128700,4162696554,4372825254,273,645,5,3952567854,In > Out
Sept 2020,134,23,1261,615633482,9209983603,9825617085,281,1224,6,8594350121,In > Out
Sept 2020,134,24,80,34656043,225962724,260618767,42,80,3,191306681,In > Out
Sept 2020,134,26,518,81254657,1648217888,1729472545,207,515,6,1566963231,In > Out
Sept 2020,134,28,4271,324207837,10525098587,10849306424,477,3701,116,10200890750,In > Out
Sept 2020,134,29,831,115910371,3804516244,3920426615,173,811,4,3688605873,In > Out
Sept 2020,134,30,1,10335,92191,102526,1,1,1,81856,In > Out
Sept 2020,134,32,303,501880121,2474527102,2976407223,121,303,3,1972646981,In > Out
Sept 2020,134,33,177,27085063,1113446455,1140531518,82,177,4,1086361392,In > Out
Sept 2020,134,34,1704,3753355460,3082993892,6836349352,481,1669,7,670361568,Out > In
Sept 2020,134,38,310,413332725,1952065596,2365398321,114,310,4,1538732871,In > Out
Sept 2020,134,39,167,781310232,1946356910,2727667142,81,164,9,1165046678,In > Out
Sept 2020,134,4,24,29918509,324562852,354481361,20,24,4,294644343,In > Out
Sept 2020,134,40,152,16903674,799674098,816577772,67,152,2,782770424,In > Out
Sept 2020,134,42,142,366212419,1398978405,1765190824,75,142,3,1032765986,In > Out
Sept 2020,134,43,927,105732863,6454915201,6560648064,288,900,4,6349182338,In > Out
Sept 2020,134,44,37,1958884,82600863,84559747,17,37,2,80641979,In > Out
Sept 2020,134,45,1506,325075508,8848111245,9173186753,377,1457,7,8523035737,In > Out
Sept 2020,134,47,1407,141645338,6293232561,6434877899,415,1367,11,6151587223,In > Out
Sept 2020,134,48,215,19657436,224026739,243684175,111,214,2,204369303,In > Out
Sept 2020,134,5,2459,5541919214,17181244745,22723163959,536,2341,7,11639325531,In > Out
Sept 2020,134,50,184,40606405,3186775488,3227381893,99,184,3,3146169083,In > Out
Sept 2020,134,52,645,170484683,12970895607,13141380290,190,639,2,12800410924,In > Out
Sept 2020,134,53,26,3000489,7997559,10998048,16,26,3,4997070,In > Out
Sept 2020,134,54,4784,1170226077,12919062279,14089288356,656,4106,9,11748836202,In > Out
Sept 2020,134,55,140,16800210,1806282577,1823082787,41,140,3,1789482367,In > Out
Sept 2020,134,56,1438,163752286,7721012274,7884764560,224,1411,17,7557259988,In > Out
Sept 2020,134,58,57,5125852,349155987,354281839,49,57,2,344030135,In > Out
Sept 2020,134,60,713,1339085930,7078168403,8417254333,241,707,7,5739082473,In > Out
Sept 2020,134,61,2326,449855687,16606269067,17056124754,204,2214,5,16156413380,In > Out
Sept 2020,134,62,45,2525482,89156442,91681924,20,45,4,86630960,In > Out
Sept 2020,134,63,486,211804637,2266526329,2478330966,137,484,4,2054721692,In > Out
Sept 2020,134,64,584,64908034,2763747695,2828655729,191,584,5,2698839661,In > Out
Sept 2020,134,66,13,713361,2611932,3325293,5,13,2,1898571,In > Out
Sept 2020,134,67,73,10888673,522787418,533676091,37,73,2,511898745,In > Out
Sept 2020,134,69,395,64011797,4050414491,4114426288,116,389,3,3986402694,In > Out
Sept 2020,134,7,2038,376771605,23878233173,24255004778,227,1965,5,23501461568,In > Out
Sept 2020,134,71,1720,2764703199,7731344794,10496047993,410,1610,93,4966641595,In > Out
Sept 2020,134,72,34,4537695,13422064,17959759,23,34,4,8884369,In > Out
Sept 2020,134,73,181,605687982,3921484555,4527172537,62,178,4,3315796573,In > Out
Sept 2020,134,74,732,694622644,3056670198,3751292842,199,710,10,2362047554,In > Out
Sept 2020,134,75,1593,1844376256,8265766837,10110143093,395,1293,24,6421390581,In > Out
Sept 2020,134,76,339,434267739,1768126949,2202394688,135,329,6,1333859210,In > Out
Sept 2020,134,77,178,40369945,134904531,175274476,54,178,1,94534586,In > Out
Sept 2020,134,78,335,65744959,7161402738,7227147697,119,335,3,7095657779,In > Out
Sept 2020,134,80,175,192873343,1029914793,1222788136,83,174,3,837041450,In > Out
Sept 2020,134,81,788,465957967,8501525078,8967483045,214,783,5,8035567111,In > Out
Sept 2020,134,82,485,46628243,2013791257,2060419500,150,482,4,1967163014,In > Out
Sept 2020,134,84,178,54688748,2454997989,2509686737,64,178,3,2400309241,In > Out
Sept 2020,134,86,12,790187,37756629,38546816,8,12,2,36966442,In > Out
Sept 2020,134,88,865,169050181,7693563033,7862613214,291,862,10,7524512852,In > Out
Sept 2020,134,89,398,66565852,2837066211,2903632063,93,396,4,2770500359,In > Out
Sept 2020,134,90,321,1347510125,21986320131,23333830256,153,314,5,20638810006,In > Out
Sept 2020,134,91,309,37591901,1297193201,1334785102,102,309,3,1259601300,In > Out
Sept 2020,134,92,641,572778725,2252027491,2824806216,225,633,3,1679248766,In > Out
Sept 2020,134,94,671,143767997,6055386953,6199154950,154,671,7,5911618956,In > Out
Sept 2020,134,95,592,54675778,931594957,986270735,284,590,5,876919179,In > Out
Sept 2020,134,97,860,128529026,3433658561,3562187587,172,848,6,3305129535,In > Out
Sept 2020,134,98,582,748160484,15388358204,16136518688,220,570,8,14640197720,In > Out
Sept 2020,134,99,179,128263672,277269535,405533207,68,179,3,149005863,In > Out
Sept 2020,135,57,478,30611852,452768774,483380626,231,450,2,422156922,In > Out
Sept 2020,138,133,1204,136914378,2880896031,3017810409,227,1172,3,2743981653,In > Out
Sept 2020,138,167,1186,57165471,5025289188,5082454659,48,1008,2,4968123717,In > Out
Sept 2020,138,97,875,39718002,3839756487,3879474489,45,834,2,3800038485,In > Out
Sept 2020,14,10,143,6820546,696575948,703396494,73,143,2,689755402,In > Out
Sept 2020,14,111,78,1236459,245716516,246952975,14,78,2,244480057,In > Out
Sept 2020,14,12,20,2287616,195496139,197783755,4,20,1,193208523,In > Out
Sept 2020,14,16,161,13806274,355073939,368880213,15,160,4,341267665,In > Out
Sept 2020,14,18,62,5648275,114054121,119702396,26,62,2,108405846,In > Out
Sept 2020,14,20,4,298271,23039498,23337769,4,4,2,22741227,In > Out
Sept 2020,14,42,24,2391539,291716504,294108043,8,24,2,289324965,In > Out
Sept 2020,14,57,348,94879205,4759005686,4853884891,122,340,3,4664126481,In > Out
Sept 2020,141,104,8920,3018229344,35974171081,38992400425,101,6845,2,32955941737,In > Out
Sept 2020,141,109,370,54379214,3892539101,3946918315,49,367,2,3838159887,In > Out
Sept 2020,141,131,520,2079228714,6451928392,8531157106,132,519,3,4372699678,In > Out
Sept 2020,141,138,249,25698156,758534203,784232359,75,249,3,732836047,In > Out
Sept 2020,141,155,36,3086228,140937866,144024094,27,36,2,137851638,In > Out
Sept 2020,141,165,29,1868335,90416927,92285262,4,29,2,88548592,In > Out
Sept 2020,141,170,546,117929592,8688756491,8806686083,60,545,2,8570826899,In > Out
Sept 2020,141,194,316,57843996,4123381745,4181225741,51,316,2,4065537749,In > Out
Sept 2020,141,195,130,26427149,850944417,877371566,57,130,2,824517268,In > Out
Sept 2020,141,28,1446,216172692,617273123,833445815,48,1406,2,401100431,In > Out
Sept 2020,141,39,459,153389336,7101636506,7255025842,145,459,2,6948247170,In > Out
Sept 2020,141,40,70,42615942,1594748503,1637364445,30,70,2,1552132561,In > Out
Sept 2020,141,41,5,228600,22661104,22889704,5,5,2,22432504,In > Out
Sept 2020,141,42,782,182777755,4780196775,4962974530,194,766,2,4597419020,In > Out
Sept 2020,141,62,185,34146541,522830243,556976784,57,185,2,488683702,In > Out
Sept 2020,141,63,261,31969663,409409800,441379463,64,261,2,377440137,In > Out
Sept 2020,141,68,392,127270834,2330278602,2457549436,145,389,2,2203007768,In > Out
Sept 2020,141,91,348,15967615,1131802606,1147770221,43,347,2,1115834991,In > Out
Sept 2020,142,101,15,4506658,288531923,293038581,4,15,1,284025265,In > Out
Sept 2020,142,103,16,4578498,276086399,280664897,4,16,1,271507901,In > Out
Sept 2020,142,104,14,7137398,286150706,293288104,4,14,1,279013308,In > Out
Sept 2020,142,105,22,2391029,295010434,297401463,7,22,2,292619405,In > Out
Sept 2020,142,11,17,4452797,243807475,248260272,3,17,1,239354678,In > Out
Sept 2020,142,121,2,3250224,1523147834,1526398058,2,2,1,1519897610,In > Out
Sept 2020,142,122,4,367428,110862336,111229764,4,4,1,110494908,In > Out
Sept 2020,142,13,14,3487092,244248173,247735265,4,14,1,240761081,In > Out
Sept 2020,142,14,527,4714189,713328064,718042253,5,519,517,708613875,In > Out
Sept 2020,142,16,4,435882,118854264,119290146,4,4,1,118418382,In > Out
Sept 2020,142,17,15,19160,1730591,1749751,1,1,15,1711431,In > Out
Sept 2020,142,18,2,143704,26485535,26629239,2,2,2,26341831,In > Out
Sept 2020,142,19,3,304469,42289576,42594045,3,3,2,41985107,In > Out
Sept 2020,142,21,3,239097,38065496,38304593,3,3,1,37826399,In > Out
Sept 2020,142,22,8,10700,951080,961780,1,1,8,940380,In > Out
Sept 2020,142,24,3,4850317,1939715023,1944565340,3,3,1,1934864706,In > Out
Sept 2020,142,27,4,648251,134831320,135479571,4,4,1,134183069,In > Out
Sept 2020,142,28,4,487340,119149484,119636824,3,4,1,118662144,In > Out
Sept 2020,142,30,17,4878230,273055964,277934194,5,17,2,268177734,In > Out
Sept 2020,142,31,4,595782,128638129,129233911,4,4,1,128042347,In > Out
Sept 2020,142,32,4,406172,100899158,101305330,4,4,1,100492986,In > Out
Sept 2020,142,33,3,398757,114977039,115375796,3,3,1,114578282,In > Out
Sept 2020,142,34,18,4775043,256158297,260933340,4,18,1,251383254,In > Out
Sept 2020,142,35,14,2979214,234175747,237154961,4,14,1,231196533,In > Out
Sept 2020,142,36,27,6086636,255218342,261304978,6,27,12,249131706,In > Out
Sept 2020,142,4,18,3557754,276988205,280545959,4,18,1,273430451,In > Out
Sept 2020,142,41,14,3915848,252618377,256534225,4,14,1,248702529,In > Out
Sept 2020,142,5,16,3719050,264642994,268362044,3,16,1,260923944,In > Out
Sept 2020,142,50,4,72467259,4082455700,4154922959,2,4,2,4009988441,In > Out
Sept 2020,142,54,5,32507515,469688,32977203,4,5,5,32037827,Out > In
Sept 2020,142,55,4,470350,118912410,119382760,4,4,1,118442060,In > Out
Sept 2020,142,56,129,28765040,227084,28992124,2,129,128,28537956,Out > In
Sept 2020,142,57,112,46059817,1202512,47262329,13,22,111,44857305,Out > In
Sept 2020,142,58,389,86772886,947325,87720211,6,352,384,85825561,Out > In
Sept 2020,142,59,406,105320826,1293455,106614281,5,320,396,104027371,Out > In
Sept 2020,142,60,4,657706,146497742,147155448,4,4,1,145840036,In > Out
Sept 2020,142,61,4,451258,128896231,129347489,4,4,1,128444973,In > Out
Sept 2020,142,63,4,451828,118535744,118987572,4,4,1,118083916,In > Out
Sept 2020,142,67,4,494282,118135290,118629572,4,4,1,117641008,In > Out
Sept 2020,142,68,227,2178892,61683027,63861919,4,223,1,59504135,In > Out
Sept 2020,142,69,215,8736298,351526798,360263096,7,215,2,342790500,In > Out
Sept 2020,142,70,13578,78853201,1676381136,1755234337,2,8939,1,1597527935,In > Out
Sept 2020,142,71,29529,341163890,10502891792,10844055682,7,12398,8,10161727902,In > Out
Sept 2020,142,72,4,454813,122090390,122545203,4,4,1,121635577,In > Out
Sept 2020,142,74,2449,671300404,30889132653,31560433057,4,2448,2,30217832249,In > Out
Sept 2020,142,75,4,472534,120395849,120868383,3,4,1,119923315,In > Out
Sept 2020,142,76,2,354780,45572635,45927415,2,2,2,45217855,In > Out
Sept 2020,142,77,2,578267,44919719,45497986,2,2,2,44341452,In > Out
Sept 2020,142,79,1631,38360345,1378822099,1417182444,12,1560,2,1340461754,In > Out
Sept 2020,142,80,4,533848,134700005,135233853,4,4,1,134166157,In > Out
Sept 2020,142,81,14,3892428,276200690,280093118,4,14,1,272308262,In > Out
Sept 2020,142,84,14,4021960,241483281,245505241,2,14,1,237461321,In > Out
Sept 2020,142,86,23,535734,125973054,126508788,7,5,20,125437320,In > Out
Sept 2020,142,87,4,575479,131648085,132223564,4,4,1,131072606,In > Out
Sept 2020,142,88,4,550109,128997366,129547475,4,4,1,128447257,In > Out
Sept 2020,142,89,4,483375,134301695,134785070,4,4,1,133818320,In > Out
Sept 2020,142,9,18,4329699,262764291,267093990,4,18,1,258434592,In > Out
Sept 2020,142,90,4,532406,124029310,124561716,4,4,1,123496904,In > Out
Sept 2020,142,91,3,739506,116257380,116996886,1,3,1,115517874,In > Out
Sept 2020,142,92,4,526736,126309460,126836196,4,4,1,125782724,In > Out
Sept 2020,142,93,4,377838,118335985,118713823,4,4,1,117958147,In > Out
Sept 2020,142,94,15,5779914,211106916,216886830,3,15,1,205327002,In > Out
Sept 2020,142,96,14,4053270,281984632,286037902,4,14,1,277931362,In > Out
Sept 2020,142,97,14,3521749,100401149,103922898,4,14,1,96879400,In > Out
Sept 2020,142,98,4,680888,134469247,135150135,4,4,1,133788359,In > Out
Sept 2020,142,99,1673,25318766,316276522,341595288,54,1590,1,290957756,In > Out
Sept 2020,143,137,3032,2556825339,10481038826,13037864165,557,2698,14,7924213487,In > Out
Sept 2020,143,148,1778,3991884247,19312442955,23304327202,411,1678,7,15320558708,In > Out
Sept 2020,143,149,9549,3802648279,319101105655,322903753934,1380,7019,28,315298457376,In > Out
Sept 2020,143,152,11814,6047497716,99065444984,105112942700,1691,8462,31,93017947268,In > Out
Sept 2020,143,2,1327,2274310531,5131584545,7405895076,427,1291,4,2857274014,In > Out
Sept 2020,143,205,7802,6751002661,60295444562,67046447223,949,6526,8,53544441901,In > Out
Sept 2020,143,220,2949,262792423,16631539488,16894331911,754,2724,2,16368747065,In > Out
Sept 2020,143,27,7,51326497,163404541,214731038,4,7,1,112078044,In > Out
Sept 2020,143,28,122,411453684,642942015,1054395699,55,122,1,231488331,In > Out
Sept 2020,143,43,120,98763233,386215875,484979108,61,120,1,287452642,In > Out
Sept 2020,144,100,16,9199127,1551273610,1560472737,6,16,2,1542074483,In > Out
Sept 2020,144,179,431,38783125,2750975384,2789758509,36,431,2,2712192259,In > Out
Sept 2020,144,210,288,22339032,1181294690,1203633722,38,288,2,1158955658,In > Out
Sept 2020,144,29,1,2223242,924200,3147442,1,1,1,1299042,Out > In
Sept 2020,144,72,3,24784,606729,631513,2,3,1,581945,In > Out
Sept 2020,145,170,943,51187209,3326256788,3377443997,51,941,2,3275069579,In > Out
Sept 2020,145,29,19,1452803,9675971,11128774,6,19,1,8223168,In > Out
Sept 2020,145,47,60,12530037,3209160704,3221690741,15,60,2,3196630667,In > Out
Sept 2020,145,53,76,1770111,94691518,96461629,30,76,2,92921407,In > Out
Sept 2020,145,64,78,26107550,6528299524,6554407074,14,78,2,6502191974,In > Out
Sept 2020,145,65,109,14308882,3383071689,3397380571,33,109,2,3368762807,In > Out
Sept 2020,145,71,198,18392969,3617594532,3635987501,29,198,2,3599201563,In > Out
Sept 2020,145,74,531,44400627,7745498322,7789898949,36,531,2,7701097695,In > Out
Sept 2020,145,79,59,13530667,3366787378,3380318045,13,59,2,3353256711,In > Out
Sept 2020,145,89,82,90724548,6574578711,6665303259,17,82,2,6483854163,In > Out
Sept 2020,145,9,192,22979507,3721084519,3744064026,17,192,2,3698105012,In > Out
Sept 2020,145,90,53,12212851,3128072372,3140285223,11,53,1,3115859521,In > Out
Sept 2020,145,94,321,20948813,3820842363,3841791176,28,321,2,3799893550,In > Out
Sept 2020,145,95,909,47316776,3195292577,3242609353,46,815,2,3147975801,In > Out
Sept 2020,146,106,775,124744095,642695478,767439573,155,755,2,517951383,In > Out
Sept 2020,146,132,1919,355034622,2063859793,2418894415,420,1818,3,1708825171,In > Out
Sept 2020,146,136,2563,1662343778,6405607533,8067951311,111,2355,2,4743263755,In > Out
Sept 2020,146,138,231,59269086,2219738267,2279007353,44,231,2,2160469181,In > Out
Sept 2020,146,140,1469,197215807,767052217,964268024,73,1417,2,569836410,In > Out
Sept 2020,146,141,33,12333934,295699586,308033520,20,33,2,283365652,In > Out
Sept 2020,146,143,1916,451591987,10021947783,10473539770,124,1826,2,9570355796,In > Out
Sept 2020,146,152,1068,238716190,1282131444,1520847634,119,1034,3,1043415254,In > Out
Sept 2020,146,157,997,138624638,246863539,385488177,141,979,2,108238901,In > Out
Sept 2020,146,163,281,65903162,4429085690,4494988852,27,281,2,4363182528,In > Out
Sept 2020,146,165,17,5859557,286738597,292598154,7,17,3,280879040,In > Out
Sept 2020,146,175,97,26284673,209816477,236101150,52,97,2,183531804,In > Out
Sept 2020,146,193,617,63797100,469830444,533627544,66,609,2,406033344,In > Out
Sept 2020,146,213,151,12924287,673278027,686202314,27,150,2,660353740,In > Out
Sept 2020,146,220,425,205244463,7816017782,8021262245,87,423,2,7610773319,In > Out
Sept 2020,146,24,1097,262139986,369922766,632062752,144,1074,2,107782780,In > Out
Sept 2020,146,60,333,28030099,334152410,362182509,126,331,2,306122311,In > Out
Sept 2020,146,63,212,26445988,627015909,653461897,60,212,2,600569921,In > Out
Sept 2020,146,77,605,148618363,450464775,599083138,125,595,2,301846412,In > Out
Sept 2020,146,79,29,3553399,148544106,152097505,10,29,2,144990707,In > Out
Sept 2020,146,8,61,1144190,45102350,46246540,17,61,1,43958160,In > Out
Sept 2020,149,108,400,73978441,3623995805,3697974246,70,383,3,3550017364,In > Out
Sept 2020,149,119,65,35940566,1754485890,1790426456,45,65,2,1718545324,In > Out
Sept 2020,149,129,182,11061713,713487785,724549498,22,180,2,702426072,In > Out
Sept 2020,149,13,2,114904,129994,244898,2,2,2,15090,In > Out
Sept 2020,149,147,539,26728087,469588465,496316552,214,533,2,442860378,In > Out
Sept 2020,149,157,570,92196163,6984301787,7076497950,99,563,2,6892105624,In > Out
Sept 2020,149,158,1282,256461753,6021672617,6278134370,452,1242,2,5765210864,In > Out
Sept 2020,149,160,58,111416718,40376848,151793566,51,5,9,71039870,Out > In
Sept 2020,149,168,37,14872872,427002414,441875286,22,37,3,412129542,In > Out
Sept 2020,149,176,4280,33720843,1507037909,1540758752,44,3846,2,1473317066,In > Out
Sept 2020,149,181,94,19568748,1411650035,1431218783,49,93,2,1392081287,In > Out
Sept 2020,149,189,1575,418865356,1728540161,2147405517,138,1508,2,1309674805,In > Out
Sept 2020,149,193,289,584394158,3335920358,3920314516,57,285,6,2751526200,In > Out
Sept 2020,149,195,284,51009896,703761067,754770963,37,282,2,652751171,In > Out
Sept 2020,149,231,1335,207004849,1998489168,2205494017,365,1295,3,1791484319,In > Out
Sept 2020,149,237,82,9957031,566816415,576773446,33,82,2,556859384,In > Out
Sept 2020,149,253,159,77995260,1951802339,2029797599,47,159,3,1873807079,In > Out
Sept 2020,149,45,246,6258653,236898510,243157163,91,246,2,230639857,In > Out
Sept 2020,149,60,515,134434238,507748343,642182581,104,508,2,373314105,In > Out
Sept 2020,149,72,20,2928002,96301074,99229076,14,20,2,93373072,In > Out
Sept 2020,149,78,21,476319,17657251,18133570,9,21,2,17180932,In > Out
Sept 2020,149,8,2441,113201737,1524436114,1637637851,379,2320,2,1411234377,In > Out
Sept 2020,149,82,79,7050618,58390336,65440954,48,79,4,51339718,In > Out
Sept 2020,149,83,112,30192001,2297338592,2327530593,45,109,2,2267146591,In > Out
Sept 2020,149,86,73,10632775,510791300,521424075,23,73,2,500158525,In > Out
Sept 2020,149,88,40,20306610,116332932,136639542,7,40,2,96026322,In > Out
Sept 2020,149,91,19,1139093,62446856,63585949,6,19,2,61307763,In > Out
Sept 2020,149,92,3424,414960648,2334511018,2749471666,370,3084,2,1919550370,In > Out
Sept 2020,149,95,156,17152599,868371492,885524091,46,156,2,851218893,In > Out
Sept 2020,150,119,64,9861579,440189290,450050869,28,63,2,430327711,In > Out
Sept 2020,150,123,44,4180333,79362981,83543314,22,43,2,75182648,In > Out
Sept 2020,150,128,335,45023169,910060215,955083384,115,301,2,865037046,In > Out
Sept 2020,150,15,135,54142113,437021583,491163696,18,134,2,382879470,In > Out
Sept 2020,150,159,139,14950859,870573872,885524731,45,139,2,855623013,In > Out
Sept 2020,150,171,1771,374930999,5895518550,6270449549,314,1672,3,5520587551,In > Out
Sept 2020,150,180,57,5810173,219445391,225255564,31,51,2,213635218,In > Out
Sept 2020,150,184,114,200496844,1345742824,1546239668,39,114,3,1145245980,In > Out
Sept 2020,150,189,1317,1859681590,12242413687,14102095277,91,1316,3,10382732097,In > Out
Sept 2020,150,191,68,300960955,14780018,315740973,14,63,1,286180937,Out > In
Sept 2020,150,207,233,50077819,3547358652,3597436471,27,232,2,3497280833,In > Out
Sept 2020,150,215,62,9060402,415292895,424353297,23,61,2,406232493,In > Out
Sept 2020,150,216,9,115288,5174478,5289766,6,9,1,5059190,In > Out
Sept 2020,150,219,2060,503339124,852301316,1355640440,190,1949,2,348962192,In > Out
Sept 2020,150,220,302,10050379,737252754,747303133,26,300,3,727202375,In > Out
Sept 2020,150,221,60,4970083,81623858,86593941,19,60,3,76653775,In > Out
Sept 2020,150,237,368,26957072,1371731636,1398688708,155,368,3,1344774564,In > Out
Sept 2020,150,239,12,866682,9842997,10709679,7,12,1,8976315,In > Out
Sept 2020,150,240,550,150459444,343224445,493683889,73,542,2,192765001,In > Out
Sept 2020,150,241,1813,448107072,5080385526,5528492598,454,1769,6,4632278454,In > Out
Sept 2020,150,245,2359,1479764197,70653458298,72133222495,158,2359,3,69173694101,In > Out
Sept 2020,150,250,188,83085578,3015254494,3098340072,24,188,2,2932168916,In > Out
Sept 2020,150,31,66,8293190,461689187,469982377,27,65,2,453395997,In > Out
Sept 2020,150,46,158,42133579,388649735,430783314,77,143,2,346516156,In > Out
Sept 2020,150,57,5,1049395246,993037275,2042432521,1,5,5,56357971,Out > In
Sept 2020,150,71,237,120099011,3897191453,4017290464,55,235,2,3777092442,In > Out
Sept 2020,150,86,86,33796507,1205267450,1239063957,40,86,2,1171470943,In > Out
Sept 2020,151,96,975,461581572022,1785883048,463367455070,13,955,2,459795688974,Out > In
Sept 2020,153,133,191,43703766,682787583,726491349,74,191,3,639083817,In > Out
Sept 2020,154,136,63,6391069,287709588,294100657,28,63,2,281318519,In > Out
Sept 2020,154,14,215,28010008,1305599748,1333609756,29,215,2,1277589740,In > Out
Sept 2020,154,143,1394,410455728,16271034560,16681490288,380,1343,2,15860578832,In > Out
Sept 2020,154,162,1288,2022309750,4238739845,6261049595,238,1242,4,2216430095,In > Out
Sept 2020,154,167,67,7109429,391197572,398307001,27,66,2,384088143,In > Out
Sept 2020,154,172,52,1087035,337089284,338176319,22,52,2,336002249,In > Out
Sept 2020,154,174,199,9545445,534819591,544365036,29,199,2,525274146,In > Out
Sept 2020,154,179,80,9909172,283495861,293405033,43,80,2,273586689,In > Out
Sept 2020,154,185,1602,171498009,1425332574,1596830583,350,1529,2,1253834565,In > Out
Sept 2020,154,202,49,5087105,243441749,248528854,20,49,2,238354644,In > Out
Sept 2020,154,207,273,25951054,722432347,748383401,79,272,2,696481293,In > Out
Sept 2020,154,221,880,287618113,4001718610,4289336723,157,864,2,3714100497,In > Out
Sept 2020,154,222,1332,135371110,2473252921,2608624031,296,1284,2,2337881811,In > Out
Sept 2020,154,23,45,2181273,78471429,80652702,20,44,2,76290156,In > Out
Sept 2020,154,25,320,85608051,3586367730,3671975781,35,318,2,3500759679,In > Out
Sept 2020,154,29,1015,461231305,4353857126,4815088431,90,988,3,3892625821,In > Out
Sept 2020,154,35,605,181461226,4140294574,4321755800,37,595,2,3958833348,In > Out
Sept 2020,154,38,53,5733153,267242549,272975702,24,53,2,261509396,In > Out
Sept 2020,154,56,60,6155009,298511030,304666039,26,60,2,292356021,In > Out
Sept 2020,154,57,56,5881034,324866408,330747442,25,56,2,318985374,In > Out
Sept 2020,154,61,58,5111711,286366234,291477945,27,58,2,281254523,In > Out
Sept 2020,154,66,67,9478721,354766719,364245440,36,67,2,345287998,In > Out
Sept 2020,154,72,60,6259449,307467716,313727165,25,60,2,301208267,In > Out
Sept 2020,154,9,70,10149878,546828291,556978169,35,70,2,536678413,In > Out
Sept 2020,154,95,115,23709655,697648796,721358451,47,114,2,673939141,In > Out
Sept 2020,155,106,1,4496,111430,115926,1,1,1,106934,In > Out
Sept 2020,155,135,4,474055,3240,477295,1,4,4,470815,Out > In
Sept 2020,155,142,316,89684626,1493849,91178475,58,1,316,88190777,Out > In
Sept 2020,155,143,4,490716,49481,540197,4,4,1,441235,Out > In
Sept 2020,155,145,395,11455980,1314737698,1326193678,7,392,7,1303281718,In > Out
Sept 2020,155,146,15,11296986,3244964995,3256261981,8,15,8,3233668009,In > Out
Sept 2020,155,149,213,66978072,5184162,72162234,56,19,199,61793910,Out > In
Sept 2020,155,151,58,275938649,86173213667,86449152316,17,48,27,85897275018,In > Out
Sept 2020,155,167,430,4687381294,8483183732,13170565026,148,242,130,3795802438,In > Out
Sept 2020,155,169,158,274869231,679900082,954769313,91,64,20,405030851,In > Out
Sept 2020,155,170,147,221598224,138336083,359934307,95,46,19,83262141,Out > In
Sept 2020,155,205,101,4832064,101462181,106294245,21,77,27,96630117,In > Out
Sept 2020,156,136,1183,262839874,3646275069,3909114943,111,1150,2,3383435195,In > Out
Sept 2020,156,138,248,49841979,2061908877,2111750856,129,241,2,2012066898,In > Out
Sept 2020,156,142,1012,136538826,1364906395,1501445221,202,972,2,1228367569,In > Out
Sept 2020,156,145,573,75911476,2374749758,2450661234,179,569,2,2298838282,In > Out
Sept 2020,156,149,670,43369360,427890124,471259484,177,625,8,384520764,In > Out
Sept 2020,156,155,2073,334755523,1045388038,1380143561,64,1964,2,710632515,In > Out
Sept 2020,156,171,405,374668144,13987316584,14361984728,88,401,3,13612648440,In > Out
Sept 2020,156,188,1425,435655559,5027530978,5463186537,116,1367,2,4591875419,In > Out
Sept 2020,156,195,64,9773333,232713812,242487145,36,64,1,222940479,In > Out
Sept 2020,156,208,295,48330150,2419660807,2467990957,72,295,2,2371330657,In > Out
Sept 2020,156,210,196,97841811,3627906141,3725747952,25,196,2,3530064330,In > Out
Sept 2020,156,213,846,211476606,3808099279,4019575885,124,828,2,3596622673,In > Out
Sept 2020,156,216,311,90376436,3362087286,3452463722,88,310,2,3271710850,In > Out
Sept 2020,156,225,4519,644050438,6064069412,6708119850,219,4002,2,5420018974,In > Out
Sept 2020,156,238,367,65714331,4302552652,4368266983,26,367,2,4236838321,In > Out
Sept 2020,156,243,533,113004238,3400956427,3513960665,61,525,3,3287952189,In > Out
Sept 2020,156,250,5895,1840048901,18792862865,20632911766,986,5056,9,16952813964,In > Out
Sept 2020,159,105,154,59389256,3311927262,3371316518,73,154,2,3252538006,In > Out
Sept 2020,159,14,424,84440701,583524955,667965656,82,422,2,499084254,In > Out
Sept 2020,159,145,1068,584816675,5171781529,5756598204,151,1053,2,4586964854,In > Out
Sept 2020,159,161,872,122399919,5153889380,5276289299,30,872,2,5031489461,In > Out
Sept 2020,159,171,165,7470582,431594774,439065356,20,165,2,424124192,In > Out
Sept 2020,159,201,166,8288530,2179740778,2188029308,37,165,2,2171452248,In > Out
Sept 2020,159,217,78,67552493,3174668026,3242220519,23,78,2,3107115533,In > Out
Sept 2020,159,229,356,59022915,4087934602,4146957517,33,344,2,4028911687,In > Out
Sept 2020,159,239,134,70012023,3139380926,3209392949,25,134,2,3069368903,In > Out
Sept 2020,159,248,2578,2250176940,34827473670,37077650610,408,2477,8,32577296730,In > Out
Sept 2020,159,251,259,7537756,788130749,795668505,34,259,2,780592993,In > Out
Sept 2020,159,30,398,55391816,3815889003,3871280819,29,398,2,3760497187,In > Out
Sept 2020,159,34,283,118634512,3948104281,4066738793,29,283,2,3829469769,In > Out
Sept 2020,159,42,1,27738,2815222,2842960,1,1,1,2787484,In > Out
Sept 2020,16,10,459,48435251,2199256290,2247691541,74,451,3,2150821039,In > Out
Sept 2020,16,12,5694,574658349,18112007855,18686666204,699,4846,19,17537349506,In > Out
Sept 2020,16,14,30958,42791521218,94569035491,137360556709,1351,15890,15,51777514273,In > Out
Sept 2020,16,16,10461,420174514,24449611123,24869785637,199,7906,3,24029436609,In > Out
Sept 2020,16,19,1134,150044731,357615765,507660496,35,1101,2,207571034,In > Out
Sept 2020,16,2,955,205363952,19104609478,19309973430,88,931,2,18899245526,In > Out
Sept 2020,16,20,13331,2401455442,50340701325,52742156767,554,11239,26,47939245883,In > Out
Sept 2020,16,240,3340,1132080212,23523968337,24656048549,430,3114,6,22391888125,In > Out
Sept 2020,16,4,95,30821354,1062117799,1092939153,50,95,2,1031296445,In > Out
Sept 2020,16,7,8744,313760971,11826905946,12140666917,154,6787,3,11513144975,In > Out
Sept 2020,160,10,494,27407461,606367617,633775078,100,479,4,578960156,In > Out
Sept 2020,160,105,2606,894861253,2610547168,3505408421,168,2507,3,1715685915,In > Out
Sept 2020,160,106,5341,2979250762,25341724391,28320975153,175,4791,3,22362473629,In > Out
Sept 2020,160,107,12980,355704268,4252966941,4608671209,139,11589,3,3897262673,In > Out
Sept 2020,160,108,1564,178706191,31702858837,31881565028,122,1500,2,31524152646,In > Out
Sept 2020,160,109,1778,3459254166,99849678547,103308932713,197,1705,5,96390424381,In > Out
Sept 2020,160,11,4373,206655975,2250416355,2457072330,110,4192,2,2043760380,In > Out
Sept 2020,160,110,3410,1464843986,8529701172,9994545158,180,3135,5,7064857186,In > Out
Sept 2020,160,111,2794,1279793912,46371103039,47650896951,147,2618,4,45091309127,In > Out
Sept 2020,160,112,426,43882256,1545331325,1589213581,89,420,2,1501449069,In > Out
Sept 2020,160,12,548,162558017,8847959347,9010517364,87,533,2,8685401330,In > Out
Sept 2020,160,121,305359,198446327699,1551915408658,1750361736357,8565,20709,182,1353469080959,In > Out
Sept 2020,160,122,279434,177662140067,1646429545036,1824091685103,8681,18481,579,1468767404969,In > Out
Sept 2020,160,123,313984,246531016740,2008721630321,2255252647061,9155,19917,97,1762190613581,In > Out
Sept 2020,160,124,304754,271431930182,1648849171393,1920281101575,8442,21768,154,1377417241211,In > Out
Sept 2020,160,125,292629,137665851101,1697751353369,1835417204470,7717,17636,159,1560085502268,In > Out
Sept 2020,160,126,282275,148359954648,1693515434070,1841875388718,8041,17098,110,1545155479422,In > Out
Sept 2020,160,127,297997,211930466561,1628252541323,1840183007884,8502,19160,190,1416322074762,In > Out
Sept 2020,160,128,55974,63557712138,283797187262,347354899400,5285,16836,48,220239475124,In > Out
Sept 2020,160,13,3872,321628066,5883273592,6204901658,186,2638,3,5561645526,In > Out
Sept 2020,160,130,264,18241642,1384371656,1402613298,55,240,2,1366130014,In > Out
Sept 2020,160,132,73943,13777525393,456577522496,470355047889,948,16267,8,442799997103,In > Out
Sept 2020,160,14,13382,1920584360,8175008280,10095592640,69,8745,2,6254423920,In > Out
Sept 2020,160,144,456,36975730,5748474972,5785450702,145,449,3,5711499242,In > Out
Sept 2020,160,15,423,17721361,3882481467,3900202828,48,416,3,3864760106,In > Out
Sept 2020,160,152,338,437375763,1501211263,1938587026,55,330,33,1063835500,In > Out
Sept 2020,160,153,429,769404436,2825748274,3595152710,78,419,60,2056343838,In > Out
Sept 2020,160,154,288,333094377,1483512920,1816607297,47,285,28,1150418543,In > Out
Sept 2020,160,155,683,1246329046,5513734735,6760063781,109,667,87,4267405689,In > Out
Sept 2020,160,156,389,833356697,2974452066,3807808763,84,386,55,2141095369,In > Out
Sept 2020,160,157,590,595111457,3003622743,3598734200,74,578,52,2408511286,In > Out
Sept 2020,160,16,1119,37991780,5013631309,5051623089,80,670,3,4975639529,In > Out
Sept 2020,160,196,447035,633488752954,2134144536434,2767633289388,22209,24467,772,1500655783480,In > Out
Sept 2020,160,197,471102,558480232708,2251177009901,2809657242609,22460,25865,677,1692696777193,In > Out
Sept 2020,160,198,476619,566982171652,2292013190695,2858995362347,23011,24272,1004,1725031019043,In > Out
Sept 2020,160,199,461670,621621966874,2266045966054,2887667932928,22095,23875,608,1644423999180,In > Out
Sept 2020,160,200,168000,147358491219,592258495500,739616986719,10563,19329,530,444900004281,In > Out
Sept 2020,160,201,145970,152897739251,541797280962,694695020213,9704,18209,379,388899541711,In > Out
Sept 2020,160,202,168449,147663406801,602563873563,750227280364,10707,18743,410,454900466762,In > Out
Sept 2020,160,203,156390,174270376968,599547438629,773817815597,9902,19639,247,425277061661,In > Out
Sept 2020,160,216,17919,23068372685,176874851530,199943224215,41,15350,3,153806478845,In > Out
Sept 2020,160,236,112,7822001,126472905,134294906,6,111,3,118650904,In > Out
Sept 2020,160,237,230,21740039,3433776387,3455516426,59,228,2,3412036348,In > Out
Sept 2020,160,238,10053,2801073487,64156916027,66957989514,365,7628,3,61355842540,In > Out
Sept 2020,160,239,11549,9422956387,42644298565,52067254952,1930,8620,25,33221342178,In > Out
Sept 2020,160,240,17415,15841810095,76627816882,92469626977,2462,11606,31,60786006787,In > Out
Sept 2020,160,241,15567,6837385048,52697398273,59534783321,2162,10946,34,45860013225,In > Out
Sept 2020,160,242,14619,13204158384,78430825143,91634983527,2626,11374,129,65226666759,In > Out
Sept 2020,160,243,16706,6897242151,66083479729,72980721880,2583,11492,29,59186237578,In > Out
Sept 2020,160,244,15021,20600813487,248901905768,269502719255,2450,10335,60,228301092281,In > Out
Sept 2020,160,245,77779,9565294843,179550786113,189116080956,2403,17077,28,169985491270,In > Out
Sept 2020,160,246,10287,11665910716,43119277310,54785188026,1893,7874,23,31453366594,In > Out
Sept 2020,160,247,9626,6860777101,33551358911,40412136012,1722,7582,61,26690581810,In > Out
Sept 2020,160,249,394,1087726972,3849608051,4937335023,122,392,5,2761881079,In > Out
Sept 2020,160,33,2619,298878563,3916263466,4215142029,391,2442,11,3617384903,In > Out
Sept 2020,160,34,4160,428886447,25838125014,26267011461,471,3744,6,25409238567,In > Out
Sept 2020,160,35,219,223810149,429337848,653147997,41,218,2,205527699,In > Out
Sept 2020,160,36,9564,2248640058,5489880768,7738520826,199,6552,4,3241240710,In > Out
Sept 2020,160,37,2187,400711020,17110326081,17511037101,274,2051,5,16709615061,In > Out
Sept 2020,160,38,1565,396462142,6265375791,6661837933,335,1471,3,5868913649,In > Out
Sept 2020,160,39,9474,2883799786,2819832083,5703631869,322,5594,4,63967703,Out > In
Sept 2020,160,40,475,8026791335,881571360,8908362695,69,472,12,7145219975,Out > In
Sept 2020,160,57,6834,1903151014,37886925213,39790076227,934,5540,6,35983774199,In > Out
Sept 2020,160,58,6290,549330511883,29476388660,578806900543,699,5386,8,519854123223,Out > In
Sept 2020,160,59,7731,3519806982,72797913448,76317720430,637,6576,5,69278106466,In > Out
Sept 2020,160,60,5693,1459557874,20431861285,21891419159,572,5046,9,18972303411,In > Out
Sept 2020,160,61,8250,8146997256,44235565744,52382563000,2311,6534,9,36088568488,In > Out
Sept 2020,160,62,11275,4947493420,55989716781,60937210201,1170,8547,8,51042223361,In > Out
Sept 2020,160,63,12834,50942506508,124134903068,175077409576,1160,9889,11,73192396560,In > Out
Sept 2020,160,65,32422,38200725344,139593990341,177794715685,1968,15012,10,101393264997,In > Out
Sept 2020,160,66,54712,75948563655,317183392962,393131956617,2889,18329,53,241234829307,In > Out
Sept 2020,160,67,45607,22408830930,215666222577,238075053507,3051,18755,40,193257391647,In > Out
Sept 2020,160,68,37251,27915973236,221686836501,249602809737,2581,15206,55,193770863265,In > Out
Sept 2020,160,69,59226,45678933110,307568462096,353247395206,3139,19422,33,261889528986,In > Out
Sept 2020,160,70,31484,10892061234,205170280323,216062341557,2030,15326,32,194278219089,In > Out
Sept 2020,160,71,40862,18476923604,183803562379,202280485983,2648,17177,25,165326638775,In > Out
Sept 2020,160,72,57612,40076957462,311178731733,351255689195,3236,18842,348,271101774271,In > Out
Sept 2020,160,73,12522,2304608634,121035984989,123340593623,368,8912,4,118731376355,In > Out
Sept 2020,160,74,7963,830091235,90743299321,91573390556,135,6317,2,89913208086,In > Out
Sept 2020,160,75,10559,1420715257,101971029889,103391745146,223,8439,4,100550314632,In > Out
Sept 2020,160,76,10692,695821633,116420793589,117116615222,412,7864,9,115724971956,In > Out
Sept 2020,160,77,8512,672798984,90457031599,91129830583,207,6609,3,89784232615,In > Out
Sept 2020,160,78,9651,739179820,111186645059,111925824879,381,7375,2,110447465239,In > Out
Sept 2020,160,79,27067,1762394850,83404370986,85166765836,766,11899,3,81641976136,In > Out
Sept 2020,160,80,24813,1866118523,89474272359,91340390882,607,11238,3,87608153836,In > Out
Sept 2020,160,81,2955,734774073,5967699579,6702473652,459,2710,5,5232925506,In > Out
Sept 2020,160,83,1911,355897995,1683792442,2039690437,206,1821,2,1327894447,In > Out
Sept 2020,160,84,1106,141925394,1296906855,1438832249,182,1079,2,1154981461,In > Out
Sept 2020,160,86,1868,198075468,2696913856,2894989324,160,1773,2,2498838388,In > Out
Sept 2020,160,87,1614,250907809,4795151229,5046059038,153,1542,2,4544243420,In > Out
Sept 2020,160,9,3317,219976197,912177940,1132154137,57,3180,2,692201743,In > Out
Sept 2020,161,10,1015,153331069,3260609776,3413940845,157,1006,7,3107278707,In > Out
Sept 2020,161,100,1585,4823310791,25481304001,30304614792,376,1517,13,20657993210,In > Out
Sept 2020,161,102,6,145195,5081197,5226392,5,6,1,4936002,In > Out
Sept 2020,161,103,260,154929441,9852175347,10007104788,127,258,5,9697245906,In > Out
Sept 2020,161,105,464,62891851,1779143142,1842034993,110,463,3,1716251291,In > Out
Sept 2020,161,107,498,104931332,1929852361,2034783693,165,497,7,1824921029,In > Out
Sept 2020,161,109,425,73269568,4352347029,4425616597,205,422,6,4279077461,In > Out
Sept 2020,161,11,98,9878253,82579723,92457976,70,98,3,72701470,In > Out
Sept 2020,161,110,1303,8346889293,5264551253,13611440546,214,1230,8,3082338040,Out > In
Sept 2020,161,111,1344,1962593994,3169725482,5132319476,227,1319,26,1207131488,In > Out
Sept 2020,161,112,1363,549766774,4456072125,5005838899,290,1334,6,3906305351,In > Out
Sept 2020,161,113,100,49441017,413800594,463241611,44,100,3,364359577,In > Out
Sept 2020,161,115,581,391473629,4006579820,4398053449,240,580,8,3615106191,In > Out
Sept 2020,161,116,844,186790759,2058854328,2245645087,143,822,5,1872063569,In > Out
Sept 2020,161,117,1278,412009452,4054238096,4466247548,295,1235,11,3642228644,In > Out
Sept 2020,161,118,625,105912818,2332625638,2438538456,145,618,5,2226712820,In > Out
Sept 2020,161,119,1261,1407988474,59568673250,60976661724,218,1261,5,58160684776,In > Out
Sept 2020,161,121,1667,215206539,6791337260,7006543799,298,1603,4,6576130721,In > Out
Sept 2020,161,124,713,447934454,3067393077,3515327531,216,713,4,2619458623,In > Out
Sept 2020,161,127,297,49363763,1892131542,1941495305,120,297,3,1842767779,In > Out
Sept 2020,161,129,380,150781729,8151335902,8302117631,115,380,1,8000554173,In > Out
Sept 2020,161,13,883,361862394,6483203277,6845065671,271,822,12,6121340883,In > Out
Sept 2020,161,130,1027,242704788,4006714567,4249419355,328,936,106,3764009779,In > Out
Sept 2020,161,132,742,71325869,2544401593,2615727462,244,736,9,2473075724,In > Out
Sept 2020,161,133,486,183546494,2152636133,2336182627,188,483,9,1969089639,In > Out
Sept 2020,161,135,526,87105866,1940918059,2028023925,184,522,3,1853812193,In > Out
Sept 2020,161,138,1827,528582169,16377341665,16905923834,425,1751,7,15848759496,In > Out
Sept 2020,161,139,1344,334922164,12454052891,12788975055,450,1312,9,12119130727,In > Out
Sept 2020,161,14,807,174313066,7244783118,7419096184,331,796,6,7070470052,In > Out
Sept 2020,161,141,951,2495472231,5950717210,8446189441,257,933,9,3455244979,In > Out
Sept 2020,161,142,775,620301357,8684184524,9304485881,247,765,3,8063883167,In > Out
Sept 2020,161,144,304,126422854,1796271656,1922694510,118,303,4,1669848802,In > Out
Sept 2020,161,145,478,521052109,12708642852,13229694961,184,476,10,12187590743,In > Out
Sept 2020,161,147,74,70767877,2567285701,2638053578,29,74,3,2496517824,In > Out
Sept 2020,161,148,61,8178058,356228115,364406173,32,61,3,348050057,In > Out
Sept 2020,161,151,1443,1558356649,7326159664,8884516313,341,1404,8,5767803015,In > Out
Sept 2020,161,152,750,266096732,1176593108,1442689840,283,744,5,910496376,In > Out
Sept 2020,161,153,1483,227761148,6308058626,6535819774,333,1443,11,6080297478,In > Out
Sept 2020,161,157,1590,1929250128,7095747396,9024997524,420,1523,7,5166497268,In > Out
Sept 2020,161,159,177,20287881,1517033665,1537321546,100,177,3,1496745784,In > Out
Sept 2020,161,16,220,33867527,853340013,887207540,117,220,4,819472486,In > Out
Sept 2020,161,160,391,515519927,5899794789,6415314716,145,387,7,5384274862,In > Out
Sept 2020,161,161,191,53461833,3225042487,3278504320,90,191,4,3171580654,In > Out
Sept 2020,161,162,853,520396134,6620490183,7140886317,302,837,6,6100094049,In > Out
Sept 2020,161,165,988,209483854,14567845632,14777329486,339,964,6,14358361778,In > Out
Sept 2020,161,166,163,453078745,335153819,788232564,81,161,6,117924926,Out > In
Sept 2020,161,167,297,40738715,1074870102,1115608817,96,287,4,1034131387,In > Out
Sept 2020,161,168,1299,152546864,9376060416,9528607280,310,1220,5,9223513552,In > Out
Sept 2020,161,169,869,154797919,6561852212,6716650131,209,853,7,6407054293,In > Out
Sept 2020,161,17,69,21764254,4191763754,4213528008,32,69,3,4169999500,In > Out
Sept 2020,161,171,1264,233803906,21463310050,21697113956,155,1201,4,21229506144,In > Out
Sept 2020,161,173,5,224602,4062982,4287584,4,5,2,3838380,In > Out
Sept 2020,161,174,724,4939724032,5452946860,10392670892,204,710,7,513222828,In > Out
Sept 2020,161,176,893,338332763,8827787518,9166120281,262,874,7,8489454755,In > Out
Sept 2020,161,177,228,923952069,1479788207,2403740276,92,225,6,555836138,In > Out
Sept 2020,161,178,267,21056113,597609471,618665584,58,266,4,576553358,In > Out
Sept 2020,161,18,74,10610232,118475875,129086107,16,74,2,107865643,In > Out
Sept 2020,161,180,687,249626831,6331442702,6581069533,200,684,6,6081815871,In > Out
Sept 2020,161,181,718,316152473,2116849819,2433002292,164,701,7,1800697346,In > Out
Sept 2020,161,182,944,884742436,3138833613,4023576049,335,923,15,2254091177,In > Out
Sept 2020,161,183,426,55543521,3851368920,3906912441,119,420,4,3795825399,In > Out
Sept 2020,161,184,194,619023227,549510605,1168533832,84,194,3,69512622,Out > In
Sept 2020,161,186,865,1823308728,4647772218,6471080946,209,852,9,2824463490,In > Out
Sept 2020,161,187,246,114927333,793279994,908207327,161,246,2,678352661,In > Out
Sept 2020,161,188,341,52809575,1746912139,1799721714,85,339,4,1694102564,In > Out
Sept 2020,161,189,316,56647700,648470531,705118231,118,316,5,591822831,In > Out
Sept 2020,161,190,2636,534510175,9298261087,9832771262,481,2473,8,8763750912,In > Out
Sept 2020,161,192,715,347415741,2382868750,2730284491,183,715,6,2035453009,In > Out
Sept 2020,161,193,119,8065190,289723693,297788883,42,119,1,281658503,In > Out
Sept 2020,161,194,420,38532713,527809748,566342461,100,415,4,489277035,In > Out
Sept 2020,161,195,4128,95716347,7011836370,7107552717,185,4100,7,6916120023,In > Out
Sept 2020,161,196,333,152879542,9362677097,9515556639,123,322,5,9209797555,In > Out
Sept 2020,161,197,696,174449079,2820496159,2994945238,237,693,5,2646047080,In > Out
Sept 2020,161,198,507,4603093260,6223132388,10826225648,205,501,6,1620039128,In > Out
Sept 2020,161,20,29,6740228,160158628,166898856,17,29,1,153418400,In > Out
Sept 2020,161,200,344,108728791,1217988078,1326716869,98,339,4,1109259287,In > Out
Sept 2020,161,201,61,11219102,444900736,456119838,34,61,3,433681634,In > Out
Sept 2020,161,202,871,514528865,5892313754,6406842619,190,856,13,5377784889,In > Out
Sept 2020,161,203,18,1442006,35778534,37220540,15,18,2,34336528,In > Out
Sept 2020,161,204,68,26479094,995389909,1021869003,37,68,3,968910815,In > Out
Sept 2020,161,206,377,92394683,3347007730,3439402413,133,373,13,3254613047,In > Out
Sept 2020,161,208,807,136758704,4808554262,4945312966,271,788,5,4671795558,In > Out
Sept 2020,161,209,261,140733047,11344233390,11484966437,104,259,4,11203500343,In > Out
Sept 2020,161,21,478,732706720,4412451855,5145158575,137,469,5,3679745135,In > Out
Sept 2020,161,210,457,79356898,2320750929,2400107827,185,457,4,2241394031,In > Out
Sept 2020,161,211,510,94555312,1762461037,1857016349,173,508,13,1667905725,In > Out
Sept 2020,161,212,340,242266563,1097281916,1339548479,116,334,11,855015353,In > Out
Sept 2020,161,213,45,8646493,337539328,346185821,25,45,2,328892835,In > Out
Sept 2020,161,215,345,579189094,10478353508,11057542602,159,341,4,9899164414,In > Out
Sept 2020,161,216,551,1082348381,2262123234,3344471615,204,544,5,1179774853,In > Out
Sept 2020,161,217,509,151218036,10083126558,10234344594,107,508,3,9931908522,In > Out
Sept 2020,161,220,474,56245504,1500485083,1556730587,185,454,5,1444239579,In > Out
Sept 2020,161,221,364,57345902,2512694009,2570039911,128,363,5,2455348107,In > Out
Sept 2020,161,24,136,34930170,1750357790,1785287960,30,135,2,1715427620,In > Out
Sept 2020,161,25,381,46776938,1873609821,1920386759,152,381,7,1826832883,In > Out
Sept 2020,161,26,632,99508444,3698821225,3798329669,222,630,4,3599312781,In > Out
Sept 2020,161,27,722,227917344,2908248085,3136165429,191,713,6,2680330741,In > Out
Sept 2020,161,28,1468,724263179,9974144529,10698407708,397,1420,5,9249881350,In > Out
Sept 2020,161,30,608,175457091,6481879230,6657336321,240,591,4,6306422139,In > Out
Sept 2020,161,31,232,63499860,657963677,721463537,87,232,4,594463817,In > Out
Sept 2020,161,32,467,82055003,2788484922,2870539925,181,467,5,2706429919,In > Out
Sept 2020,161,33,480,252546409,17784230114,18036776523,140,480,3,17531683705,In > Out
Sept 2020,161,34,909,259462597,5955968841,6215431438,213,893,7,5696506244,In > Out
Sept 2020,161,35,4449,1721510051,28413016204,30134526255,791,3932,7,26691506153,In > Out
Sept 2020,161,36,80,5826445,368064135,373890580,39,80,1,362237690,In > Out
Sept 2020,161,37,492,62652779,2326535331,2389188110,167,491,4,2263882552,In > Out
Sept 2020,161,38,453,154670070,2774113056,2928783126,139,451,5,2619442986,In > Out
Sept 2020,161,39,456,155645746,3077711339,3233357085,186,453,18,2922065593,In > Out
Sept 2020,161,4,1827,763707281,46703129511,47466836792,381,1750,6,45939422230,In > Out
Sept 2020,161,40,240,610050611,31264128543,31874179154,38,223,4,30654077932,In > Out
Sept 2020,161,42,185,32279215,571530569,603809784,96,183,4,539251354,In > Out
Sept 2020,161,43,789,541436986,2910653649,3452090635,219,774,6,2369216663,In > Out
Sept 2020,161,44,1001,704692774,4936541355,5641234129,245,993,7,4231848581,In > Out
Sept 2020,161,46,687,68200776,1951470301,2019671077,208,678,9,1883269525,In > Out
Sept 2020,161,47,1660,1280314261,19776213726,21056527987,302,1604,14,18495899465,In > Out
Sept 2020,161,49,221,66993554,1504355155,1571348709,86,220,7,1437361601,In > Out
Sept 2020,161,5,171,21259566,759157375,780416941,74,171,3,737897809,In > Out
Sept 2020,161,50,129,198838868,298011003,496849871,58,129,3,99172135,In > Out
Sept 2020,161,51,747,216567739,1249773722,1466341461,200,730,9,1033205983,In > Out
Sept 2020,161,52,519,215069172,4261141015,4476210187,177,506,4,4046071843,In > Out
Sept 2020,161,53,218,24923137,874007077,898930214,117,218,2,849083940,In > Out
Sept 2020,161,54,1021,280721402,6841332312,7122053714,168,964,8,6560610910,In > Out
Sept 2020,161,55,295,31888847,785303715,817192562,145,295,5,753414868,In > Out
Sept 2020,161,56,542,132974810,9198891341,9331866151,209,538,8,9065916531,In > Out
Sept 2020,161,57,1185,1026688740,5484916111,6511604851,228,1159,6,4458227371,In > Out
Sept 2020,161,58,1354,252468346,8859606641,9112074987,410,1287,8,8607138295,In > Out
Sept 2020,161,6,194,32046369,804633293,836679662,85,190,3,772586924,In > Out
Sept 2020,161,60,126,19662106,1570463569,1590125675,65,126,2,1550801463,In > Out
Sept 2020,161,62,175,75568124,427931754,503499878,69,174,3,352363630,In > Out
Sept 2020,161,63,611,391322015,1093499230,1484821245,198,594,20,702177215,In > Out
Sept 2020,161,64,524,118044247,5546850557,5664894804,135,515,7,5428806310,In > Out
Sept 2020,161,65,664,349044454,3096977441,3446021895,227,655,10,2747932987,In > Out
Sept 2020,161,66,117,30201438,2163320046,2193521484,57,117,3,2133118608,In > Out
Sept 2020,161,67,810,1683370707,3535766237,5219136944,271,804,6,1852395530,In > Out
Sept 2020,161,68,210,3622907683,1227601817,4850509500,76,208,4,2395305866,Out > In
Sept 2020,161,69,367,110626421,4430393787,4541020208,111,363,1,4319767366,In > Out
Sept 2020,161,7,398,223254236,2550191863,2773446099,139,398,4,2326937627,In > Out
Sept 2020,161,70,824,241697747,20801032903,21042730650,27,824,5,20559335156,In > Out
Sept 2020,161,72,351,559033592,2536315608,3095349200,165,351,5,1977282016,In > Out
Sept 2020,161,74,942,241617216,7328607574,7570224790,295,927,7,7086990358,In > Out
Sept 2020,161,75,249,46879073,1924727158,1971606231,127,246,4,1877848085,In > Out
Sept 2020,161,76,809,734966235,8492412275,9227378510,296,803,5,7757446040,In > Out
Sept 2020,161,77,117,22176113,1826288342,1848464455,39,117,4,1804112229,In > Out
Sept 2020,161,78,202,27864878,1031272983,1059137861,79,202,3,1003408105,In > Out
Sept 2020,161,8,811,23227779,902893702,926121481,101,808,2,879665923,In > Out
Sept 2020,161,80,34,4705830,16462503,21168333,24,34,2,11756673,In > Out
Sept 2020,161,82,1471,268677541,7393319396,7661996937,358,1400,6,7124641855,In > Out
Sept 2020,161,83,527,189905505,8431336457,8621241962,107,522,4,8241430952,In > Out
Sept 2020,161,84,306,56345607,1470521976,1526867583,132,305,5,1414176369,In > Out
Sept 2020,161,86,362,40461321,1262261298,1302722619,118,358,8,1221799977,In > Out
Sept 2020,161,87,1131,348539726,9155307275,9503847001,176,1045,6,8806767549,In > Out
Sept 2020,161,88,325,38813175,2978317973,3017131148,113,323,4,2939504798,In > Out
Sept 2020,161,90,1770,566618793,3873842084,4440460877,394,1690,7,3307223291,In > Out
Sept 2020,161,91,589,198229267,8808415171,9006644438,223,584,3,8610185904,In > Out
Sept 2020,161,94,302,239182320,689648189,928830509,127,301,3,450465869,In > Out
Sept 2020,161,95,1196,836771324,4658265128,5495036452,258,1018,25,3821493804,In > Out
Sept 2020,161,96,139,10001297,464790398,474791695,59,139,3,454789101,In > Out
Sept 2020,161,97,361,172879416,2712537877,2885417293,120,359,6,2539658461,In > Out
Sept 2020,161,99,529,29139157,1107646724,1136785881,159,529,3,1078507567,In > Out
Sept 2020,163,4,2,88786,1871240,1960026,1,2,1,1782454,In > Out
Sept 2020,164,126,233,217958166,180334978,398293144,116,233,2,37623188,Out > In
Sept 2020,164,127,373,66233235,7963979641,8030212876,56,370,2,7897746406,In > Out
Sept 2020,164,138,31,2220238,8501463,10721701,4,31,1,6281225,In > Out
Sept 2020,164,141,411,15413600,181381849,196795449,117,408,3,165968249,In > Out
Sept 2020,164,147,52,2342696,88992676,91335372,18,52,2,86649980,In > Out
Sept 2020,164,158,1689,135821561,4507174067,4642995628,256,1616,3,4371352506,In > Out
Sept 2020,164,159,1165,267703819,3753688967,4021392786,139,1128,2,3485985148,In > Out
Sept 2020,164,165,276,100747588,6999215208,7099962796,49,275,2,6898467620,In > Out
Sept 2020,164,166,72,12398762,443015291,455414053,42,72,2,430616529,In > Out
Sept 2020,164,188,211,15373621,143665467,159039088,106,208,2,128291846,In > Out
Sept 2020,164,196,1475,612483235,6117070323,6729553558,320,1417,4,5504587088,In > Out
Sept 2020,164,60,208,4000378,1073176641,1077177019,37,207,2,1069176263,In > Out
Sept 2020,164,77,28,560532,35014957,35575489,7,28,2,34454425,In > Out
Sept 2020,164,82,34,183837054,421666857,605503911,3,34,2,237829803,In > Out
Sept 2020,164,83,57,501510212,84569131,586079343,32,15,28,416941081,Out > In
Sept 2020,164,96,213,24393087,285592381,309985468,29,211,2,261199294,In > Out
Sept 2020,165,106,2053,422503288,10280124965,10702628253,148,1954,2,9857621677,In > Out
Sept 2020,165,108,3655,737231322,16240148200,16977379522,796,3328,7,15502916878,In > Out
Sept 2020,165,123,150,181749149,12126594873,12308344022,36,148,2,11944845724,In > Out
Sept 2020,165,131,51,9969367,953996324,963965691,10,51,2,944026957,In > Out
Sept 2020,165,137,1021,219959441,938366264,1158325705,52,995,4,718406823,In > Out
Sept 2020,165,142,410,555812778,4301645865,4857458643,91,406,2,3745833087,In > Out
Sept 2020,165,152,261,87787754,982550975,1070338729,130,259,8,894763221,In > Out
Sept 2020,165,157,755,100016392,2673478569,2773494961,107,726,2,2573462177,In > Out
Sept 2020,165,165,14709,5325014241,42042101864,47367116105,1583,9661,7,36717087623,In > Out
Sept 2020,165,176,17,540808,2426698,2967506,10,17,1,1885890,In > Out
Sept 2020,165,187,385,67886010,3653460804,3721346814,72,381,2,3585574794,In > Out
Sept 2020,165,198,1866,375045385,3938894480,4313939865,100,1763,2,3563849095,In > Out
Sept 2020,165,199,1785,404038240,722339977,1126378217,68,1706,4,318301737,In > Out
Sept 2020,165,202,5360,1724069777,25998167437,27722237214,1030,4727,7,24274097660,In > Out
Sept 2020,165,233,474,4072420939,8092477926,12164898865,124,307,113,4020056987,In > Out
Sept 2020,165,234,261,24990096,554958698,579948794,141,260,2,529968602,In > Out
Sept 2020,165,235,251,91183854,4332655147,4423839001,68,251,2,4241471293,In > Out
Sept 2020,165,25,1,26010,744350,770360,1,1,1,718340,In > Out
Sept 2020,165,31,2,215059,88425,303484,2,1,2,126634,Out > In
Sept 2020,165,43,1076,2076644880,7128062803,9204707683,277,1038,5,5051417923,In > Out
Sept 2020,165,61,2209,654975339,5915483181,6570458520,118,2080,3,5260507842,In > Out
Sept 2020,165,67,460,46804783,4664775353,4711580136,39,460,2,4617970570,In > Out
Sept 2020,165,93,189,443558207,3215035592,3658593799,76,189,3,2771477385,In > Out
Sept 2020,165,94,34,1664261,52461602,54125863,8,34,2,50797341,In > Out
Sept 2020,166,131,213,81790296,3476318606,3558108902,24,213,2,3394528310,In > Out
Sept 2020,166,135,222,28303762,625489687,653793449,30,220,2,597185925,In > Out
Sept 2020,166,137,372,22786032,1364941780,1387727812,26,372,2,1342155748,In > Out
Sept 2020,166,138,1310,492168402,7855743258,8347911660,215,1309,4,7363574856,In > Out
Sept 2020,166,139,296,53716682,3727660531,3781377213,27,296,2,3673943849,In > Out
Sept 2020,166,146,322,63912741,3925701739,3989614480,28,322,2,3861788998,In > Out
Sept 2020,166,153,131,103462755,377091834,480554589,27,127,2,273629079,In > Out
Sept 2020,166,162,272,14475858,3423853449,3438329307,25,272,2,3409377591,In > Out
Sept 2020,166,165,255,83430593,3188684824,3272115417,26,255,2,3105254231,In > Out
Sept 2020,166,170,249,48760384,231674016,280434400,119,249,2,182913632,In > Out
Sept 2020,166,178,300,122456664,254556853,377013517,125,300,2,132100189,In > Out
Sept 2020,166,192,163,61014596,3147141260,3208155856,55,163,2,3086126664,In > Out
Sept 2020,166,193,308,6818521,3201967560,3208786081,26,308,2,3195149039,In > Out
Sept 2020,166,24,326,65874358,4515965869,4581840227,31,308,2,4450091511,In > Out
Sept 2020,167,117,618,105661709,5305726960,5411388669,179,608,2,5200065251,In > Out
Sept 2020,167,118,3642,736990583,5130422734,5867413317,200,3314,2,4393432151,In > Out
Sept 2020,167,121,163,48174509,3489496749,3537671258,34,163,2,3441322240,In > Out
Sept 2020,167,124,366,936217523,3280169935,4216387458,143,365,4,2343952412,In > Out
Sept 2020,167,127,949,359822083,8504701161,8864523244,287,923,2,8144879078,In > Out
Sept 2020,167,139,359,90432373,570699772,661132145,120,355,2,480267399,In > Out
Sept 2020,167,156,98,6971974,334850649,341822623,9,98,2,327878675,In > Out
Sept 2020,167,174,1095,128899992,4800113503,4929013495,270,1076,2,4671213511,In > Out
Sept 2020,167,177,102,3768267,11874669,15642936,12,102,2,8106402,In > Out
Sept 2020,167,186,42,3422462,54039374,57461836,24,42,3,50616912,In > Out
Sept 2020,167,19,410,47494822,785552113,833046935,103,400,2,738057291,In > Out
Sept 2020,167,203,1932,456353515,4431748832,4888102347,152,1828,2,3975395317,In > Out
Sept 2020,167,232,2396,202428059,5267773279,5470201338,446,2207,2,5065345220,In > Out
Sept 2020,167,26,854,232291145,1416400292,1648691437,215,829,2,1184109147,In > Out
Sept 2020,167,35,199,55570848,3705319838,3760890686,48,198,2,3649748990,In > Out
Sept 2020,168,103,75,8356539,65522905,73879444,23,75,2,57166366,In > Out
Sept 2020,168,105,397,48491819,918344386,966836205,99,393,2,869852567,In > Out
Sept 2020,168,111,1049,88969041,1216540236,1305509277,333,998,3,1127571195,In > Out
Sept 2020,168,114,159,93377463,3626463816,3719841279,27,159,2,3533086353,In > Out
Sept 2020,168,116,590,75014244,3967230477,4042244721,127,562,4,3892216233,In > Out
Sept 2020,168,122,31,231739,27216123,27447862,11,31,2,26984384,In > Out
Sept 2020,168,123,1118,226535702,2517803849,2744339551,330,1066,4,2291268147,In > Out
Sept 2020,168,132,111,5176609,308382378,313558987,26,111,2,303205769,In > Out
Sept 2020,168,136,1454,766378723,16672708326,17439087049,185,1421,3,15906329603,In > Out
Sept 2020,168,139,20,401514,4711459,5112973,6,20,1,4309945,In > Out
Sept 2020,168,153,33,9435609,514507897,523943506,10,33,3,505072288,In > Out
Sept 2020,168,154,196,931092145,3622654566,4553746711,32,196,2,2691562421,In > Out
Sept 2020,168,155,2030,9923399569,1331757774,11255157343,507,1541,218,8591641795,Out > In
Sept 2020,168,161,43,2345861,78328241,80674102,22,43,2,75982380,In > Out
Sept 2020,168,169,293,27869159,2324796393,2352665552,102,292,2,2296927234,In > Out
Sept 2020,168,176,19,7967763,156717835,164685598,14,19,2,148750072,In > Out
Sept 2020,168,179,74,10009170,31189619,41198789,23,74,2,21180449,In > Out
Sept 2020,168,185,182,100309782,3630351453,3730661235,26,179,2,3530041671,In > Out
Sept 2020,168,186,8,2684590,140648,2825238,6,1,8,2543942,Out > In
Sept 2020,168,187,8,160721,6419276,6579997,2,8,2,6258555,In > Out
Sept 2020,168,190,64,11849136,428008309,439857445,43,64,2,416159173,In > Out
Sept 2020,168,195,145,100017355,3466196123,3566213478,24,145,2,3366178768,In > Out
Sept 2020,168,201,519,134596686,55050478424,55185075110,25,519,2,54915881738,In > Out
Sept 2020,168,202,217,21539131,826459390,847998521,33,215,2,804920259,In > Out
Sept 2020,168,205,238,113541240,2992552063,3106093303,96,236,3,2879010823,In > Out
Sept 2020,168,209,1338,147159573,467339308,614498881,61,1282,1,320179735,In > Out
Sept 2020,168,219,168,172773369,554804987,727578356,75,168,3,382031618,In > Out
Sept 2020,168,222,64,12309598,3087596040,3099905638,18,64,1,3075286442,In > Out
Sept 2020,168,23,121,17853655,77770681,95624336,49,121,4,59917026,In > Out
Sept 2020,168,30,3,108960,4847585,4956545,3,3,1,4738625,In > Out
Sept 2020,168,42,2563,296530568,1542057440,1838588008,427,2425,2,1245526872,In > Out
Sept 2020,168,57,76,204280930,66791741,271072671,38,17,46,137489189,Out > In
Sept 2020,168,59,1832,2978899202,7045249205,10024148407,440,1779,8,4066350003,In > Out
Sept 2020,168,7,144,15917815,158873924,174791739,62,143,3,142956109,In > Out
Sept 2020,168,74,231,37452521,344358653,381811174,63,231,2,306906132,In > Out
Sept 2020,168,8,148,6797290,319617527,326414817,23,148,2,312820237,In > Out
Sept 2020,168,86,256,27552266,297040127,324592393,23,256,2,269487861,In > Out
Sept 2020,168,93,45,24043501798,445352738,24488854536,28,45,2,23598149060,Out > In
Sept 2020,169,156,80,3279727,232968522,236248249,17,80,2,229688795,In > Out
Sept 2020,169,157,337,17636603,526710576,544347179,52,334,2,509073973,In > Out
Sept 2020,169,163,265,47006909,3309619567,3356626476,23,265,2,3262612658,In > Out
Sept 2020,169,164,434,111467187,3433240754,3544707941,90,433,2,3321773567,In > Out
Sept 2020,169,168,1232,165131453,7738897044,7904028497,140,1201,5,7573765591,In > Out
Sept 2020,169,172,778,279298304,5052495768,5331794072,158,770,2,4773197464,In > Out
Sept 2020,169,174,2,239550,197810,437360,2,1,2,41740,Out > In
Sept 2020,169,187,325,459569211,7751394956,8210964167,129,325,3,7291825745,In > Out
Sept 2020,169,193,543,181021815,3828481047,4009502862,55,538,2,3647459232,In > Out
Sept 2020,169,194,1086,84922185882,876462244,85798648126,24,1079,1,84045723638,Out > In
Sept 2020,169,197,115,99321505,3191142502,3290464007,39,115,2,3091820997,In > Out
Sept 2020,169,6,7406,753897511490,6612033569,760509545059,933,7008,42,747285477921,Out > In
Sept 2020,169,8,30,63663098868,4007506779,67670605647,20,1,30,59655592089,Out > In
Sept 2020,170,112,68,65285178,2796910267,2862195445,19,67,2,2731625089,In > Out
Sept 2020,170,128,160,49188330,4740703608,4789891938,48,160,3,4691515278,In > Out
Sept 2020,170,129,107,155696191,192180615,347876806,64,105,3,36484424,In > Out
Sept 2020,170,13,780,154751202,2016522138,2171273340,104,779,3,1861770936,In > Out
Sept 2020,170,164,353,36398263,425558343,461956606,112,349,2,389160080,In > Out
Sept 2020,170,172,323,81922435,3481173137,3563095572,108,321,3,3399250702,In > Out
Sept 2020,170,187,1385,3140891641,6471701497,9612593138,393,1332,4,3330809856,In > Out
Sept 2020,170,19,23,877867,4407977,5285844,4,23,2,3530110,In > Out
Sept 2020,170,192,637,90572565,2822969255,2913541820,52,628,2,2732396690,In > Out
Sept 2020,170,194,3539,1502401190,14003043599,15505444789,629,3246,6,12500642409,In > Out
Sept 2020,170,197,1,10533,744798,755331,1,1,1,734265,In > Out
Sept 2020,170,198,119,4951491,45773368,50724859,21,119,2,40821877,In > Out
Sept 2020,170,208,190,163260674,2988287192,3151547866,26,190,2,2825026518,In > Out
Sept 2020,170,209,706,110236171,4699173520,4809409691,31,706,2,4588937349,In > Out
Sept 2020,170,227,12,35017415,41404661,76422076,7,12,2,6387246,In > Out
Sept 2020,170,229,3373,193656554,942030830,1135687384,171,3059,5,748374276,In > Out
Sept 2020,170,230,68,9393819,1056643628,1066037447,21,68,2,1047249809,In > Out
Sept 2020,170,232,1415,1619780798,5072150048,6691930846,257,1184,2,3452369250,In > Out
Sept 2020,170,234,93,4303157,11491309,15794466,9,93,2,7188152,In > Out
Sept 2020,170,236,552,68030388,122704454,190734842,46,551,2,54674066,In > Out
Sept 2020,170,242,408,4379355,1029646549,1034025904,23,408,2,1025267194,In > Out
Sept 2020,170,244,1145,104509971,518923766,623433737,56,1105,3,414413795,In > Out
Sept 2020,170,28,64,6199051,130265353,136464404,15,64,2,124066302,In > Out
Sept 2020,170,34,5,821525,30351760,31173285,3,5,2,29530235,In > Out
Sept 2020,170,37,98,3636387,13161918,16798305,13,98,2,9525531,In > Out
Sept 2020,170,42,3,104826,234444,339270,2,3,1,129618,In > Out
Sept 2020,170,45,722,437601005,6389984816,6827585821,274,662,7,5952383811,In > Out
Sept 2020,170,47,239,425843115,186879590001,187305433116,78,238,3,186453746886,In > Out
Sept 2020,170,51,473,23908243,1676024753,1699932996,94,341,2,1652116510,In > Out
Sept 2020,170,57,3861,1945512767,10252965577,12198478344,891,3489,14,8307452810,In > Out
Sept 2020,170,59,1796,88216926,211525250,299742176,1,1765,1,123308324,In > Out
Sept 2020,170,63,2822,260688084,2885692666,3146380750,653,2645,2,2625004582,In > Out
Sept 2020,170,66,178,13161497,196824144,209985641,83,178,2,183662647,In > Out
Sept 2020,170,67,126,17040611,166806165,183846776,36,103,2,149765554,In > Out
Sept 2020,170,68,289,178644409,6613805651,6792450060,28,288,2,6435161242,In > Out
Sept 2020,170,73,1128,232065771,3498434518,3730500289,117,1099,3,3266368747,In > Out
Sept 2020,171,10,632,95570752,2541220788,2636791540,153,629,8,2445650036,In > Out
Sept 2020,171,100,409,28139614,1606301582,1634441196,163,402,2,1578161968,In > Out
Sept 2020,171,101,1424,488865709,18599384224,19088249933,420,1399,34,18110518515,In > Out
Sept 2020,171,102,1357,192070481,5169957459,5362027940,343,1314,6,4977886978,In > Out
Sept 2020,171,103,902,99111727,2505394621,2604506348,220,883,8,2406282894,In > Out
Sept 2020,171,104,769,743904598,22433843711,23177748309,247,759,10,21689939113,In > Out
Sept 2020,171,105,1161,241194056,7042532709,7283726765,329,1135,6,6801338653,In > Out
Sept 2020,171,107,200,1299205721,5200315492,6499521213,105,200,5,3901109771,In > Out
Sept 2020,171,108,371,1554748523,6563660056,8118408579,182,369,5,5008911533,In > Out
Sept 2020,171,109,1702,522753388,10135854580,10658607968,409,1660,28,9613101192,In > Out
Sept 2020,171,112,737,177372284,7867552726,8044925010,177,729,8,7690180442,In > Out
Sept 2020,171,114,475,51459288,1839575988,1891035276,149,471,7,1788116700,In > Out
Sept 2020,171,115,737,190770665,4847788091,5038558756,219,730,10,4657017426,In > Out
Sept 2020,171,116,1860,1100256147,7260945430,8361201577,348,1823,14,6160689283,In > Out
Sept 2020,171,118,870,501005122,11632976142,12133981264,215,853,8,11131971020,In > Out
Sept 2020,171,119,68,15542648,329580906,345123554,21,68,1,314038258,In > Out
Sept 2020,171,120,347,136119050,1378337747,1514456797,154,346,4,1242218697,In > Out
Sept 2020,171,122,859,105115177,5939491420,6044606597,178,813,5,5834376243,In > Out
Sept 2020,171,123,962,224932255,6622136517,6847068772,170,946,4,6397204262,In > Out
Sept 2020,171,125,1136,1920495840,8257555167,10178051007,255,1117,7,6337059327,In > Out
Sept 2020,171,127,211,16110438,464310190,480420628,63,208,3,448199752,In > Out
Sept 2020,171,128,138,12540809,822929044,835469853,58,135,3,810388235,In > Out
Sept 2020,171,129,43,28210119,256373787,284583906,20,43,4,228163668,In > Out
Sept 2020,171,130,760,171776106,18548162137,18719938243,258,750,5,18376386031,In > Out
Sept 2020,171,131,1121,769253621,19745432133,20514685754,452,1110,8,18976178512,In > Out
Sept 2020,171,132,1044,180026810,4684087318,4864114128,133,1029,5,4504060508,In > Out
Sept 2020,171,133,67,19410049,123024423,142434472,26,67,2,103614374,In > Out
Sept 2020,171,134,523,123677951,3525287344,3648965295,147,520,5,3401609393,In > Out
Sept 2020,171,135,157,6573561,249556154,256129715,64,157,29,242982593,In > Out
Sept 2020,171,136,754,97097345,2017371819,2114469164,215,743,5,1920274474,In > Out
Sept 2020,171,137,1048,328361525,7571053400,7899414925,210,1039,12,7242691875,In > Out
Sept 2020,171,138,286,50675738,914506190,965181928,69,284,4,863830452,In > Out
Sept 2020,171,139,278,120767594,852139000,972906594,159,278,50,731371406,In > Out
Sept 2020,171,140,327,606343294,3213353710,3819697004,104,323,7,2607010416,In > Out
Sept 2020,171,141,557,106170042,4195736314,4301906356,214,557,4,4089566272,In > Out
Sept 2020,171,142,430,373992364,2792860978,3166853342,153,427,10,2418868614,In > Out
Sept 2020,171,143,659,272385850,4868034279,5140420129,112,638,4,4595648429,In > Out
Sept 2020,171,144,2458,239687803,16342254820,16581942623,405,2286,6,16102567017,In > Out
Sept 2020,171,145,149,22920363,807512760,830433123,78,148,4,784592397,In > Out
Sept 2020,171,146,251,34989608,1848093373,1883082981,117,247,5,1813103765,In > Out
Sept 2020,171,147,1262,108113833,4945884272,5053998105,271,1208,10,4837770439,In > Out
Sept 2020,171,148,378,50516964,1486237762,1536754726,134,375,4,1435720798,In > Out
Sept 2020,171,149,2343,1155895133,9100666576,10256561709,200,2199,4,7944771443,In > Out
Sept 2020,171,15,387,251678308,1661051470,1912729778,166,384,8,1409373162,In > Out
Sept 2020,171,150,279,35115253,1112146041,1147261294,90,274,5,1077030788,In > Out
Sept 2020,171,151,190,79954566,567005151,646959717,106,190,5,487050585,In > Out
Sept 2020,171,152,160,21481257,926005297,947486554,71,157,1,904524040,In > Out
Sept 2020,171,153,240,63073956,1896180304,1959254260,126,239,5,1833106348,In > Out
Sept 2020,171,154,338,38354854,3709646705,3748001559,94,337,6,3671291851,In > Out
Sept 2020,171,156,751,787792361,5447841840,6235634201,177,748,3,4660049479,In > Out
Sept 2020,171,157,956,99054698,3634624189,3733678887,232,941,4,3535569491,In > Out
Sept 2020,171,158,513,205064372,3670627822,3875692194,193,510,7,3465563450,In > Out
Sept 2020,171,159,258,47094019,1747453509,1794547528,93,258,4,1700359490,In > Out
Sept 2020,171,16,401,860285160,9895585617,10755870777,137,401,5,9035300457,In > Out
Sept 2020,171,161,498,131486132,2334485882,2465972014,196,491,10,2202999750,In > Out
Sept 2020,171,163,427,44554466,2032081853,2076636319,169,416,10,1987527387,In > Out
Sept 2020,171,164,1877,1723445413,15426831783,17150277196,450,1813,9,13703386370,In > Out
Sept 2020,171,165,462,82770227,2443611586,2526381813,128,461,5,2360841359,In > Out
Sept 2020,171,166,1497,1457015496,5784955622,7241971118,373,1460,9,4327940126,In > Out
Sept 2020,171,167,1061,3105265079,11411871863,14517136942,438,1020,9,8306606784,In > Out
Sept 2020,171,168,363,89466348,1203474046,1292940394,97,352,18,1114007698,In > Out
Sept 2020,171,17,155,51954755,1453018898,1504973653,80,155,3,1401064143,In > Out
Sept 2020,171,170,971,283806486,3722662451,4006468937,240,961,8,3438855965,In > Out
Sept 2020,171,171,1044,314331479,7160744934,7475076413,374,1034,6,6846413455,In > Out
Sept 2020,171,172,626,99036596,3975841762,4074878358,202,620,4,3876805166,In > Out
Sept 2020,171,173,1275,561455870,25599131552,26160587422,417,1257,8,25037675682,In > Out
Sept 2020,171,174,590,170464911,5457411165,5627876076,135,573,7,5286946254,In > Out
Sept 2020,171,175,4,495870401,8494333961,8990204362,4,4,2,7998463560,In > Out
Sept 2020,171,177,1426,209179184,3737569993,3946749177,298,1355,5,3528390809,In > Out
Sept 2020,171,179,1876,424418959,10739364577,11163783536,208,1797,5,10314945618,In > Out
Sept 2020,171,181,177,30673181,1029999757,1060672938,97,177,2,999326576,In > Out
Sept 2020,171,184,909,315881187,2945341540,3261222727,206,895,8,2629460353,In > Out
Sept 2020,171,185,1211,8760614713,17537008272,26297622985,217,1199,10,8776393559,In > Out
Sept 2020,171,186,931,83675821,4701648995,4785324816,167,913,3,4617973174,In > Out
Sept 2020,171,187,618,221134158,11460774102,11681908260,171,613,5,11239639944,In > Out
Sept 2020,171,188,537,83754399,2503950447,2587704846,148,532,6,2420196048,In > Out
Sept 2020,171,19,882,2152913836,7808521003,9961434839,201,864,5,5655607167,In > Out
Sept 2020,171,190,708,422544807,3650007918,4072552725,172,703,6,3227463111,In > Out
Sept 2020,171,194,359,81816601,7659950467,7741767068,110,358,3,7578133866,In > Out
Sept 2020,171,196,142,47428264,444733703,492161967,73,142,4,397305439,In > Out
Sept 2020,171,202,462,67125110,3911172642,3978297752,160,461,4,3844047532,In > Out
Sept 2020,171,203,336,30508769,1045289638,1075798407,102,335,5,1014780869,In > Out
Sept 2020,171,204,1188,410770558,7813099769,8223870327,195,1150,5,7402329211,In > Out
Sept 2020,171,205,57,2832692,143665611,146498303,9,57,1,140832919,In > Out
Sept 2020,171,206,71,21702673,265290882,286993555,24,71,1,243588209,In > Out
Sept 2020,171,207,1441,183450364,4511853486,4695303850,404,1356,8,4328403122,In > Out
Sept 2020,171,208,227,289511640,1276747164,1566258804,91,225,8,987235524,In > Out
Sept 2020,171,209,1924,757692858,8913966206,9671659064,466,1829,5,8156273348,In > Out
Sept 2020,171,210,1002,1587576327,5162360503,6749936830,188,989,4,3574784176,In > Out
Sept 2020,171,211,359,75219574,3131114166,3206333740,142,356,1,3055894592,In > Out
Sept 2020,171,212,474,78618462,2246286068,2324904530,100,470,7,2167667606,In > Out
Sept 2020,171,213,1336,429358864,10318010319,10747369183,458,1323,24,9888651455,In > Out
Sept 2020,171,215,40,43691599,4173671938,4217363537,31,40,1,4129980339,In > Out
Sept 2020,171,216,1018,291667822,4159204741,4450872563,289,1000,5,3867536919,In > Out
Sept 2020,171,22,1606,1100377648,15712643791,16813021439,406,1558,9,14612266143,In > Out
Sept 2020,171,221,1339,679536819,36640465221,37320002040,360,1316,4,35960928402,In > Out
Sept 2020,171,222,269,40535509,1731340537,1771876046,113,269,3,1690805028,In > Out
Sept 2020,171,223,230,32633065,1362650170,1395283235,89,230,3,1330017105,In > Out
Sept 2020,171,23,1453,399553430,5439978917,5839532347,322,1404,8,5040425487,In > Out
Sept 2020,171,27,167,20559877,675839364,696399241,82,165,3,655279487,In > Out
Sept 2020,171,30,462,150776387,1925723941,2076500328,143,460,6,1774947554,In > Out
Sept 2020,171,31,134,25490637,3532046545,3557537182,56,133,3,3506555908,In > Out
Sept 2020,171,33,285,111454119,505861225,617315344,158,285,5,394407106,In > Out
Sept 2020,171,35,407,96788643,6137648519,6234437162,139,404,4,6040859876,In > Out
Sept 2020,171,36,466,359644576,4911715344,5271359920,145,466,6,4552070768,In > Out
Sept 2020,171,40,645,6097380631,14091675656,20189056287,252,633,9,7994295025,In > Out
Sept 2020,171,41,51,7344471,34886991,42231462,29,51,2,27542520,In > Out
Sept 2020,171,42,509,111528280,4991469419,5102997699,149,509,5,4879941139,In > Out
Sept 2020,171,44,485,91587729,5041602981,5133190710,159,410,18,4950015252,In > Out
Sept 2020,171,45,879,444481433,5747373605,6191855038,292,863,10,5302892172,In > Out
Sept 2020,171,46,601,183588505,7060527296,7244115801,175,590,5,6876938791,In > Out
Sept 2020,171,47,131,14014556,990517677,1004532233,35,130,2,976503121,In > Out
Sept 2020,171,48,860,807825311,14443152750,15250978061,305,848,10,13635327439,In > Out
Sept 2020,171,49,768,408899497,4998733446,5407632943,220,749,31,4589833949,In > Out
Sept 2020,171,50,714,403339292,2522478047,2925817339,159,709,6,2119138755,In > Out
Sept 2020,171,54,503,79216154,4212807815,4292023969,151,497,6,4133591661,In > Out
Sept 2020,171,57,592,81367562,1740177505,1821545067,160,580,4,1658809943,In > Out
Sept 2020,171,58,1159,325154973,22634551121,22959706094,397,1156,22,22309396148,In > Out
Sept 2020,171,59,291,140695721,1097876987,1238572708,178,233,120,957181266,In > Out
Sept 2020,171,6,521,220575919,1341587115,1562163034,175,512,3,1121011196,In > Out
Sept 2020,171,60,165,107817047,1049271988,1157089035,58,164,5,941454941,In > Out
Sept 2020,171,63,93,14329350,415144737,429474087,44,93,1,400815387,In > Out
Sept 2020,171,64,175,38446056,442386147,480832203,70,175,4,403940091,In > Out
Sept 2020,171,65,530,12732844957,7473253726,20206098683,198,522,8,5259591231,Out > In
Sept 2020,171,66,1259,458973312,2641530011,3100503323,322,1216,6,2182556699,In > Out
Sept 2020,171,67,1147,582704721,4996073939,5578778660,289,1114,6,4413369218,In > Out
Sept 2020,171,71,1052,183679745,4733454058,4917133803,173,1049,2,4549774313,In > Out
Sept 2020,171,72,279,112306005,1551882131,1664188136,131,278,3,1439576126,In > Out
Sept 2020,171,74,1164,169325318,5462477856,5631803174,311,1149,8,5293152538,In > Out
Sept 2020,171,75,604,215920907,11907939726,12123860633,178,596,5,11692018819,In > Out
Sept 2020,171,76,1639,3015150973,22500932889,25516083862,376,1583,16,19485781916,In > Out
Sept 2020,171,77,486,47771907,1979080071,2026851978,173,485,5,1931308164,In > Out
Sept 2020,171,78,1283,472585050,15060851329,15533436379,348,1246,7,14588266279,In > Out
Sept 2020,171,79,2137,1254656695,61274540705,62529197400,534,2013,9,60019884010,In > Out
Sept 2020,171,81,120,30114842,802713371,832828213,42,118,5,772598529,In > Out
Sept 2020,171,82,1428,144461395,9111571119,9256032514,278,1394,6,8967109724,In > Out
Sept 2020,171,84,1138,1241811842,5250474398,6492286240,407,1135,4,4008662556,In > Out
Sept 2020,171,85,43,5606262,31392472,36998734,29,43,3,25786210,In > Out
Sept 2020,171,86,202,570688352,1794455460,2365143812,92,200,9,1223767108,In > Out
Sept 2020,171,87,1501,488514376,16304915973,16793430349,446,1470,5,15816401597,In > Out
Sept 2020,171,88,306,51055382,458129789,509185171,136,306,6,407074407,In > Out
Sept 2020,171,91,1255,310361085,41820563343,42130924428,433,1230,4,41510202258,In > Out
Sept 2020,171,92,161,23036690,691273884,714310574,69,159,3,668237194,In > Out
Sept 2020,171,93,619,2857100531,8168237403,11025337934,187,609,10,5311136872,In > Out
Sept 2020,171,95,28,1325724,20200655,21526379,22,28,3,18874931,In > Out
Sept 2020,171,96,788,134018467,5325485478,5459503945,287,777,5,5191467011,In > Out
Sept 2020,171,98,10,998886,8705445,9704331,8,10,2,7706559,In > Out
Sept 2020,173,103,29,3875229,169211639,173086868,15,29,2,165336410,In > Out
Sept 2020,173,70,3403,466217543,2026359524,2492577067,412,3166,2,1560141981,In > Out
Sept 2020,174,109,299,113726159,444076654,557802813,96,299,2,330350495,In > Out
Sept 2020,174,118,185,34813203,1421442080,1456255283,33,185,2,1386628877,In > Out
Sept 2020,174,196,92,91806313,340210890,432017203,17,92,2,248404577,In > Out
Sept 2020,175,192,1274,61149443,3643379861,3704529304,200,1234,3,3582230418,In > Out
Sept 2020,175,32,32,555998,38515015,39071013,8,32,2,37959017,In > Out
Sept 2020,176,175,1,48990,54471,103461,1,1,1,5481,In > Out
Sept 2020,176,176,13,620041,71951070,72571111,6,13,2,71331029,In > Out
Sept 2020,176,38,689,115728510,4012824319,4128552829,234,689,2,3897095809,In > Out
Sept 2020,176,99,49,61491231,1784087485,1845578716,34,49,3,1722596254,In > Out
Sept 2020,177,174,166,2350055,24868684,27218739,1,166,1,22518629,In > Out
Sept 2020,178,103,119,11788177,357037365,368825542,58,119,2,345249188,In > Out
Sept 2020,178,121,449,278143472,6908221086,7186364558,103,447,2,6630077614,In > Out
Sept 2020,178,123,1926,323245508,2045822482,2369067990,97,1812,3,1722576974,In > Out
Sept 2020,178,126,156,51644206,3623876649,3675520855,31,156,2,3572232443,In > Out
Sept 2020,178,184,322,164752961,8421694522,8586447483,74,315,6,8256941561,In > Out
Sept 2020,178,185,32,22883020,15211660,38094680,9,32,2,7671360,Out > In
Sept 2020,178,219,11,3211011,218147357,221358368,6,11,1,214936346,In > Out
Sept 2020,178,29,1034,209658313,7509220468,7718878781,61,979,2,7299562155,In > Out
Sept 2020,178,4,2580,11540205324,1836640942,13376846266,325,2456,3,9703564382,Out > In
Sept 2020,178,47,158,12949200,86635765,99584965,48,156,2,73686565,In > Out
Sept 2020,178,61,201,54325355,3721501739,3775827094,34,200,2,3667176384,In > Out
Sept 2020,178,78,970,168120786,1967099513,2135220299,300,951,3,1798978727,In > Out
Sept 2020,178,95,6677,397334216,21059339543,21456673759,143,5640,2,20662005327,In > Out
Sept 2020,179,130,562,104481701,5276300127,5380781828,187,551,3,5171818426,In > Out
Sept 2020,179,160,436,12220916371,652924822,12873841193,356,8,179,11567991549,Out > In
Sept 2020,179,199,57,9610954,265846848,275457802,10,57,1,256235894,In > Out
Sept 2020,179,211,1145,348675199,3933655876,4282331075,98,1117,3,3584980677,In > Out
Sept 2020,179,47,194,91788603,3861519379,3953307982,40,194,2,3769730776,In > Out
Sept 2020,179,52,297,76764585,5015641749,5092406334,104,297,2,4938877164,In > Out
Sept 2020,180,113,106,11005607,514260427,525266034,28,106,2,503254820,In > Out
Sept 2020,180,133,170,10433666,346946116,357379782,49,168,2,336512450,In > Out
Sept 2020,180,137,106,12794223,133736333,146530556,54,106,2,120942110,In > Out
Sept 2020,180,138,164,44512598,75081601,119594199,46,164,2,30569003,In > Out
Sept 2020,180,140,641,149046937,1157559393,1306606330,113,631,2,1008512456,In > Out
Sept 2020,180,154,2543,638904783,2518767961,3157672744,212,2366,3,1879863178,In > Out
Sept 2020,180,161,63,8097110,469460476,477557586,24,62,2,461363366,In > Out
Sept 2020,180,165,305,52395076,3648286610,3700681686,35,304,2,3595891534,In > Out
Sept 2020,180,169,261,28584110,1178538369,1207122479,35,261,2,1149954259,In > Out
Sept 2020,180,172,724,403141469,1303402358,1706543827,105,687,2,900260889,In > Out
Sept 2020,180,175,272,94123970,3661766605,3755890575,28,271,2,3567642635,In > Out
Sept 2020,180,187,301,13338284,3778673295,3792011579,27,300,2,3765335011,In > Out
Sept 2020,180,188,411,57897919,3895586463,3953484382,27,408,2,3837688544,In > Out
Sept 2020,180,189,1145,907578267,5604154844,6511733111,148,1088,3,4696576577,In > Out
Sept 2020,180,193,496,13322596,1865882308,1879204904,51,478,2,1852559712,In > Out
Sept 2020,180,199,77,11469531,480732467,492201998,37,75,2,469262936,In > Out
Sept 2020,180,204,186,101447421,3665791349,3767238770,28,186,2,3564343928,In > Out
Sept 2020,180,44,366,276599908,3585199882,3861799790,99,363,2,3308599974,In > Out
Sept 2020,180,59,47,5253033,287021164,292274197,24,46,2,281768131,In > Out
Sept 2020,180,62,4078,960693537,3767699559,4728393096,248,3605,3,2807006022,In > Out
Sept 2020,180,82,346,110797916,4260383393,4371181309,26,345,2,4149585477,In > Out
Sept 2020,180,84,319,7590286,3373569708,3381159994,23,319,2,3365979422,In > Out
Sept 2020,180,85,317,106525149,4006414409,4112939558,29,317,2,3899889260,In > Out
Sept 2020,180,96,871,932152730,3886435738,4818588468,205,848,4,2954283008,In > Out
Sept 2020,180,98,679,328502237,4331382456,4659884693,163,665,2,4002880219,In > Out
Sept 2020,181,109,213,52700672,3222280528,3274981200,74,213,2,3169579856,In > Out
Sept 2020,181,111,168,19587539,276198944,295786483,36,167,2,256611405,In > Out
Sept 2020,181,114,67,3255749,556593325,559849074,34,67,2,553337576,In > Out
Sept 2020,181,115,275,22658577,1070256208,1092914785,102,275,2,1047597631,In > Out
Sept 2020,181,117,2,294004,21506637,21800641,2,2,1,21212633,In > Out
Sept 2020,181,119,118,8376801,175531764,183908565,31,118,2,167154963,In > Out
Sept 2020,181,122,3678,440423174,5889218473,6329641647,630,3354,2,5448795299,In > Out
Sept 2020,181,127,1968,322639312,3907186830,4229826142,312,1890,3,3584547518,In > Out
Sept 2020,181,128,408,112725920,3361035364,3473761284,150,401,2,3248309444,In > Out
Sept 2020,181,130,2,46120,2007547,2053667,2,2,1,1961427,In > Out
Sept 2020,181,131,82,7585010,624541273,632126283,45,82,2,616956263,In > Out
Sept 2020,181,133,3,64970,19981769,20046739,2,3,1,19916799,In > Out
Sept 2020,181,141,158,111932679,3970424934,4082357613,70,158,2,3858492255,In > Out
Sept 2020,181,148,141,86216596,3181814280,3268030876,47,141,3,3095597684,In > Out
Sept 2020,181,150,3536,680186964,8996762278,9676949242,488,3301,2,8316575314,In > Out
Sept 2020,181,151,133,18172224,700855285,719027509,50,132,2,682683061,In > Out
Sept 2020,181,155,70,2877035,165260793,168137828,17,70,2,162383758,In > Out
Sept 2020,181,158,215,12145223,545721803,557867026,61,214,3,533576580,In > Out
Sept 2020,181,164,96,10419535,278382704,288802239,33,96,2,267963169,In > Out
Sept 2020,181,168,3,312442,7045310,7357752,3,3,2,6732868,In > Out
Sept 2020,181,169,64,199048194,65296471,264344665,33,14,36,133751723,Out > In
Sept 2020,181,171,600,56658367,1762420963,1819079330,170,589,3,1705762596,In > Out
Sept 2020,181,172,102,32578393,259702317,292280710,42,102,2,227123924,In > Out
Sept 2020,181,175,831,698658892,27478599198,28177258090,233,800,5,26779940306,In > Out
Sept 2020,181,177,42,3839999,40315611,44155610,31,42,2,36475612,In > Out
Sept 2020,181,184,3519,7808441960,1801657513,9610099473,319,3191,129,6006784447,Out > In
Sept 2020,181,186,66,16691935,450011339,466703274,38,66,2,433319404,In > Out
Sept 2020,181,196,7,312190,10218102,10530292,4,7,6,9905912,In > Out
Sept 2020,181,197,42,1292376,82565952,83858328,16,42,2,81273576,In > Out
Sept 2020,181,198,233,24046690,1086322539,1110369229,31,232,2,1062275849,In > Out
Sept 2020,181,20,2618,274061256,5081918301,5355979557,348,2501,4,4807857045,In > Out
Sept 2020,181,208,1129,203140816,3204645215,3407786031,98,1095,2,3001504399,In > Out
Sept 2020,181,212,11,56341,1672970,1729311,7,11,1,1616629,In > Out
Sept 2020,181,215,111,3775810,102306537,106082347,26,111,2,98530727,In > Out
Sept 2020,181,216,18,61191,2476753,2537944,5,18,2,2415562,In > Out
Sept 2020,181,220,209,8170249,741309840,749480089,69,209,2,733139591,In > Out
Sept 2020,181,226,2510,388687636,6486301579,6874989215,179,2410,2,6097613943,In > Out
Sept 2020,181,230,4,106422,23317996,23424418,2,4,1,23211574,In > Out
Sept 2020,181,231,277,21284998,357716033,379001031,139,277,2,336431035,In > Out
Sept 2020,181,234,1358,4187361578,1593487844,5780849422,188,1293,2,2593873734,Out > In
Sept 2020,181,238,8,2493973,531615280,534109253,6,8,2,529121307,In > Out
Sept 2020,181,240,790,124903975,3695321173,3820225148,151,775,3,3570417198,In > Out
Sept 2020,181,244,7,22006,977218,999224,5,7,1,955212,In > Out
Sept 2020,181,247,958,216474363,6922084523,7138558886,96,938,3,6705610160,In > Out
Sept 2020,181,248,139,1575301201,6184320929,7759622130,57,138,10,4609019728,In > Out
Sept 2020,181,250,53,2081734,4429726,6511460,7,52,2,2347992,In > Out
Sept 2020,181,251,404,90046785,4062901084,4152947869,32,391,2,3972854299,In > Out
Sept 2020,181,36,25,115587959,5071913880,5187501839,8,25,2,4956325921,In > Out
Sept 2020,181,37,14,58732,2108492,2167224,9,14,1,2049760,In > Out
Sept 2020,181,38,19,1123000,190421277,191544277,11,19,1,189298277,In > Out
Sept 2020,181,4,2,514148,4913977,5428125,2,2,1,4399829,In > Out
Sept 2020,181,46,471,51154925,6880445500,6931600425,157,461,2,6829290575,In > Out
Sept 2020,181,47,18,1202329,3386249,4588578,9,18,1,2183920,In > Out
Sept 2020,181,5,44,1511556,355918739,357430295,14,44,2,354407183,In > Out
Sept 2020,181,54,328,32773948,334688850,367462798,96,322,2,301914902,In > Out
Sept 2020,181,59,1261,1478866886,5618357974,7097224860,92,1207,4,4139491088,In > Out
Sept 2020,181,6,14,58921,2172072,2230993,8,14,1,2113151,In > Out
Sept 2020,181,61,1171,142829957,311100933,453930890,107,1143,2,168270976,In > Out
Sept 2020,181,64,50,6134631,31681033,37815664,26,27,16,25546402,In > Out
Sept 2020,181,7,792,97725599,2987143942,3084869541,248,722,2,2889418343,In > Out
Sept 2020,181,71,2763,552048875,6215822469,6767871344,639,2606,25,5663773594,In > Out
Sept 2020,181,73,47,9250136,173013447,182263583,14,39,2,163763311,In > Out
Sept 2020,181,74,497,163744169,3970635128,4134379297,193,497,3,3806890959,In > Out
Sept 2020,181,77,23,858594,23856357,24714951,16,23,1,22997763,In > Out
Sept 2020,181,78,1,10869,2138844,2149713,1,1,1,2127975,In > Out
Sept 2020,181,79,1,16862,125932,142794,1,1,1,109070,In > Out
Sept 2020,181,8,270,131782758,5268502526,5400285284,27,270,3,5136719768,In > Out
Sept 2020,181,80,12,5162656,656276860,661439516,3,12,2,651114204,In > Out
Sept 2020,181,81,306,80853639,3749284193,3830137832,28,304,2,3668430554,In > Out
Sept 2020,181,82,383,70642573,4345209186,4415851759,32,382,2,4274566613,In > Out
Sept 2020,181,88,197,5472062,1985101402,1990573464,37,197,3,1979629340,In > Out
Sept 2020,181,9,6267,4126393222,4874640250,9001033472,292,5553,4,748247028,In > Out
Sept 2020,181,90,99,151535265,5893251311,6044786576,53,99,4,5741716046,In > Out
Sept 2020,181,93,2666,647577682,8731449301,9379026983,669,2461,5,8083871619,In > Out
Sept 2020,181,95,104,4975384,94209772,99185156,60,104,2,89234388,In > Out
Sept 2020,181,99,2,442484,19525186,19967670,1,2,1,19082702,In > Out
Sept 2020,183,119,13,457170,51051934,51509104,12,13,1,50594764,In > Out
Sept 2020,183,19,28,4749549,449361851,454111400,16,28,2,444612302,In > Out
Sept 2020,183,88,53,11272863,491657107,502929970,28,52,2,480384244,In > Out
Sept 2020,183,94,1403,1282975896,5179467655,6462443551,67,1367,3,3896491759,In > Out
Sept 2020,184,134,11379,3050815592,56067017354,59117832946,1431,8771,7,53016201762,In > Out
Sept 2020,184,136,5494,1853422480,11632901195,13486323675,794,4709,7,9779478715,In > Out
Sept 2020,184,137,4047,15341454480,292146149,15633600629,26,3489,3688,15049308331,Out > In
Sept 2020,184,138,30674,36905525216,148019556589,184925081805,3291,14802,5,111114031373,In > Out
Sept 2020,184,181,441,33908269,566389413,600297682,105,439,4,532481144,In > Out
Sept 2020,184,188,3899,6079665358,15955129023,22034794381,462,3506,9,9875463665,In > Out
Sept 2020,184,203,612,148860844,179209440,328070284,24,608,3,30348596,In > Out
Sept 2020,184,216,145,7875184,14877552,22752736,2,100,3,7002368,In > Out
Sept 2020,184,218,61,12099205,407509100,419608305,20,61,3,395409895,In > Out
Sept 2020,184,219,2094,272574955,3735189340,4007764295,397,1953,102,3462614385,In > Out
Sept 2020,184,246,5642,1308154998,11478692248,12786847246,565,4953,5,10170537250,In > Out
Sept 2020,19,122,121,370598,21100526,21471124,1,119,1,20729928,In > Out
Sept 2020,190,100,4,232881,39408845,39641726,3,4,1,39175964,In > Out
Sept 2020,190,101,4,239402,49679495,49918897,2,4,2,49440093,In > Out
Sept 2020,190,110,2,11515,527404,538919,2,2,1,515889,In > Out
Sept 2020,190,119,76,5469075,952613047,958082122,19,76,2,947143972,In > Out
Sept 2020,190,123,13,1134849,157893701,159028550,7,13,1,156758852,In > Out
Sept 2020,190,125,35,3744513,184928177,188672690,8,35,1,181183664,In > Out
Sept 2020,190,156,36,4558267,228295830,232854097,8,36,1,223737563,In > Out
Sept 2020,190,160,17,1321590,134104475,135426065,6,17,1,132782885,In > Out
Sept 2020,190,165,45,2555314,701120001,703675315,18,45,2,698564687,In > Out
Sept 2020,190,208,3,401073,54648140,55049213,2,3,2,54247067,In > Out
Sept 2020,190,209,226,1643900,156327030,157970930,7,226,2,154683130,In > Out
Sept 2020,190,216,3,371548,54879584,55251132,1,3,1,54508036,In > Out
Sept 2020,190,217,249,2362430,145386090,147748520,4,245,2,143023660,In > Out
Sept 2020,190,219,1365,6125652,379770301,385895953,37,1297,2,373644649,In > Out
Sept 2020,190,223,9,604225,103281119,103885344,5,9,2,102676894,In > Out
Sept 2020,190,39,13,454916,100649502,101104418,8,13,2,100194586,In > Out
Sept 2020,190,40,1,102166,18792,120958,1,1,1,83374,Out > In
Sept 2020,190,43,196,2481510,136323614,138805124,6,194,2,133842104,In > Out
Sept 2020,190,44,191,2526555,148717418,151243973,7,190,2,146190863,In > Out
Sept 2020,190,48,16,648531,30689523,31338054,2,4,15,30040992,In > Out
Sept 2020,190,53,3,208252,45825591,46033843,1,3,1,45617339,In > Out
Sept 2020,190,54,6,209593,47757121,47966714,3,6,1,47547528,In > Out
Sept 2020,190,57,9,648141,110027874,110676015,4,9,2,109379733,In > Out
Sept 2020,190,58,16,861598,153099936,153961534,5,16,2,152238338,In > Out
Sept 2020,190,78,4,336280,81931723,82268003,4,4,2,81595443,In > Out
Sept 2020,191,11,5,701025,225587,926612,2,5,1,475438,Out > In
Sept 2020,191,13,31,1550971,18468701,20019672,7,31,1,16917730,In > Out
Sept 2020,191,14,71,4073071,551147998,555221069,17,71,3,547074927,In > Out
Sept 2020,191,37,21,1267838,99944574,101212412,5,21,2,98676736,In > Out
Sept 2020,191,39,1728,529884531,31262925117,31792809648,202,1613,3,30733040586,In > Out
Sept 2020,191,46,1,1207076,120069830,121276906,1,1,1,118862754,In > Out
Sept 2020,191,48,10,147990,7179255,7327245,2,10,2,7031265,In > Out
Sept 2020,191,51,2985,452110595,4681528247,5133638842,396,2712,3,4229417652,In > Out
Sept 2020,191,62,1543,116893532,8650574116,8767467648,378,1523,2,8533680584,In > Out
Sept 2020,192,38,48,2352589,13732104,16084693,5,48,2,11379515,In > Out
Sept 2020,192,39,42,1766840,4131843,5898683,3,42,1,2365003,In > Out
Sept 2020,192,40,67,2848906,15088748,17937654,6,67,2,12239842,In > Out
Sept 2020,192,45,52,3257604,364306663,367564267,12,52,2,361049059,In > Out
Sept 2020,195,10,260,1066615240,1766228873,2832844113,90,256,9,699613633,In > Out
Sept 2020,195,100,72,806282316,868968090,1675250406,39,72,3,62685774,In > Out
Sept 2020,195,104,1582,82706600,1080242320,1162948920,190,1526,4,997535720,In > Out
Sept 2020,195,105,817,99157989,1978467719,2077625708,168,794,5,1879309730,In > Out
Sept 2020,195,106,1938,255759785,10269228346,10524988131,521,1845,10,10013468561,In > Out
Sept 2020,195,107,396,42916453,1862747515,1905663968,144,395,4,1819831062,In > Out
Sept 2020,195,109,249,34314274,1595421991,1629736265,96,245,5,1561107717,In > Out
Sept 2020,195,11,410,1637442340,4115599635,5753041975,162,406,12,2478157295,In > Out
Sept 2020,195,110,985,1277376499,63451012653,64728389152,356,952,9,62173636154,In > Out
Sept 2020,195,113,1114,463695344,12503027773,12966723117,285,1101,11,12039332429,In > Out
Sept 2020,195,114,24,2196270,6131481,8327751,16,24,2,3935211,In > Out
Sept 2020,195,115,1192,232034466,2305796961,2537831427,208,1161,6,2073762495,In > Out
Sept 2020,195,116,359,162855104,12372661656,12535516760,134,359,4,12209806552,In > Out
Sept 2020,195,118,73,8160432,160848192,169008624,44,73,2,152687760,In > Out
Sept 2020,195,12,354,35132074,1919917775,1955049849,65,353,4,1884785701,In > Out
Sept 2020,195,120,2843,2018447387,35730721183,37749168570,512,2702,9,33712273796,In > Out
Sept 2020,195,123,900,175812836,9364843331,9540656167,260,883,5,9189030495,In > Out
Sept 2020,195,125,240,36387125,1032476992,1068864117,122,239,6,996089867,In > Out
Sept 2020,195,128,91,10192431,178678078,188870509,31,91,2,168485647,In > Out
Sept 2020,195,129,459,56973914,1905062121,1962036035,151,456,5,1848088207,In > Out
Sept 2020,195,13,620,117361150,2416190164,2533551314,221,614,4,2298829014,In > Out
Sept 2020,195,130,334,189953518,1063746317,1253699835,132,331,4,873792799,In > Out
Sept 2020,195,131,58,9327270,832108575,841435845,30,58,2,822781305,In > Out
Sept 2020,195,132,307,59313096,1784445656,1843758752,126,305,5,1725132560,In > Out
Sept 2020,195,133,28,18471458,21386498,39857956,20,28,1,2915040,In > Out
Sept 2020,195,134,188,33017332,298461657,331478989,91,188,3,265444325,In > Out
Sept 2020,195,135,28,1112581,20171489,21284070,15,28,4,19058908,In > Out
Sept 2020,195,136,203,198710527,885087076,1083797603,76,202,2,686376549,In > Out
Sept 2020,195,137,238,145454689,3816829026,3962283715,111,238,4,3671374337,In > Out
Sept 2020,195,138,394,31551594,1530977891,1562529485,105,394,3,1499426297,In > Out
Sept 2020,195,139,354,322972081,8520629645,8843601726,143,354,5,8197657564,In > Out
Sept 2020,195,14,236,139175397,1759648494,1898823891,82,229,3,1620473097,In > Out
Sept 2020,195,140,23,57965826,187907753,245873579,11,23,1,129941927,In > Out
Sept 2020,195,141,61,9870889,346462489,356333378,37,61,2,336591600,In > Out
Sept 2020,195,142,939,378883552,13043238123,13422121675,253,918,9,12664354571,In > Out
Sept 2020,195,143,11,557091,40471661,41028752,8,11,2,39914570,In > Out
Sept 2020,195,144,1734,152962683,6513674641,6666637324,208,1678,29,6360711958,In > Out
Sept 2020,195,145,130,1511030166,3245179635,4756209801,62,126,9,1734149469,In > Out
Sept 2020,195,147,364,137593019,2035574765,2173167784,135,350,9,1897981746,In > Out
Sept 2020,195,148,72,11230987,353514101,364745088,34,72,1,342283114,In > Out
Sept 2020,195,149,681,78395741,4960078132,5038473873,247,672,3,4881682391,In > Out
Sept 2020,195,15,663,93995696,3121245506,3215241202,133,657,4,3027249810,In > Out
Sept 2020,195,150,113,46489489,3273634423,3320123912,37,113,3,3227144934,In > Out
Sept 2020,195,151,230,268085112,719877482,987962594,84,230,4,451792370,In > Out
Sept 2020,195,153,425,19788620,730839219,750627839,35,424,1,711050599,In > Out
Sept 2020,195,154,56,12267485,301768454,314035939,33,56,2,289500969,In > Out
Sept 2020,195,155,33,2360563,68710610,71071173,12,33,3,66350047,In > Out
Sept 2020,195,156,1883,238234786,6166791182,6405025968,220,1786,3,5928556396,In > Out
Sept 2020,195,157,165,29739834,1078945035,1108684869,53,165,2,1049205201,In > Out
Sept 2020,195,159,1135,977840889,7997335771,8975176660,473,1098,8,7019494882,In > Out
Sept 2020,195,16,358,78631169,2495815418,2574446587,137,353,4,2417184249,In > Out
Sept 2020,195,160,127,43197176,3023403198,3066600374,54,127,1,2980206022,In > Out
Sept 2020,195,161,1333,293168374,7711290811,8004459185,331,1306,5,7418122437,In > Out
Sept 2020,195,165,117,8680413,50569216,59249629,45,115,4,41888803,In > Out
Sept 2020,195,166,110,111328185,614544642,725872827,56,102,11,503216457,In > Out
Sept 2020,195,167,326,287977830,1350872902,1638850732,74,323,4,1062895072,In > Out
Sept 2020,195,168,47,3422528,57201072,60623600,25,47,2,53778544,In > Out
Sept 2020,195,169,2171,3578436118,37906411441,41484847559,531,2065,13,34327975323,In > Out
Sept 2020,195,17,205,20133663,809134138,829267801,119,205,2,789000475,In > Out
Sept 2020,195,170,364,30905560,1652865479,1683771039,81,364,5,1621959919,In > Out
Sept 2020,195,171,90,111108714,127032270,238140984,49,90,3,15923556,In > Out
Sept 2020,195,172,9,163106,4604718,4767824,8,9,1,4441612,In > Out
Sept 2020,195,173,792,305567572,7610838671,7916406243,287,776,10,7305271099,In > Out
Sept 2020,195,174,348,91635644,5741480753,5833116397,145,346,7,5649845109,In > Out
Sept 2020,195,175,483,586124431,1421257907,2007382338,120,483,8,835133476,In > Out
Sept 2020,195,177,605,65442497,4684991640,4750434137,236,566,5,4619549143,In > Out
Sept 2020,195,178,72,14623663,561423802,576047465,23,72,3,546800139,In > Out
Sept 2020,195,18,393,276913136,2016708983,2293622119,161,386,4,1739795847,In > Out
Sept 2020,195,180,1113,2693959928,15114027412,17807987340,184,1099,10,12420067484,In > Out
Sept 2020,195,182,865,170217414,4290410875,4460628289,217,845,7,4120193461,In > Out
Sept 2020,195,183,250,49786891,1503680580,1553467471,87,250,2,1453893689,In > Out
Sept 2020,195,184,277,15109798,766985463,782095261,35,274,2,751875665,In > Out
Sept 2020,195,185,164,46113180,1195494704,1241607884,67,161,4,1149381524,In > Out
Sept 2020,195,186,41,2367200,82615955,84983155,21,41,2,80248755,In > Out
Sept 2020,195,187,393,280534357,10121883644,10402418001,142,383,7,9841349287,In > Out
Sept 2020,195,188,1005,1050906333,15984256991,17035163324,208,960,12,14933350658,In > Out
Sept 2020,195,189,166,13668210,335657004,349325214,52,165,2,321988794,In > Out
Sept 2020,195,19,73,17935202,1109769608,1127704810,43,73,3,1091834406,In > Out
Sept 2020,195,190,20,1827261,7951133,9778394,10,20,2,6123872,In > Out
Sept 2020,195,191,879,1548429270,4504567756,6052997026,221,855,11,2956138486,In > Out
Sept 2020,195,192,1187,146349684,6153876911,6300226595,318,1167,4,6007527227,In > Out
Sept 2020,195,193,6,206922,1082161,1289083,4,6,1,875239,In > Out
Sept 2020,195,194,902,1002270568,8247772409,9250042977,274,896,11,7245501841,In > Out
Sept 2020,195,195,122,77240128,1607825433,1685065561,81,122,3,1530585305,In > Out
Sept 2020,195,196,154,30897230,424896487,455793717,64,154,4,393999257,In > Out
Sept 2020,195,197,11,354434,3012639,3367073,5,11,1,2658205,In > Out
Sept 2020,195,198,413,287832104,3922953349,4210785453,79,413,3,3635121245,In > Out
Sept 2020,195,199,222,104231329,8530394517,8634625846,82,219,4,8426163188,In > Out
Sept 2020,195,20,751,77524020,2491107084,2568631104,190,750,4,2413583064,In > Out
Sept 2020,195,200,207,30513329,403292762,433806091,80,207,3,372779433,In > Out
Sept 2020,195,201,186,373173319,841366596,1214539915,77,186,7,468193277,In > Out
Sept 2020,195,202,52,5662918,81276966,86939884,32,52,3,75614048,In > Out
Sept 2020,195,203,393,183692430,13709329936,13893022366,89,393,2,13525637506,In > Out
Sept 2020,195,204,61,5176144,249261812,254437956,40,61,2,244085668,In > Out
Sept 2020,195,205,432,374480206,9851099503,10225579709,192,428,6,9476619297,In > Out
Sept 2020,195,206,978,223304118,2514681608,2737985726,194,963,4,2291377490,In > Out
Sept 2020,195,207,1377,1688886344,8562042528,10250928872,247,1339,11,6873156184,In > Out
Sept 2020,195,208,715,115005264,9260888569,9375893833,229,709,3,9145883305,In > Out
Sept 2020,195,209,131,7433382,94688907,102122289,47,131,5,87255525,In > Out
Sept 2020,195,21,886,126754670,5007630459,5134385129,188,873,5,4880875789,In > Out
Sept 2020,195,210,6,767623,50249447,51017070,6,6,1,49481824,In > Out
Sept 2020,195,211,157,57136017,1901275936,1958411953,66,157,3,1844139919,In > Out
Sept 2020,195,212,442,2096706216,5019430765,7116136981,161,431,11,2922724549,In > Out
Sept 2020,195,213,99,28362999,404121561,432484560,43,97,3,375758562,In > Out
Sept 2020,195,214,232,45239540,2098260173,2143499713,137,230,4,2053020633,In > Out
Sept 2020,195,215,7000,1720063641,58579973436,60300037077,818,5868,45,56859909795,In > Out
Sept 2020,195,216,2409,905001822,22938722479,23843724301,424,2301,15,22033720657,In > Out
Sept 2020,195,217,949,162055054,3973032369,4135087423,290,949,5,3810977315,In > Out
Sept 2020,195,218,452,351695600,1562929195,1914624795,181,436,5,1211233595,In > Out
Sept 2020,195,219,323,165981036,1575101396,1741082432,74,323,3,1409120360,In > Out
Sept 2020,195,22,381,132503425,12052165423,12184668848,129,361,5,11919661998,In > Out
Sept 2020,195,220,513,1250916179,2020071104,3270987283,170,507,6,769154925,In > Out
Sept 2020,195,221,176,13975767,674023572,687999339,101,176,3,660047805,In > Out
Sept 2020,195,222,34,4028396,150085333,154113729,29,34,1,146056937,In > Out
Sept 2020,195,223,902,544980802,37488729578,38033710380,240,901,6,36943748776,In > Out
Sept 2020,195,23,688,155563048,4100940923,4256503971,195,679,3,3945377875,In > Out
Sept 2020,195,24,1714,657175335,54343010131,55000185466,242,1647,7,53685834796,In > Out
Sept 2020,195,25,868,5439820057,3594294520,9034114577,229,857,11,1845525537,Out > In
Sept 2020,195,26,4,381113,2929863,3310976,3,4,1,2548750,In > Out
Sept 2020,195,27,71,548773086,545507445,1094280531,36,70,4,3265641,Out > In
Sept 2020,195,28,173,68227103,2105563987,2173791090,68,171,5,2037336884,In > Out
Sept 2020,195,29,2379,2821347561,270960564445,273781912006,224,2296,3,268139216884,In > Out
Sept 2020,195,30,46,49097761,86695637,135793398,30,46,2,37597876,In > Out
Sept 2020,195,31,614,85786381,4002522539,4088308920,144,598,6,3916736158,In > Out
Sept 2020,195,32,2899,484999024,14089817010,14574816034,488,2586,4,13604817986,In > Out
Sept 2020,195,33,62,3701136,138327003,142028139,35,62,2,134625867,In > Out
Sept 2020,195,34,440,512320397,2301865885,2814186282,161,433,5,1789545488,In > Out
Sept 2020,195,35,149,14102063,261276137,275378200,79,149,6,247174074,In > Out
Sept 2020,195,36,690,190904843,6684988351,6875893194,224,686,2,6494083508,In > Out
Sept 2020,195,37,1469,935953087,27191120711,28127073798,409,1450,7,26255167624,In > Out
Sept 2020,195,38,18,1522147,153865112,155387259,10,18,3,152342965,In > Out
Sept 2020,195,39,206,45863547,2345116476,2390980023,86,204,3,2299252929,In > Out
Sept 2020,195,4,749,260881698,13498618788,13759500486,266,740,4,13237737090,In > Out
Sept 2020,195,40,571,74037667,3592027642,3666065309,157,570,5,3517989975,In > Out
Sept 2020,195,41,657,179095459,2877683512,3056778971,187,643,6,2698588053,In > Out
Sept 2020,195,42,495,97056314,8289915824,8386972138,72,495,4,8192859510,In > Out
Sept 2020,195,43,313,64328301,3907968048,3972296349,148,310,3,3843639747,In > Out
Sept 2020,195,44,450,1013211594,13246300677,14259512271,95,450,4,12233089083,In > Out
Sept 2020,195,45,108,402341357,374980981,777322338,47,108,4,27360376,Out > In
Sept 2020,195,46,21,1139985,48073148,49213133,14,21,2,46933163,In > Out
Sept 2020,195,47,75,6085389,433806744,439892133,28,75,2,427721355,In > Out
Sept 2020,195,48,9,293640,936061,1229701,4,9,1,642421,In > Out
Sept 2020,195,49,64,6893230,137426582,144319812,40,64,3,130533352,In > Out
Sept 2020,195,5,93,12542889,639358978,651901867,37,93,3,626816089,In > Out
Sept 2020,195,50,309,455042451,5694875836,6149918287,129,309,7,5239833385,In > Out
Sept 2020,195,51,178,402153124,1629652097,2031805221,88,177,5,1227498973,In > Out
Sept 2020,195,52,134,20489172,338489520,358978692,81,134,6,318000348,In > Out
Sept 2020,195,53,563,82914113,1479016489,1561930602,119,555,4,1396102376,In > Out
Sept 2020,195,54,1197,3417517681,17281760303,20699277984,326,1140,14,13864242622,In > Out
Sept 2020,195,55,29,5205930,85942475,91148405,14,29,1,80736545,In > Out
Sept 2020,195,56,500,126487578,1695677321,1822164899,170,497,5,1569189743,In > Out
Sept 2020,195,57,466,141791843,4503253221,4645045064,141,461,11,4361461378,In > Out
Sept 2020,195,58,78,9919100,171598878,181517978,27,78,4,161679778,In > Out
Sept 2020,195,59,89,6739998,184480778,191220776,44,89,4,177740780,In > Out
Sept 2020,195,6,203,76553750,1362151923,1438705673,85,203,3,1285598173,In > Out
Sept 2020,195,60,128,61355805,680017386,741373191,56,126,4,618661581,In > Out
Sept 2020,195,61,14,3961226,37754611,41715837,7,14,1,33793385,In > Out
Sept 2020,195,62,1268,229489650,8898536634,9128026284,304,1267,2,8669046984,In > Out
Sept 2020,195,63,730,160659194,1414088633,1574747827,178,701,5,1253429439,In > Out
Sept 2020,195,64,307,251261548,1686816117,1938077665,128,301,6,1435554569,In > Out
Sept 2020,195,65,250,78824609,3636248227,3715072836,109,250,3,3557423618,In > Out
Sept 2020,195,66,768,238237700,10962328512,11200566212,232,748,5,10724090812,In > Out
Sept 2020,195,67,201,806262363,7072471765,7878734128,119,201,6,6266209402,In > Out
Sept 2020,195,68,573,89558916,2366525242,2456084158,118,568,6,2276966326,In > Out
Sept 2020,195,69,98,17722282,132160340,149882622,34,98,1,114438058,In > Out
Sept 2020,195,7,191,9274109,272831339,282105448,66,191,1,263557230,In > Out
Sept 2020,195,70,537,22240671,539400855,561641526,119,534,3,517160184,In > Out
Sept 2020,195,71,325,42674101,1017269717,1059943818,89,321,2,974595616,In > Out
Sept 2020,195,72,23,3416514,100946384,104362898,12,23,1,97529870,In > Out
Sept 2020,195,73,298,584058293,685187026,1269245319,132,285,7,101128733,In > Out
Sept 2020,195,74,3,74458,1890042,1964500,2,3,1,1815584,In > Out
Sept 2020,195,75,392,297488606,591226427,888715033,122,375,7,293737821,In > Out
Sept 2020,195,76,52,6804557,149894521,156699078,31,52,2,143089964,In > Out
Sept 2020,195,77,294,42136395,1049037210,1091173605,108,294,3,1006900815,In > Out
Sept 2020,195,78,841,198459167,4285125155,4483584322,105,811,3,4086665988,In > Out
Sept 2020,195,79,379,99748463,7061373613,7161122076,202,378,4,6961625150,In > Out
Sept 2020,195,8,2693,778814102,56279130683,57057944785,551,2492,10,55500316581,In > Out
Sept 2020,195,81,354,79460825,3988641837,4068102662,135,350,2,3909181012,In > Out
Sept 2020,195,82,712,1351554200,3086894461,4438448661,165,700,5,1735340261,In > Out
Sept 2020,195,83,2638,3132697065,13184357966,16317055031,585,2530,6,10051660901,In > Out
Sept 2020,195,84,78,9958696,43475278,53433974,43,78,4,33516582,In > Out
Sept 2020,195,85,380,55571704,1322147590,1377719294,114,380,5,1266575886,In > Out
Sept 2020,195,87,72,82445725,288191068,370636793,26,72,3,205745343,In > Out
Sept 2020,195,88,238,22716819,825582211,848299030,82,238,2,802865392,In > Out
Sept 2020,195,89,19,10460920,177049188,187510108,15,19,3,166588268,In > Out
Sept 2020,195,9,347,85032249,7328285083,7413317332,33,347,3,7243252834,In > Out
Sept 2020,195,90,1001,130990613,2392454039,2523444652,279,994,4,2261463426,In > Out
Sept 2020,195,91,42,10224527,10514607,20739134,11,42,2,290080,In > Out
Sept 2020,195,92,4,53687,832949,886636,4,4,2,779262,In > Out
Sept 2020,195,93,1490,406887489,5550186103,5957073592,322,1470,6,5143298614,In > Out
Sept 2020,195,94,58,33957232,607153433,641110665,27,58,2,573196201,In > Out
Sept 2020,195,95,590,177319160,5931298198,6108617358,207,579,5,5753979038,In > Out
Sept 2020,195,96,1144,7006998386,6185623064,13192621450,307,1113,5,821375322,Out > In
Sept 2020,195,97,910,191338013,7836871306,8028209319,210,891,5,7645533293,In > Out
Sept 2020,195,99,477,180727488,4580005098,4760732586,184,474,4,4399277610,In > Out
Sept 2020,196,108,964,59114479,4090808421,4149922900,48,800,2,4031693942,In > Out
Sept 2020,196,119,731,42910324,3342446994,3385357318,39,708,2,3299536670,In > Out
Sept 2020,196,125,57,38761873,2868890956,2907652829,15,57,2,2830129083,In > Out
Sept 2020,196,160,848,39677464,2725250299,2764927763,56,846,2,2685572835,In > Out
Sept 2020,196,170,62,41426919,3024697835,3066124754,15,62,2,2983270916,In > Out
Sept 2020,196,178,98,44534674,3265935755,3310470429,24,98,2,3221401081,In > Out
Sept 2020,196,183,58,41837492,3081891110,3123728602,14,58,2,3040053618,In > Out
Sept 2020,196,187,32,1244843,51481406,52726249,14,32,2,50236563,In > Out
Sept 2020,196,189,321,9836636,746891496,756728132,24,321,2,737054860,In > Out
Sept 2020,196,190,61,41822945,3095335416,3137158361,16,61,2,3053512471,In > Out
Sept 2020,196,192,42,1577807,109436254,111014061,15,42,2,107858447,In > Out
Sept 2020,196,24,203,20933122,507892421,528825543,61,202,2,486959299,In > Out
Sept 2020,196,34,81,87381450,6367340496,6454721946,18,81,2,6279959046,In > Out
Sept 2020,196,39,47,1804585,131067060,132871645,16,47,2,129262475,In > Out
Sept 2020,196,46,43,945250,80684628,81629878,14,43,2,79739378,In > Out
Sept 2020,196,62,97,89435143,6483714559,6573149702,24,97,2,6394279416,In > Out
Sept 2020,196,7,424,23401685,858302467,881704152,130,423,2,834900782,In > Out
Sept 2020,197,100,366,37130610,867951354,905081964,119,362,7,830820744,In > Out
Sept 2020,197,101,264,28176575,1105093035,1133269610,116,260,4,1076916460,In > Out
Sept 2020,197,102,98,231259664,1156661290,1387920954,53,98,3,925401626,In > Out
Sept 2020,197,103,219,48888780,243019881,291908661,93,219,4,194131101,In > Out
Sept 2020,197,104,718,243490647,4179331693,4422822340,188,704,8,3935841046,In > Out
Sept 2020,197,105,285,237465942,693258038,930723980,92,280,6,455792096,In > Out
Sept 2020,197,107,222,67811460,1065262177,1133073637,76,222,4,997450717,In > Out
Sept 2020,197,108,158,18031990,685655699,703687689,73,158,5,667623709,In > Out
Sept 2020,197,11,487,203196910,5987747217,6190944127,161,482,8,5784550307,In > Out
Sept 2020,197,110,261,276042773,1381623423,1657666196,97,259,5,1105580650,In > Out
Sept 2020,197,113,126,18843759,73297716,92141475,48,124,2,54453957,In > Out
Sept 2020,197,115,328,54146072,5308272563,5362418635,79,326,4,5254126491,In > Out
Sept 2020,197,117,148,32533262,393906173,426439435,72,147,7,361372911,In > Out
Sept 2020,197,118,82,11447631,113788723,125236354,53,82,4,102341092,In > Out
Sept 2020,197,120,237,517586344,352953875,870540219,72,236,4,164632469,Out > In
Sept 2020,197,121,168,531382066,754803210,1286185276,81,167,3,223421144,In > Out
Sept 2020,197,123,307,2001338195,3264902251,5266240446,117,306,6,1263564056,In > Out
Sept 2020,197,124,136,127232871,6699941951,6827174822,66,135,3,6572709080,In > Out
Sept 2020,197,125,87,72287017,1307283108,1379570125,52,87,3,1234996091,In > Out
Sept 2020,197,126,212,16005766,477405855,493411621,96,210,4,461400089,In > Out
Sept 2020,197,128,294,69132401,6259186681,6328319082,76,289,3,6190054280,In > Out
Sept 2020,197,131,233,58729419,746812989,805542408,66,231,8,688083570,In > Out
Sept 2020,197,132,255,42332994,521337367,563670361,127,223,20,479004373,In > Out
Sept 2020,197,133,167,18906931,138258135,157165066,60,167,5,119351204,In > Out
Sept 2020,197,135,299,37457193,2099501497,2136958690,97,293,8,2062044304,In > Out
Sept 2020,197,136,160,548854111,1295237425,1844091536,53,160,9,746383314,In > Out
Sept 2020,197,137,202,101341187,2946797613,3048138800,66,201,5,2845456426,In > Out
Sept 2020,197,138,884,420432301,23193420943,23613853244,142,858,5,22772988642,In > Out
Sept 2020,197,139,345,204339138,12447423123,12651762261,94,344,2,12243083985,In > Out
Sept 2020,197,14,168,282329235,3398054629,3680383864,77,168,4,3115725394,In > Out
Sept 2020,197,140,523,189073065,11875689384,12064762449,90,519,5,11686616319,In > Out
Sept 2020,197,141,529,107266341,315820399,423086740,91,529,2,208554058,In > Out
Sept 2020,197,142,98,6769849,164276533,171046382,51,98,4,157506684,In > Out
Sept 2020,197,143,483,434366133,3413756551,3848122684,123,472,5,2979390418,In > Out
Sept 2020,197,144,260,2316737972,4697286212,7014024184,93,257,10,2380548240,In > Out
Sept 2020,197,145,213,1026379384,4684172949,5710552333,47,213,4,3657793565,In > Out
Sept 2020,197,146,205,292580880,1295273772,1587854652,74,204,8,1002692892,In > Out
Sept 2020,197,148,92,6771455,277399419,284170874,42,91,6,270627964,In > Out
Sept 2020,197,149,278,4911535565,4907094607,9818630172,73,278,5,4440958,Out > In
Sept 2020,197,15,222,30389255,935696429,966085684,90,221,5,905307174,In > Out
Sept 2020,197,150,248,27958097,516811422,544769519,90,247,7,488853325,In > Out
Sept 2020,197,152,78,36062524,879299921,915362445,43,78,3,843237397,In > Out
Sept 2020,197,153,433,1255093390,17066813919,18321907309,122,431,3,15811720529,In > Out
Sept 2020,197,154,123,13904602,415396949,429301551,54,123,3,401492347,In > Out
Sept 2020,197,155,120,98439649,465890455,564330104,57,120,6,367450806,In > Out
Sept 2020,197,156,132,10563713,183998880,194562593,60,131,5,173435167,In > Out
Sept 2020,197,158,304,58478252,2237794144,2296272396,117,303,4,2179315892,In > Out
Sept 2020,197,159,149,35108593,1619048703,1654157296,82,149,2,1583940110,In > Out
Sept 2020,197,16,105,41529692,168450341,209980033,57,105,2,126920649,In > Out
Sept 2020,197,160,98,7343052,156393115,163736167,46,98,1,149050063,In > Out
Sept 2020,197,161,286,72091061,1276975512,1349066573,81,283,4,1204884451,In > Out
Sept 2020,197,162,126,32676433,1200644150,1233320583,55,126,3,1167967717,In > Out
Sept 2020,197,163,555,408257951,308238161,716496112,71,555,3,100019790,Out > In
Sept 2020,197,164,306,36821338,1453893744,1490715082,95,305,4,1417072406,In > Out
Sept 2020,197,165,385,75876145,775352192,851228337,59,379,6,699476047,In > Out
Sept 2020,197,166,102,7602079,114943284,122545363,51,101,2,107341205,In > Out
Sept 2020,197,167,342,224915417,5824117855,6049033272,117,335,5,5599202438,In > Out
Sept 2020,197,168,329,283669723,6197429745,6481099468,135,328,6,5913760022,In > Out
Sept 2020,197,169,125,23795189,232536049,256331238,55,124,4,208740860,In > Out
Sept 2020,197,17,141,21443155,1509975312,1531418467,50,140,2,1488532157,In > Out
Sept 2020,197,170,53,3782091,107259587,111041678,36,53,2,103477496,In > Out
Sept 2020,197,171,215,65669563,1962824104,2028493667,67,215,4,1897154541,In > Out
Sept 2020,197,172,203,92665872,945733311,1038399183,76,201,4,853067439,In > Out
Sept 2020,197,174,161,235545585,636355602,871901187,61,160,4,400810017,In > Out
Sept 2020,197,178,202,97884603,1780365871,1878250474,86,197,8,1682481268,In > Out
Sept 2020,197,179,214,129679112,6790907114,6920586226,89,213,3,6661228002,In > Out
Sept 2020,197,180,150,36721153,306951626,343672779,60,149,4,270230473,In > Out
Sept 2020,197,181,410,265910681,1252380922,1518291603,105,410,6,986470241,In > Out
Sept 2020,197,183,120,28958285,591752760,620711045,55,119,2,562794475,In > Out
Sept 2020,197,184,106,8801078,162831768,171632846,50,106,2,154030690,In > Out
Sept 2020,197,186,2520,91706107,4867193949,4958900056,118,2468,4,4775487842,In > Out
Sept 2020,197,187,290,208895484,928448265,1137343749,118,279,8,719552781,In > Out
Sept 2020,197,188,279,58638643,1738691195,1797329838,70,277,4,1680052552,In > Out
Sept 2020,197,191,168,29508150,303424392,332932542,55,167,4,273916242,In > Out
Sept 2020,197,192,217,45165185,2233572154,2278737339,73,217,4,2188406969,In > Out
Sept 2020,197,193,132,15617162,94328340,109945502,70,132,4,78711178,In > Out
Sept 2020,197,194,238,175537323,1924477179,2100014502,89,236,5,1748939856,In > Out
Sept 2020,197,195,136,45579959,592111896,637691855,57,134,4,546531937,In > Out
Sept 2020,197,196,230,294469590,1339600436,1634070026,109,226,8,1045130846,In > Out
Sept 2020,197,197,148,17017035,692196568,709213603,72,148,4,675179533,In > Out
Sept 2020,197,198,147,49980281,1639136373,1689116654,72,147,4,1589156092,In > Out
Sept 2020,197,199,201,43409531,1002509813,1045919344,82,198,4,959100282,In > Out
Sept 2020,197,20,125,28074894,334205302,362280196,53,125,6,306130408,In > Out
Sept 2020,197,201,193,116472397,547075586,663547983,97,193,3,430603189,In > Out
Sept 2020,197,202,309,128150152,1173240006,1301390158,124,299,4,1045089854,In > Out
Sept 2020,197,204,102,19804771,516031431,535836202,50,102,4,496226660,In > Out
Sept 2020,197,205,358,1478044751,3298429685,4776474436,113,353,7,1820384934,In > Out
Sept 2020,197,206,267,107210609,2248593619,2355804228,128,265,6,2141383010,In > Out
Sept 2020,197,209,238,20096233,819401674,839497907,64,235,2,799305441,In > Out
Sept 2020,197,210,122,27612478,1037880185,1065492663,70,122,4,1010267707,In > Out
Sept 2020,197,211,397,536288749,2756983208,3293271957,106,390,9,2220694459,In > Out
Sept 2020,197,212,380,347025321,1780693263,2127718584,130,379,5,1433667942,In > Out
Sept 2020,197,213,261,179945606,1404784060,1584729666,108,259,4,1224838454,In > Out
Sept 2020,197,214,255,39573624,592826426,632400050,120,252,6,553252802,In > Out
Sept 2020,197,215,202,29326615,506224857,535551472,108,201,7,476898242,In > Out
Sept 2020,197,216,222,84270142,2756498756,2840768898,82,220,2,2672228614,In > Out
Sept 2020,197,219,223,93082797,410018774,503101571,81,221,5,316935977,In > Out
Sept 2020,197,22,133,1221270667,3893525925,5114796592,64,130,5,2672255258,In > Out
Sept 2020,197,221,423,96559233,5589354262,5685913495,123,421,7,5492795029,In > Out
Sept 2020,197,222,41,4220075,263853272,268073347,27,41,3,259633197,In > Out
Sept 2020,197,223,437,551275086,3034346636,3585621722,133,436,6,2483071550,In > Out
Sept 2020,197,24,104,207063103,1964805137,2171868240,59,103,4,1757742034,In > Out
Sept 2020,197,25,902,301430874,18036523329,18337954203,188,888,4,17735092455,In > Out
Sept 2020,197,26,632,409809405,5078533132,5488342537,132,629,3,4668723727,In > Out
Sept 2020,197,27,288,31539682,1366613056,1398152738,40,288,3,1335073374,In > Out
Sept 2020,197,30,168,25285389,1407219313,1432504702,35,166,3,1381933924,In > Out
Sept 2020,197,31,141,24339596,106949605,131289201,72,141,3,82610009,In > Out
Sept 2020,197,32,376,219221576,2298453236,2517674812,128,368,8,2079231660,In > Out
Sept 2020,197,35,257,2767270674,4577486219,7344756893,110,253,7,1810215545,In > Out
Sept 2020,197,37,271,64644700,2684012994,2748657694,102,269,6,2619368294,In > Out
Sept 2020,197,38,86,8492934,229366766,237859700,46,86,2,220873832,In > Out
Sept 2020,197,39,158,31701727,928847160,960548887,68,158,3,897145433,In > Out
Sept 2020,197,4,122,13466687,467735871,481202558,58,122,3,454269184,In > Out
Sept 2020,197,40,147,11069736,154742481,165812217,64,147,4,143672745,In > Out
Sept 2020,197,41,175,59408655,2056281601,2115690256,88,173,3,1996872946,In > Out
Sept 2020,197,42,213,582351684,6657157040,7239508724,94,212,7,6074805356,In > Out
Sept 2020,197,43,148,3282226700,2450944265,5733170965,70,146,6,831282435,Out > In
Sept 2020,197,44,247,22398844,664618538,687017382,94,240,4,642219694,In > Out
Sept 2020,197,45,285,31903390,320647159,352550549,82,284,3,288743769,In > Out
Sept 2020,197,46,154,13160893,316735302,329896195,74,153,3,303574409,In > Out
Sept 2020,197,48,294,151935684,563759120,715694804,82,294,4,411823436,In > Out
Sept 2020,197,49,119,38145352,275955118,314100470,50,118,1,237809766,In > Out
Sept 2020,197,51,134,7842671,95004609,102847280,45,134,1,87161938,In > Out
Sept 2020,197,53,394,449420171,15078216368,15527636539,132,386,6,14628796197,In > Out
Sept 2020,197,54,221,15587285,470429244,486016529,72,221,4,454841959,In > Out
Sept 2020,197,55,171,588587423,579782732,1168370155,78,171,5,8804691,Out > In
Sept 2020,197,57,163,507341597,125722056,633063653,80,160,5,381619541,Out > In
Sept 2020,197,58,89,50134616,2718068949,2768203565,46,89,3,2667934333,In > Out
Sept 2020,197,60,299,3537278390,2172336344,5709614734,127,291,10,1364942046,Out > In
Sept 2020,197,62,410,638160841,3381713264,4019874105,123,396,4,2743552423,In > Out
Sept 2020,197,63,361,105743516,2105926218,2211669734,143,361,3,2000182702,In > Out
Sept 2020,197,64,628,2321159058,5414463882,7735622940,95,556,6,3093304824,In > Out
Sept 2020,197,65,161,28343567,784289383,812632950,70,161,3,755945816,In > Out
Sept 2020,197,66,92,6709252,99774677,106483929,37,92,2,93065425,In > Out
Sept 2020,197,68,160,14719950,308228841,322948791,79,160,3,293508891,In > Out
Sept 2020,197,71,469,727092246,2086388935,2813481181,150,463,7,1359296689,In > Out
Sept 2020,197,72,158,187561893,781497595,969059488,66,158,3,593935702,In > Out
Sept 2020,197,73,239,227428863,557927643,785356506,84,237,7,330498780,In > Out
Sept 2020,197,74,199,79660379,68043416,147703795,65,199,3,11616963,Out > In
Sept 2020,197,75,83,11194810,192606117,203800927,47,83,5,181411307,In > Out
Sept 2020,197,76,68,5920703,33779416,39700119,41,68,4,27858713,In > Out
Sept 2020,197,77,273,93762361,6700468631,6794230992,119,269,6,6606706270,In > Out
Sept 2020,197,78,398,22444775,1013363095,1035807870,58,398,4,990918320,In > Out
Sept 2020,197,79,652,11113791424,4618088309,15731879733,198,639,8,6495703115,Out > In
Sept 2020,197,80,221,1349037321,1896767635,3245804956,80,220,7,547730314,In > Out
Sept 2020,197,81,116,661513919,11835816186,12497330105,67,116,9,11174302267,In > Out
Sept 2020,197,82,418,349962052,1064305845,1414267897,133,417,3,714343793,In > Out
Sept 2020,197,83,338,272886096,5648037786,5920923882,116,336,8,5375151690,In > Out
Sept 2020,197,85,145,185730123,1602743283,1788473406,66,145,1,1417013160,In > Out
Sept 2020,197,86,189,18150408,254738735,272889143,57,189,4,236588327,In > Out
Sept 2020,197,87,212,117281813,2715883198,2833165011,93,212,4,2598601385,In > Out
Sept 2020,197,89,285,84331762,403685896,488017658,124,283,55,319354134,In > Out
Sept 2020,197,9,125,28838575,445278609,474117184,57,125,4,416440034,In > Out
Sept 2020,197,90,197,39996607,1854622421,1894619028,95,196,2,1814625814,In > Out
Sept 2020,197,91,186,30742151,319949763,350691914,92,184,4,289207612,In > Out
Sept 2020,197,92,244,98994339,290412298,389406637,109,243,4,191417959,In > Out
Sept 2020,197,93,173,18857819,344658932,363516751,90,173,7,325801113,In > Out
Sept 2020,197,94,136,17474519,583170706,600645225,47,136,5,565696187,In > Out
Sept 2020,197,95,395,80356750,749761187,830117937,124,388,5,669404437,In > Out
Sept 2020,197,98,187,50661500,2991864244,3042525744,79,186,5,2941202744,In > Out
Sept 2020,197,99,175,41045128,830556584,871601712,81,174,7,789511456,In > Out
Sept 2020,198,22,43699,499182035979,236917803776,736099839755,4412,15300,40,262264232203,Out > In
Sept 2020,2,1,6,457140,388816,845956,2,1,5,68324,Out > In
Sept 2020,2,100,6,157365886,43477085,200842971,3,6,2,113888801,Out > In
Sept 2020,2,13,86,976884,51077890,52054774,12,86,1,50101006,In > Out
Sept 2020,2,14,33,2371450,492131380,494502830,5,33,2,489759930,In > Out
Sept 2020,2,15,2,329590,4640,334230,2,2,2,324950,Out > In
Sept 2020,2,16,133,16557899,906462630,923020529,17,133,2,889904731,In > Out
Sept 2020,2,17,1,846857,7064,853921,1,1,1,839793,Out > In
Sept 2020,2,21,507,51787680,250720461,302508141,55,499,4,198932781,In > Out
Sept 2020,2,244,5,194528,27722044,27916572,1,5,1,27527516,In > Out
Sept 2020,2,253,7,1032004,220643834,221675838,1,7,1,219611830,In > Out
Sept 2020,2,32,1,111006,7460,118466,1,1,1,103546,Out > In
Sept 2020,2,4,2,150632,120156,270788,2,1,2,30476,Out > In
Sept 2020,2,7,29,3712674,902815897,906528571,3,29,1,899103223,In > Out
Sept 2020,2,91,879,11947320325,1465182339186,1477129659511,36,831,31,1453235018861,In > Out
Sept 2020,200,17,5,431855,100855152,101287007,4,5,2,100423297,In > Out
Sept 2020,200,199,48,2696834,206510191,209207025,8,47,2,203813357,In > Out
Sept 2020,200,20,27,2969365,316760300,319729665,8,27,2,313790935,In > Out
Sept 2020,200,200,22,2786465,293594215,296380680,4,22,2,290807750,In > Out
Sept 2020,200,206,652,114073963,169547904,283621867,25,652,2,55473941,In > Out
Sept 2020,200,211,292,8143382,310164561,318307943,12,288,2,302021179,In > Out
Sept 2020,200,22,6212,524617699,790481936,1315099635,8,4906,2,265864237,In > Out
Sept 2020,200,24,25,3520604,289294543,292815147,9,25,2,285773939,In > Out
Sept 2020,200,25,24,1774881,304480812,306255693,4,24,2,302705931,In > Out
Sept 2020,200,33,16,1363191,204782227,206145418,5,16,2,203419036,In > Out
Sept 2020,200,34,101,9716864,162034180,171751044,45,100,2,152317316,In > Out
Sept 2020,200,35,32,3417000,403292736,406709736,9,32,2,399875736,In > Out
Sept 2020,200,36,25,1848332,278677241,280525573,10,25,2,276828909,In > Out
Sept 2020,200,38,25,1721934,223686140,225408074,10,25,2,221964206,In > Out
Sept 2020,200,39,20,1309957,193846737,195156694,10,20,2,192536780,In > Out
Sept 2020,200,40,16,1483707,228310077,229793784,7,16,2,226826370,In > Out
Sept 2020,200,44,9,2544154,134819,2678973,8,9,1,2409335,Out > In
Sept 2020,200,45,25,6416000,307006755,313422755,6,25,2,300590755,In > Out
Sept 2020,200,60,4,951228,60164,1011392,3,4,1,891064,Out > In
Sept 2020,200,61,4,959944,59817,1019761,3,4,1,900127,Out > In
Sept 2020,200,65,13,737022,9459518,10196540,4,13,2,8722496,In > Out
Sept 2020,200,66,9,4171263,151560,4322823,5,9,1,4019703,Out > In
Sept 2020,200,68,40,4267036,184073312,188340348,13,40,2,179806276,In > Out
Sept 2020,200,89,8,2799143,126371,2925514,8,8,1,2672772,Out > In
Sept 2020,200,96,2,482532,22791,505323,2,2,1,459741,Out > In
Sept 2020,203,148,63,3054036,181018375,184072411,23,63,2,177964339,In > Out
Sept 2020,203,158,143,20807894,281603107,302411001,66,142,2,260795213,In > Out
Sept 2020,203,176,2336,329208804,4403255321,4732464125,161,2155,4,4074046517,In > Out
Sept 2020,203,190,275,99774887,178559229,278334116,76,275,3,78784342,In > Out
Sept 2020,203,221,1042,312988880,6219240829,6532229709,227,1016,2,5906251949,In > Out
Sept 2020,203,65,283,91218987,3980518694,4071737681,67,281,3,3889299707,In > Out
Sept 2020,203,91,953,480992914,10111412339,10592405253,161,894,2,9630419425,In > Out
Sept 2020,206,113,218,47028601,3119791553,3166820154,57,202,3,3072762952,In > Out
Sept 2020,206,127,1496,977427268,17815329187,18792756455,341,1445,4,16837901919,In > Out
Sept 2020,206,131,779,112931610,6050515243,6163446853,83,765,2,5937583633,In > Out
Sept 2020,206,132,673,73223963,3250004972,3323228935,88,666,2,3176781009,In > Out
Sept 2020,206,133,565,58960299,3821105522,3880065821,47,543,2,3762145223,In > Out
Sept 2020,206,134,474,61251270,2882396471,2943647741,55,474,2,2821145201,In > Out
Sept 2020,206,135,690,71270489,3572365446,3643635935,112,678,2,3501094957,In > Out
Sept 2020,206,136,466,84166656,4303315344,4387482000,44,466,2,4219148688,In > Out
Sept 2020,206,137,495,82883989,4301814233,4384698222,65,494,2,4218930244,In > Out
Sept 2020,206,138,627,89322379,5360950900,5450273279,84,610,2,5271628521,In > Out
Sept 2020,206,139,487,67904405,4712629462,4780533867,35,483,2,4644725057,In > Out
Sept 2020,206,140,475,97383117,4925566099,5022949216,52,467,2,4828182982,In > Out
Sept 2020,206,141,492,76612230,4999319954,5075932184,59,492,2,4922707724,In > Out
Sept 2020,206,142,484,76419182,4374823250,4451242432,54,484,2,4298404068,In > Out
Sept 2020,206,143,476,83076259,4919636994,5002713253,48,474,2,4836560735,In > Out
Sept 2020,206,144,704,240442454,8075193916,8315636370,88,704,2,7834751462,In > Out
Sept 2020,206,145,485,80232293,4261880451,4342112744,34,485,2,4181648158,In > Out
Sept 2020,206,146,474,90674292,4912920624,5003594916,47,474,2,4822246332,In > Out
Sept 2020,206,147,470,97927687,5133614699,5231542386,57,470,2,5035687012,In > Out
Sept 2020,206,148,454,81662620,4574312030,4655974650,36,454,2,4492649410,In > Out
Sept 2020,206,149,482,70597592,4269217163,4339814755,45,475,2,4198619571,In > Out
Sept 2020,206,150,519,95567863,5287771490,5383339353,56,519,2,5192203627,In > Out
Sept 2020,206,155,482,76248607,4330881724,4407130331,62,482,2,4254633117,In > Out
Sept 2020,206,156,1199,191496128,6650580784,6842076912,238,1147,3,6459084656,In > Out
Sept 2020,206,158,568,95609783,5533046674,5628656457,76,555,2,5437436891,In > Out
Sept 2020,206,161,458,96046980,5033748598,5129795578,46,458,2,4937701618,In > Out
Sept 2020,206,162,551,104392684,5149287061,5253679745,68,551,2,5044894377,In > Out
Sept 2020,206,163,483,89391019,5223449929,5312840948,41,483,2,5134058910,In > Out
Sept 2020,206,164,485,75291347,4841423855,4916715202,41,485,2,4766132508,In > Out
Sept 2020,206,165,559,100326013,5519354498,5619680511,68,557,2,5419028485,In > Out
Sept 2020,206,166,484,81236493,4260374788,4341611281,41,484,2,4179138295,In > Out
Sept 2020,206,167,524,75773830,4527186598,4602960428,61,522,2,4451412768,In > Out
Sept 2020,206,168,539,89972119,4569350805,4659322924,61,539,2,4479378686,In > Out
Sept 2020,206,169,440,73263148,4872555127,4945818275,29,440,2,4799291979,In > Out
Sept 2020,206,170,533,95647002,5282988802,5378635804,61,532,2,5187341800,In > Out
Sept 2020,206,171,485,81233124,4632842390,4714075514,42,484,2,4551609266,In > Out
Sept 2020,206,191,1629,311441516,12293927601,12605369117,228,1522,2,11982486085,In > Out
Sept 2020,206,200,5216,2025626023,37591143279,39616769302,297,4526,5,35565517256,In > Out
Sept 2020,206,201,368,53629546,3525552401,3579181947,34,368,2,3471922855,In > Out
Sept 2020,206,208,56,1154505,39368217,40522722,10,56,2,38213712,In > Out
Sept 2020,206,209,611,780553748,31711555991,32492109739,125,603,2,30931002243,In > Out
Sept 2020,206,246,112,7659335,145376953,153036288,52,112,1,137717618,In > Out
Sept 2020,206,7,367,94294897,4336809046,4431103943,28,363,2,4242514149,In > Out
Sept 2020,206,9,266,32108320171,1506293686899,1538402007070,26,263,2,1474185366728,In > Out
Sept 2020,207,10,215,475486792,1585088077,2060574869,68,215,3,1109601285,In > Out
Sept 2020,207,111,353,40172760,7063141402,7103314162,24,352,2,7022968642,In > Out
Sept 2020,207,127,62,173800741,34313902,208114643,52,1,40,139486839,Out > In
Sept 2020,207,163,185,11785011,396480911,408265922,81,185,2,384695900,In > Out
Sept 2020,207,201,324,100668391,3440003261,3540671652,108,322,3,3339334870,In > Out
Sept 2020,208,104,2,46948,4942283,4989231,1,2,1,4895335,In > Out
Sept 2020,208,105,114,543642,14096211,14639853,1,114,1,13552569,In > Out
Sept 2020,208,109,3,17475,975062,992537,1,3,1,957587,In > Out
Sept 2020,208,112,5,130282,26857618,26987900,4,5,2,26727336,In > Out
Sept 2020,208,119,4,44511,3516590,3561101,3,4,2,3472079,In > Out
Sept 2020,208,125,20,609131,73259661,73868792,3,20,1,72650530,In > Out
Sept 2020,208,128,208,24916762,66897599,91814361,18,207,2,41980837,In > Out
Sept 2020,208,17,4,45040,3625030,3670070,3,4,1,3579990,In > Out
Sept 2020,208,18,3350,554936570,329941444,884878014,3,3159,2,224995126,Out > In
Sept 2020,208,29,5,897071,25039368,25936439,5,5,2,24142297,In > Out
Sept 2020,208,30,9,1223195,5853089,7076284,5,9,2,4629894,In > Out
Sept 2020,208,32,11,6756092,3341101,10097193,5,11,2,3414991,Out > In
Sept 2020,208,39,2,230292,25848340,26078632,1,2,1,25618048,In > Out
Sept 2020,208,40,15,622141,31624555,32246696,12,15,2,31002414,In > Out
Sept 2020,208,41,7,483373,5107623,5590996,7,7,2,4624250,In > Out
Sept 2020,208,44,4,272395,25795524,26067919,3,4,2,25523129,In > Out
Sept 2020,208,47,7,247171,11066596,11313767,5,7,2,10819425,In > Out
Sept 2020,208,48,12,624798,34202249,34827047,9,12,1,33577451,In > Out
Sept 2020,208,49,1,8882,429001,437883,1,1,1,420119,In > Out
Sept 2020,208,50,3,34426,2168122,2202548,2,3,1,2133696,In > Out
Sept 2020,208,52,2,65923,4685433,4751356,1,2,1,4619510,In > Out
Sept 2020,208,56,1,59172,71928,131100,1,1,1,12756,In > Out
Sept 2020,208,58,2,203294,241076,444370,2,2,1,37782,In > Out
Sept 2020,208,59,6,812690,154821861,155634551,4,6,2,154009171,In > Out
Sept 2020,208,60,2,29529,4178775,4208304,2,2,1,4149246,In > Out
Sept 2020,208,64,36,8360327,6580926,14941253,8,36,2,1779401,Out > In
Sept 2020,208,71,1,19346,2524530,2543876,1,1,1,2505184,In > Out
Sept 2020,208,83,42,11716980,115726505,127443485,15,42,3,104009525,In > Out
Sept 2020,208,86,5,316698,35102822,35419520,2,5,2,34786124,In > Out
Sept 2020,208,87,21,1274952,47390659,48665611,6,21,2,46115707,In > Out
Sept 2020,208,88,5,142932,28041318,28184250,2,5,2,27898386,In > Out
Sept 2020,208,89,3,19867,2623270,2643137,3,3,1,2603403,In > Out
Sept 2020,208,90,59,2771602,13202620,15974222,14,59,1,10431018,In > Out
Sept 2020,208,91,37,3376799,51556586,54933385,2,37,1,48179787,In > Out
Sept 2020,208,92,41,4274302,3706978,7981280,1,41,1,567324,Out > In
Sept 2020,208,93,32,2685920,40818050,43503970,5,32,2,38132130,In > Out
Sept 2020,209,100,5,7900763420,866915197,8767678617,4,5,2,7033848223,Out > In
Sept 2020,209,18,402,66725283,610905317,677630600,79,400,2,544180034,In > Out
Sept 2020,209,203,3,278358782,12101989,290460771,1,1,3,266256793,Out > In
Sept 2020,209,204,78,709584306,313610640,1023194946,16,38,44,395973666,Out > In
Sept 2020,209,205,4,295087897,13804088,308891985,1,1,4,281283809,Out > In
Sept 2020,209,214,24,1970392,208928856,210899248,9,24,2,206958464,In > Out
Sept 2020,209,65,3,649277,1206927,1856204,3,3,2,557650,In > Out
Sept 2020,21,185,313,149197467,1797657121,1946854588,106,311,4,1648459654,In > Out
Sept 2020,21,212,8,916963,274350,1191313,2,8,1,642613,Out > In
Sept 2020,21,214,73,6834355,109065315,115899670,36,73,2,102230960,In > Out
Sept 2020,21,216,3,339895,19420213,19760108,1,3,1,19080318,In > Out
Sept 2020,21,219,16,467050,9527139,9994189,4,16,15,9060089,In > Out
Sept 2020,21,246,9,263679,6532713,6796392,9,9,2,6269034,In > Out
Sept 2020,210,12,1001,823036897041,274985716715,1098022613756,699,1,975,548051180326,Out > In
Sept 2020,210,4,319,197325527550,64939880491,262265408041,225,1,318,132385647059,Out > In
Sept 2020,213,1,25991,37286010974,297072949356,334358960330,3566,14845,105,259786938382,In > Out
Sept 2020,213,10,25453,22954610766,194423738368,217378349134,3160,15453,94,171469127602,In > Out
Sept 2020,213,100,37156,20405806143,140533387195,160939193338,3550,17133,61,120127581052,In > Out
Sept 2020,213,101,42175,22146983950,346137843695,368284827645,4001,16417,174,323990859745,In > Out
Sept 2020,213,102,31309,27828167077,210211869962,238040037039,3762,17353,121,182383702885,In > Out
Sept 2020,213,103,28672,26239985588,174265263597,200505249185,3512,14683,62,148025278009,In > Out
Sept 2020,213,104,54381,27589148233,336210188443,363799336676,5562,18860,108,308621040210,In > Out
Sept 2020,213,105,41434,27120910949,221688844891,248809755840,4680,19387,157,194567933942,In > Out
Sept 2020,213,106,28018,36619361736,183996737853,220616099589,3532,14747,79,147377376117,In > Out
Sept 2020,213,107,42382,33117863232,234775106263,267892969495,4197,17407,164,201657243031,In > Out
Sept 2020,213,108,45847,397336697162,228376359520,625713056682,4072,18817,75,168960337642,Out > In
Sept 2020,213,109,36798,79413803456,338111062207,417524865663,4154,17775,81,258697258751,In > Out
Sept 2020,213,11,43017,28255517261,225853213852,254108731113,5413,20345,384,197597696591,In > Out
Sept 2020,213,110,28484,18681153433,163310772784,181991926217,3952,15889,513,144629619351,In > Out
Sept 2020,213,111,36016,31906639726,217238276900,249144916626,4229,17468,102,185331637174,In > Out
Sept 2020,213,112,29768,28913820191,176230164991,205143985182,3593,16645,74,147316344800,In > Out
Sept 2020,213,113,30234,28439453221,239701263336,268140716557,3787,16479,73,211261810115,In > Out
Sept 2020,213,114,33589,21051338317,190890486299,211941824616,4226,16842,65,169839147982,In > Out
Sept 2020,213,115,29117,19461484292,302444254394,321905738686,3788,15185,105,282982770102,In > Out
Sept 2020,213,116,26168,12528522375,193018157347,205546679722,3146,14895,74,180489634972,In > Out
Sept 2020,213,117,39463,23513597369,282646063746,306159661115,4459,16994,107,259132466377,In > Out
Sept 2020,213,118,40679,258990067518,210641894215,469631961733,4280,18188,122,48348173303,Out > In
Sept 2020,213,119,29250,30613965997,245136501971,275750467968,4082,15507,125,214522535974,In > Out
Sept 2020,213,12,37191,26309722455,220176517153,246486239608,3860,16199,68,193866794698,In > Out
Sept 2020,213,120,31881,15493804277,195296061174,210789865451,3849,16477,75,179802256897,In > Out
Sept 2020,213,121,35924,22680703808,259119182956,281799886764,4545,17129,399,236438479148,In > Out
Sept 2020,213,122,29680,31620237811,154915161147,186535398958,3667,15582,69,123294923336,In > Out
Sept 2020,213,123,34723,24289530543,193424603948,217714134491,4715,17585,392,169135073405,In > Out
Sept 2020,213,124,38872,45005708468,484327066713,529332775181,4400,17981,113,439321358245,In > Out
Sept 2020,213,125,24698,26543080542,120270616194,146813696736,3410,15014,65,93727535652,In > Out
Sept 2020,213,126,29024,27680557360,198043078400,225723635760,3624,15579,127,170362521040,In > Out
Sept 2020,213,127,33044,23318456028,236195784528,259514240556,4252,18310,288,212877328500,In > Out
Sept 2020,213,128,36839,22732699683,202871505753,225604205436,4029,17599,88,180138806070,In > Out
Sept 2020,213,129,30901,23683715977,270432217655,294115933632,3880,15962,107,246748501678,In > Out
Sept 2020,213,13,37596,24754571955,287868659535,312623231490,4118,17706,65,263114087580,In > Out
Sept 2020,213,130,29747,35764621264,266561232914,302325854178,3455,15988,87,230796611650,In > Out
Sept 2020,213,131,27265,21279242684,181066254255,202345496939,3832,15199,71,159787011571,In > Out
Sept 2020,213,132,32651,29493217954,366527695571,396020913525,4166,16781,83,337034477617,In > Out
Sept 2020,213,133,51636,48486311278,496920461936,545406773214,5543,20858,292,448434150658,In > Out
Sept 2020,213,134,30988,19431690947,190928000728,210359691675,3482,16387,104,171496309781,In > Out
Sept 2020,213,135,22123,31278475952,231715535134,262994011086,2970,13475,74,200437059182,In > Out
Sept 2020,213,136,36302,11023754232,181100287911,192124042143,3641,17923,68,170076533679,In > Out
Sept 2020,213,137,31821,27993744895,205211291753,233205036648,4053,16647,110,177217546858,In > Out
Sept 2020,213,138,38790,38732126915,244380718456,283112845371,4376,19135,96,205648591541,In > Out
Sept 2020,213,139,32833,17576540203,249457084630,267033624833,3952,17037,147,231880544427,In > Out
Sept 2020,213,14,28799,31770231031,418314192232,450084423263,3729,15303,116,386543961201,In > Out
Sept 2020,213,140,35718,26594805450,292052966909,318647772359,4281,16747,93,265458161459,In > Out
Sept 2020,213,141,34819,17217685680,193959987390,211177673070,3494,17572,77,176742301710,In > Out
Sept 2020,213,142,35721,17493052847,245233592482,262726645329,3320,18561,204,227740539635,In > Out
Sept 2020,213,143,32677,42562345341,270365476592,312927821933,3777,16433,173,227803131251,In > Out
Sept 2020,213,144,29788,29294911465,224816716649,254111628114,3905,15881,201,195521805184,In > Out
Sept 2020,213,145,38424,45766726079,692055826174,737822552253,4404,18160,288,646289100095,In > Out
Sept 2020,213,146,32447,38218573033,246614174407,284832747440,4235,16372,104,208395601374,In > Out
Sept 2020,213,147,23799,13311662731,130691505920,144003168651,3129,14196,69,117379843189,In > Out
Sept 2020,213,148,26959,25996909822,167032681226,193029591048,3394,15615,71,141035771404,In > Out
Sept 2020,213,149,29486,30642966642,248806961131,279449927773,4095,15792,165,218163994489,In > Out
Sept 2020,213,15,40630,24782970997,246577815307,271360786304,4344,17446,80,221794844310,In > Out
Sept 2020,213,150,41462,28859668861,266257183060,295116851921,4504,18328,129,237397514199,In > Out
Sept 2020,213,151,43381,283506779516,821170523791,1104677303307,3787,18072,63,537663744275,In > Out
Sept 2020,213,152,29818,69071755078,165699223958,234770979036,4312,15578,839,96627468880,In > Out
Sept 2020,213,153,35049,22700209221,230979687889,253679897110,3842,16765,90,208279478668,In > Out
Sept 2020,213,154,40114,28625691354,252030053898,280655745252,4510,17551,253,223404362544,In > Out
Sept 2020,213,155,40442,55964515310,314409876624,370374391934,4435,18209,213,258445361314,In > Out
Sept 2020,213,156,25977,20027790368,194671031752,214698822120,3676,15369,62,174643241384,In > Out
Sept 2020,213,157,28239,18668133789,151312609798,169980743587,3539,16360,89,132644476009,In > Out
Sept 2020,213,158,31088,23878120639,203773606521,227651727160,3552,17856,137,179895485882,In > Out
Sept 2020,213,159,28557,21870854619,203541436856,225412291475,3819,15738,72,181670582237,In > Out
Sept 2020,213,16,31576,20716247900,203913952582,224630200482,3990,15399,110,183197704682,In > Out
Sept 2020,213,160,36176,28703694355,203537478783,232241173138,4173,16248,93,174833784428,In > Out
Sept 2020,213,161,32979,18909479419,323770459938,342679939357,4047,17389,159,304860980519,In > Out
Sept 2020,213,162,34770,32819949066,199238780390,232058729456,3857,18675,128,166418831324,In > Out
Sept 2020,213,163,22947,12035143252,208856351744,220891494996,3233,13674,104,196821208492,In > Out
Sept 2020,213,164,26644,22579747576,185812918050,208392665626,3808,15371,87,163233170474,In > Out
Sept 2020,213,165,38473,36393238981,199870327760,236263566741,4202,18840,93,163477088779,In > Out
Sept 2020,213,166,34698,22090531908,160745443891,182835975799,3818,19070,130,138654911983,In > Out
Sept 2020,213,167,31459,34063571892,162561446374,196625018266,3825,16217,104,128497874482,In > Out
Sept 2020,213,168,44309,48377014385,233965966183,282342980568,4480,18604,109,185588951798,In > Out
Sept 2020,213,169,35801,33543454146,187058152420,220601606566,3856,18147,187,153514698274,In > Out
Sept 2020,213,17,41537,38955070215,509806217203,548761287418,4685,19095,104,470851146988,In > Out
Sept 2020,213,170,27534,16076204567,195485582144,211561786711,3869,14238,358,179409377577,In > Out
Sept 2020,213,171,26729,21120840849,207318167898,228439008747,3555,14933,79,186197327049,In > Out
Sept 2020,213,172,25685,15659600434,156968051189,172627651623,3462,14848,60,141308450755,In > Out
Sept 2020,213,173,28859,29060515174,151600482167,180660997341,3523,16356,95,122539966993,In > Out
Sept 2020,213,174,25808,26066926952,116266201592,142333128544,2976,15835,79,90199274640,In > Out
Sept 2020,213,175,34636,24668902711,279175091259,303843993970,3603,18331,163,254506188548,In > Out
Sept 2020,213,176,29987,30586014216,222742241688,253328255904,3786,16127,223,192156227472,In > Out
Sept 2020,213,177,21393,23393671313,109145765632,132539436945,2952,14229,61,85752094319,In > Out
Sept 2020,213,178,31154,20679778397,185514588213,206194366610,3911,17096,98,164834809816,In > Out
Sept 2020,213,179,23055,98759927469,172253593127,271013520596,3127,14108,129,73493665658,In > Out
Sept 2020,213,18,28618,21848253910,245885857477,267734111387,3345,16868,95,224037603567,In > Out
Sept 2020,213,180,24599,18333429069,108432330918,126765759987,3344,14232,77,90098901849,In > Out
Sept 2020,213,181,18089,16741104278,163098791515,179839895793,3043,12036,187,146357687237,In > Out
Sept 2020,213,182,32244,27229552540,246798352125,274027904665,3728,16420,225,219568799585,In > Out
Sept 2020,213,183,23532,19898836836,135595962352,155494799188,3426,14376,179,115697125516,In > Out
Sept 2020,213,184,26492,17424415453,136547601284,153972016737,3455,15128,258,119123185831,In > Out
Sept 2020,213,185,28800,20028789554,124582942072,144611731626,4008,15735,265,104554152518,In > Out
Sept 2020,213,186,19766,16105891632,144566437754,160672329386,2906,12766,123,128460546122,In > Out
Sept 2020,213,187,23962,11802880595,124791031641,136593912236,3230,15190,55,112988151046,In > Out
Sept 2020,213,188,51138,32134942238,331671296609,363806238847,3491,19520,112,299536354371,In > Out
Sept 2020,213,189,20661,10698373590,104057744485,114756118075,2780,14398,54,93359370895,In > Out
Sept 2020,213,19,24843,18238811412,153262340395,171501151807,3277,14977,182,135023528983,In > Out
Sept 2020,213,190,28500,16178298159,206687773765,222866071924,3341,15469,251,190509475606,In > Out
Sept 2020,213,191,26628,36250287230,195986061299,232236348529,3661,14567,221,159735774069,In > Out
Sept 2020,213,192,27833,20482603649,175620547945,196103151594,3370,15313,71,155137944296,In > Out
Sept 2020,213,193,17138,22055511311,123851423909,145906935220,3055,11632,522,101795912598,In > Out
Sept 2020,213,194,20647,11349454689,105507686284,116857140973,2774,13328,47,94158231595,In > Out
Sept 2020,213,195,17284,10562032985,108710532140,119272565125,2616,12249,58,98148499155,In > Out
Sept 2020,213,196,24367,28863074419,161523489683,190386564102,3372,13803,274,132660415264,In > Out
Sept 2020,213,197,18896,11495861334,148455947674,159951809008,2860,12357,55,136960086340,In > Out
Sept 2020,213,198,27288,40778865471,128247484283,169026349754,3620,14954,125,87468618812,In > Out
Sept 2020,213,199,21034,23995457023,269591394635,293586851658,3193,13522,77,245595937612,In > Out
Sept 2020,213,2,41235,35620117017,242563717008,278183834025,4649,17966,140,206943599991,In > Out
Sept 2020,213,20,35948,26658941785,271458311168,298117252953,4009,18564,88,244799369383,In > Out
Sept 2020,213,200,33751,26518428619,211972251090,238490679709,4340,16577,208,185453822471,In > Out
Sept 2020,213,201,19276,9133719717,94981761176,104115480893,2841,12291,46,85848041459,In > Out
Sept 2020,213,202,15412,12181882022,104359711593,116541593615,2359,10867,55,92177829571,In > Out
Sept 2020,213,203,21079,10181096287,157677688001,167858784288,3039,13505,64,147496591714,In > Out
Sept 2020,213,204,20318,15278276272,118975517155,134253793427,2872,13160,71,103697240883,In > Out
Sept 2020,213,205,22042,10774138917,164827651598,175601790515,3067,13344,215,154053512681,In > Out
Sept 2020,213,206,22206,51057136088,132223147569,183280283657,2559,14291,54,81166011481,In > Out
Sept 2020,213,207,20115,11304685594,106294260087,117598945681,2763,12667,47,94989574493,In > Out
Sept 2020,213,208,16101,13849899596,142966293692,156816193288,2453,11003,88,129116394096,In > Out
Sept 2020,213,209,40506,20991223485,345375989107,366367212592,4223,18674,93,324384765622,In > Out
Sept 2020,213,21,32140,31594926252,222821600463,254416526715,4038,16466,170,191226674211,In > Out
Sept 2020,213,210,17575,10059219305,99590443097,109649662402,2473,12260,91,89531223792,In > Out
Sept 2020,213,211,16919,8041725754,139279907906,147321633660,2415,11542,37,131238182152,In > Out
Sept 2020,213,212,18592,10289764233,109646929207,119936693440,2650,12352,103,99357164974,In > Out
Sept 2020,213,213,13732,9452856419,83094383721,92547240140,2277,9922,37,73641527302,In > Out
Sept 2020,213,214,28926,12733370279,157233269635,169966639914,3719,15558,105,144499899356,In > Out
Sept 2020,213,215,24216,16711841862,152961723374,169673565236,3337,14352,84,136249881512,In > Out
Sept 2020,213,216,24363,36853653890,159556203597,196409857487,3313,15283,68,122702549707,In > Out
Sept 2020,213,217,30810,98152193077,136990062606,235142255683,4003,16516,463,38837869529,In > Out
Sept 2020,213,218,21447,15240192149,138216081685,153456273834,3181,13975,85,122975889536,In > Out
Sept 2020,213,219,21595,20536327807,144957030638,165493358445,2845,13537,68,124420702831,In > Out
Sept 2020,213,22,22198,14067245403,127749737982,141816983385,3052,13485,59,113682492579,In > Out
Sept 2020,213,220,18410,16848015667,113830623848,130678639515,2736,12129,65,96982608181,In > Out
Sept 2020,213,221,26237,22283172794,203676348792,225959521586,3269,14962,55,181393175998,In > Out
Sept 2020,213,222,16902,12279809469,73318641161,85598450630,2525,11545,48,61038831692,In > Out
Sept 2020,213,223,15285,14722519770,131510558741,146233078511,2455,10426,111,116788038971,In > Out
Sept 2020,213,224,21851,12797561659,171129258157,183926819816,3399,13290,73,158331696498,In > Out
Sept 2020,213,225,17893,12205111158,139917989054,152123100212,2587,11899,45,127712877896,In > Out
Sept 2020,213,226,27329,18143690702,212245254243,230388944945,3836,14559,54,194101563541,In > Out
Sept 2020,213,227,21714,37165487850,94103343267,131268831117,2545,13152,56,56937855417,In > Out
Sept 2020,213,228,26266,21107944573,131322219397,152430163970,3152,15103,315,110214274824,In > Out
Sept 2020,213,229,31311,50791647421,390242848515,441034495936,3678,15163,66,339451201094,In > Out
Sept 2020,213,23,35818,33781553950,317214949714,350996503664,4326,16499,87,283433395764,In > Out
Sept 2020,213,230,20848,12288761328,186461181240,198749942568,2765,13445,58,174172419912,In > Out
Sept 2020,213,231,30417,18224274680,206571776859,224796051539,4233,17490,175,188347502179,In > Out
Sept 2020,213,232,22420,18177085288,127732664242,145909749530,2903,13156,90,109555578954,In > Out
Sept 2020,213,233,20224,21543316570,98580545405,120123861975,3034,12775,52,77037228835,In > Out
Sept 2020,213,234,20139,23581899837,94619234558,118201134395,3149,12723,199,71037334721,In > Out
Sept 2020,213,235,21446,20691387883,144531584702,165222972585,3295,13493,79,123840196819,In > Out
Sept 2020,213,236,24685,12527063479,129478058594,142005122073,3133,16402,59,116950995115,In > Out
Sept 2020,213,237,27881,21488342116,305148935489,326637277605,3630,15341,79,283660593373,In > Out
Sept 2020,213,238,33281,20214687557,241768969497,261983657054,3879,17348,262,221554281940,In > Out
Sept 2020,213,239,23910,24614573899,158897355125,183511929024,3289,14814,69,134282781226,In > Out
Sept 2020,213,24,37298,46905154033,348195136368,395100290401,4559,17384,126,301289982335,In > Out
Sept 2020,213,240,24192,18663419154,160510681551,179174100705,3166,13874,65,141847262397,In > Out
Sept 2020,213,241,29287,33652968456,357522720893,391175689349,3501,16165,95,323869752437,In > Out
Sept 2020,213,242,44803,56421539140,185767602356,242189141496,3196,19283,75,129346063216,In > Out
Sept 2020,213,243,38585,31110495011,261060379095,292170874106,4353,18511,78,229949884084,In > Out
Sept 2020,213,244,21584,26625807932,135791534192,162417342124,3228,13787,61,109165726260,In > Out
Sept 2020,213,245,29695,35740116085,945152552514,980892668599,3601,14381,74,909412436429,In > Out
Sept 2020,213,246,49086,100015043886,303134447003,403149490889,4049,17812,257,203119403117,In > Out
Sept 2020,213,247,32757,28452809839,194975044917,223427854756,3907,16887,157,166522235078,In > Out
Sept 2020,213,248,19522,17248626649,163111147923,180359774572,2838,13019,122,145862521274,In > Out
Sept 2020,213,249,25414,21481905822,177653531488,199135437310,3370,14690,74,156171625666,In > Out
Sept 2020,213,25,37073,24584850265,248288048534,272872898799,3838,17694,70,223703198269,In > Out
Sept 2020,213,250,27881,17167072144,176338976057,193506048201,3761,15017,187,159171903913,In > Out
Sept 2020,213,251,32194,26013351950,203811747392,229825099342,3882,16356,60,177798395442,In > Out
Sept 2020,213,252,35587,31543079655,367472358158,399015437813,4872,17204,167,335929278503,In > Out
Sept 2020,213,253,36568,35518110562,356091919698,391610030260,4137,18012,79,320573809136,In > Out
Sept 2020,213,254,25352,31879178691,137663073782,169542252473,3174,13808,99,105783895091,In > Out
Sept 2020,213,26,35583,25875396279,220144576386,246019972665,4689,18717,586,194269180107,In > Out
Sept 2020,213,27,40113,27969340160,277674752400,305644092560,4392,17948,125,249705412240,In > Out
Sept 2020,213,28,39922,35862548331,247075991945,282938540276,4757,16960,509,211213443614,In > Out
Sept 2020,213,29,28466,94229900276,272496229425,366726129701,4175,16465,218,178266329149,In > Out
Sept 2020,213,3,28770,35176959529,140222009188,175398968717,3348,14731,214,105045049659,In > Out
Sept 2020,213,30,32482,171422188688,279692602522,451114791210,3394,15262,53,108270413834,In > Out
Sept 2020,213,31,25926,17229155032,170840346406,188069501438,3681,15208,330,153611191374,In > Out
Sept 2020,213,32,36940,1022843213574,547302684406,1570145897980,3976,17852,78,475540529168,Out > In
Sept 2020,213,33,29494,19979892705,188714513796,208694406501,3810,16047,332,168734621091,In > Out
Sept 2020,213,34,32527,36188450766,338144922594,374333373360,4010,15420,81,301956471828,In > Out
Sept 2020,213,35,31238,18795658984,311991614765,330787273749,3993,17604,152,293195955781,In > Out
Sept 2020,213,36,38646,27470577765,445994114418,473464692183,4166,16985,171,418523536653,In > Out
Sept 2020,213,37,32584,37118486516,269707250037,306825736553,4046,18274,134,232588763521,In > Out
Sept 2020,213,38,50011,28865773309,328067813738,356933587047,4728,19169,307,299202040429,In > Out
Sept 2020,213,39,39974,34394080517,299069525531,333463606048,3825,18552,103,264675445014,In > Out
Sept 2020,213,4,33767,17003416152,261997572579,279000988731,4270,17816,195,244994156427,In > Out
Sept 2020,213,40,24279,14822758334,249099608772,263922367106,3509,14425,81,234276850438,In > Out
Sept 2020,213,41,41964,24654637712,301814226562,326468864274,4050,19758,135,277159588850,In > Out
Sept 2020,213,42,40700,78318262165,397939743819,476258005984,4815,16579,130,319621481654,In > Out
Sept 2020,213,43,38591,34053472891,488678768498,522732241389,4572,15940,153,454625295607,In > Out
Sept 2020,213,44,54628,134932595028,436586412062,571519007090,5511,18156,633,301653817034,In > Out
Sept 2020,213,45,29322,17367418386,207949445477,225316863863,3543,16765,127,190582027091,In > Out
Sept 2020,213,46,46992,38840634632,293871350029,332711984661,5524,18321,217,255030715397,In > Out
Sept 2020,213,47,43030,27647542166,354210496554,381858038720,4843,17749,98,326562954388,In > Out
Sept 2020,213,48,31094,22929275311,220402512932,243331788243,4061,16013,71,197473237621,In > Out
Sept 2020,213,49,25712,55122467864,172585704884,227708172748,3215,15082,70,117463237020,In > Out
Sept 2020,213,5,35813,41441318482,244091013694,285532332176,4308,18042,86,202649695212,In > Out
Sept 2020,213,50,33942,33593943608,236438104054,270032047662,3477,15839,89,202844160446,In > Out
Sept 2020,213,51,33856,41268928368,156180219534,197449147902,3148,17313,120,114911291166,In > Out
Sept 2020,213,52,27175,15669219283,203528407997,219197627280,3373,15015,70,187859188714,In > Out
Sept 2020,213,53,44421,19942137138,225358034395,245300171533,3767,20059,71,205415897257,In > Out
Sept 2020,213,54,40266,16537074922,301399556198,317936631120,4300,19047,125,284862481276,In > Out
Sept 2020,213,55,63802,35378996295,609384955120,644763951415,4213,19122,137,574005958825,In > Out
Sept 2020,213,56,41472,42215234157,226915893981,269131128138,4684,19495,267,184700659824,In > Out
Sept 2020,213,57,35146,57422161729,369544914421,426967076150,4388,16922,202,312122752692,In > Out
Sept 2020,213,58,36946,32647542677,210262345247,242909887924,3543,16993,88,177614802570,In > Out
Sept 2020,213,59,37308,36040042163,233544792381,269584834544,3692,18270,187,197504750218,In > Out
Sept 2020,213,6,25702,32023265073,205385747222,237409012295,3718,14585,355,173362482149,In > Out
Sept 2020,213,60,38754,33899237545,292777044098,326676281643,4867,18760,130,258877806553,In > Out
Sept 2020,213,61,28482,18547532306,133088895796,151636428102,3407,16258,123,114541363490,In > Out
Sept 2020,213,62,35316,32237472131,210377290228,242614762359,4408,16822,365,178139818097,In > Out
Sept 2020,213,63,86718,29944226096,278361644991,308305871087,4202,20842,68,248417418895,In > Out
Sept 2020,213,64,35628,59009279144,214087952219,273097231363,4398,17830,204,155078673075,In > Out
Sept 2020,213,65,31627,23141684129,205415701937,228557386066,4387,15796,558,182274017808,In > Out
Sept 2020,213,66,24415,23040452794,154147033674,177187486468,3242,14083,108,131106580880,In > Out
Sept 2020,213,67,30923,21992060487,214953228733,236945289220,3702,15988,106,192961168246,In > Out
Sept 2020,213,68,35798,30136061935,249387073759,279523135694,4458,17807,394,219251011824,In > Out
Sept 2020,213,69,33140,30906525648,194122820299,225029345947,3834,16353,89,163216294651,In > Out
Sept 2020,213,7,30167,18474539641,186349071365,204823611006,3827,16875,84,167874531724,In > Out
Sept 2020,213,70,31850,26114245785,253263512649,279377758434,3826,16052,103,227149266864,In > Out
Sept 2020,213,71,33804,20162795414,255890550417,276053345831,4002,17467,77,235727755003,In > Out
Sept 2020,213,72,28527,30067250066,135844972283,165912222349,3501,15926,74,105777722217,In > Out
Sept 2020,213,73,30457,42289389217,370063371127,412352760344,3971,16122,113,327773981910,In > Out
Sept 2020,213,74,33396,34893395815,181653510758,216546906573,4175,17666,143,146760114943,In > Out
Sept 2020,213,75,33316,28783185472,231310689124,260093874596,3987,16919,94,202527503652,In > Out
Sept 2020,213,76,36839,49372945413,348317152322,397690097735,4184,18429,80,298944206909,In > Out
Sept 2020,213,77,31831,25364783967,307542834344,332907618311,4019,16432,115,282178050377,In > Out
Sept 2020,213,78,31864,15717981362,336499810442,352217791804,4069,16191,101,320781829080,In > Out
Sept 2020,213,79,35115,35815046780,270231032514,306046079294,4189,17695,101,234415985734,In > Out
Sept 2020,213,8,49750,43747097620,488781763853,532528861473,4290,18107,86,445034666233,In > Out
Sept 2020,213,80,23818,12616634737,238907837755,251524472492,3347,14028,80,226291203018,In > Out
Sept 2020,213,81,31283,21833590377,351300839139,373134429516,3901,15678,127,329467248762,In > Out
Sept 2020,213,82,28983,30022649186,188070513185,218093162371,3589,15631,225,158047863999,In > Out
Sept 2020,213,83,26762,36105402643,249482159541,285587562184,3454,14956,57,213376756898,In > Out
Sept 2020,213,84,61195,39595686108,355490931671,395086617779,4025,19424,117,315895245563,In > Out
Sept 2020,213,85,56745,35929546423,447134301921,483063848344,5723,25267,341,411204755498,In > Out
Sept 2020,213,86,39120,24935684056,370679335201,395615019257,4372,17296,132,345743651145,In > Out
Sept 2020,213,87,37261,51238932552,271705569059,322944501611,3945,16833,74,220466636507,In > Out
Sept 2020,213,88,33420,15337788813,187810830521,203148619334,4101,17055,604,172473041708,In > Out
Sept 2020,213,89,25707,17635464333,317945869689,335581334022,3743,14810,111,300310405356,In > Out
Sept 2020,213,9,31300,26608866527,188632628409,215241494936,4024,17001,193,162023761882,In > Out
Sept 2020,213,90,30994,18505549184,176136127218,194641676402,3825,16100,165,157630578034,In > Out
Sept 2020,213,91,32886,28825649235,167839065542,196664714777,3931,16870,122,139013416307,In > Out
Sept 2020,213,92,30059,21953607434,180501343130,202454950564,3749,16128,93,158547735696,In > Out
Sept 2020,213,93,30490,21515881305,176102113464,197617994769,3171,17159,118,154586232159,In > Out
Sept 2020,213,94,30610,24150340756,209241664354,233392005110,3750,16392,99,185091323598,In > Out
Sept 2020,213,95,32596,28147413571,206019357778,234166771349,3894,16998,74,177871944207,In > Out
Sept 2020,213,96,34301,39677712960,226640690341,266318403301,3809,17715,82,186962977381,In > Out
Sept 2020,213,97,35488,24853070658,255029574974,279882645632,4298,17387,273,230176504316,In > Out
Sept 2020,213,98,27643,13715864863,157090679860,170806544723,3449,15068,83,143374814997,In > Out
Sept 2020,213,99,34185,22694149897,215338486563,238032636460,3578,16483,119,192644336666,In > Out
Sept 2020,214,87,52,899706,31013808,31913514,2,43,1,30114102,In > Out
Sept 2020,214,97,25,19925900,2127959504,2147885404,13,25,2,2108033604,In > Out
Sept 2020,215,113,833,8945562405,1477104438,10422666843,385,366,220,7468457967,Out > In
Sept 2020,215,115,1295,152142352,6200991258,6353133610,29,1277,2,6048848906,In > Out
Sept 2020,215,116,517,59761379,2225385212,2285146591,71,507,4,2165623833,In > Out
Sept 2020,215,141,9,46311,1685396,1731707,4,9,1,1639085,In > Out
Sept 2020,215,154,2,315136,104844,419980,2,2,2,210292,Out > In
Sept 2020,215,157,3,50417,4027877,4078294,3,3,1,3977460,In > Out
Sept 2020,215,171,368,101070726,7277822101,7378892827,31,366,2,7176751375,In > Out
Sept 2020,215,172,283,44309813,2129709197,2174019010,66,283,3,2085399384,In > Out
Sept 2020,215,181,710,61041158,2768024052,2829065210,33,709,2,2706982894,In > Out
Sept 2020,215,190,19,728640,45939791,46668431,11,19,1,45211151,In > Out
Sept 2020,215,209,351,53953023,3633611547,3687564570,28,349,2,3579658524,In > Out
Sept 2020,215,215,5998,3247007227,32208696891,35455704118,1006,5050,8,28961689664,In > Out
Sept 2020,215,38,107,3791398,216602647,220394045,25,107,2,212811249,In > Out
Sept 2020,215,47,56,5021134,145826990,150848124,10,56,1,140805856,In > Out
Sept 2020,215,55,175,20382771,744663483,765046254,25,175,2,724280712,In > Out
Sept 2020,215,65,48,1972367,108939817,110912184,20,48,2,106967450,In > Out
Sept 2020,215,74,2,57162,1417996,1475158,2,2,2,1360834,In > Out
Sept 2020,215,76,26,1232375,72197114,73429489,11,26,2,70964739,In > Out
Sept 2020,215,85,1191,65165931,2758409091,2823575022,46,1086,2,2693243160,In > Out
Sept 2020,215,94,262,76748789,3816543122,3893291911,34,262,2,3739794333,In > Out
Sept 2020,215,95,1,41946,1600332,1642278,1,1,1,1558386,In > Out
Sept 2020,215,97,627,120511953,5316630090,5437142043,28,627,2,5196118137,In > Out
Sept 2020,221,102,23,559625,34929697,35489322,11,23,2,34370072,In > Out
Sept 2020,221,109,1964,177215886,1371722627,1548938513,98,1816,2,1194506741,In > Out
Sept 2020,221,117,337,16610306,504667110,521277416,125,333,2,488056804,In > Out
Sept 2020,221,118,288,26435950,3066967041,3093402991,82,262,2,3040531091,In > Out
Sept 2020,221,132,23,224171,13763154,13987325,11,23,2,13538983,In > Out
Sept 2020,221,134,55,11582971,443412939,454995910,29,55,2,431829968,In > Out
Sept 2020,221,136,1422,280843685,822742502,1103586187,229,1388,2,541898817,In > Out
Sept 2020,221,137,1,31021,1140444,1171465,1,1,1,1109423,In > Out
Sept 2020,221,144,211,6532480,192117658,198650138,109,211,3,185585178,In > Out
Sept 2020,221,146,6,683033,40280973,40964006,3,6,2,39597940,In > Out
Sept 2020,221,148,231,38489141,1119425760,1157914901,102,231,2,1080936619,In > Out
Sept 2020,221,153,152,13129469,186974949,200104418,64,151,2,173845480,In > Out
Sept 2020,221,159,301,58106964,1193189118,1251296082,129,299,2,1135082154,In > Out
Sept 2020,221,161,1,4170,128022,132192,1,1,1,123852,In > Out
Sept 2020,221,168,1526,2803905879,7125058310,9928964189,311,1459,10,4321152431,In > Out
Sept 2020,221,176,15,1690959,14787320,16478279,5,15,2,13096361,In > Out
Sept 2020,221,185,2314,225191497,3964324444,4189515941,614,2188,3,3739132947,In > Out
Sept 2020,221,191,2499,1179988194,26055889209,27235877403,418,2356,5,24875901015,In > Out
Sept 2020,221,193,940,5364771217,569437108,5934208325,190,721,149,4795334109,Out > In
Sept 2020,221,198,79,1579483893,183492541,1762976434,56,1,48,1395991352,Out > In
Sept 2020,221,199,262,33394485,726297283,759691768,126,262,2,692902798,In > Out
Sept 2020,221,200,382,190233389,7343891919,7534125308,35,372,2,7153658530,In > Out
Sept 2020,221,214,224,16139412,383600922,399740334,58,224,2,367461510,In > Out
Sept 2020,221,217,32,3294502,28741084,32035586,16,32,2,25446582,In > Out
Sept 2020,221,222,3,229180,4716995,4946175,3,3,2,4487815,In > Out
Sept 2020,221,24,2730,303209004,10566659567,10869868571,396,2511,3,10263450563,In > Out
Sept 2020,221,25,3885,13236233656,6813631339,20049864995,504,3380,161,6422602317,Out > In
Sept 2020,221,36,69,14852658,362072702,376925360,45,69,2,347220044,In > Out
Sept 2020,221,40,334,22453662,817902162,840355824,115,334,2,795448500,In > Out
Sept 2020,221,47,135,19938755,642287001,662225756,39,135,2,622348246,In > Out
Sept 2020,221,57,269,104498331,3128903611,3233401942,80,268,3,3024405280,In > Out
Sept 2020,221,62,2,352974,282256,635230,2,1,2,70718,Out > In
Sept 2020,221,80,317,69683548,4806008703,4875692251,28,315,2,4736325155,In > Out
Sept 2020,221,82,4281,370674110,1696055597,2066729707,108,3833,2,1325381487,In > Out
Sept 2020,221,84,1593,221616020,889701422,1111317442,261,1574,2,668085402,In > Out
Sept 2020,221,97,1927,1121639579,6545250475,7666890054,559,1847,6,5423610896,In > Out
Sept 2020,222,2,2,3932,208740,212672,1,2,1,204808,In > Out
Sept 2020,224,107,430,49299145,1183570815,1232869960,153,430,2,1134271670,In > Out
Sept 2020,224,126,104,157865193,10361041572,10518906765,63,104,2,10203176379,In > Out
Sept 2020,224,151,37,428436,9415643,9844079,8,37,2,8987207,In > Out
Sept 2020,224,201,526,62681941,1430892424,1493574365,145,517,4,1368210483,In > Out
Sept 2020,224,218,206,92627262,6710985487,6803612749,27,206,2,6618358225,In > Out
Sept 2020,224,221,2583,3320789211,21401846346,24722635557,418,2389,5,18081057135,In > Out
Sept 2020,225,101,1129,114200343,6518975020,6633175363,47,1083,2,6404774677,In > Out
Sept 2020,225,122,186,28452745,1234123085,1262575830,80,186,2,1205670340,In > Out
Sept 2020,225,126,413,108595207,7739848294,7848443501,28,413,2,7631253087,In > Out
Sept 2020,225,138,1252,911917961,3103797014,4015714975,276,1200,5,2191879053,In > Out
Sept 2020,225,142,8,457417,43547238,44004655,5,8,1,43089821,In > Out
Sept 2020,225,145,27,494274,10584520,11078794,5,27,1,10090246,In > Out
Sept 2020,225,149,1286,1739572844,9427205238,11166778082,353,1246,4,7687632394,In > Out
Sept 2020,225,152,559,75574595,801689655,877264250,192,559,2,726115060,In > Out
Sept 2020,225,153,125,29692978,1198973568,1228666546,31,125,2,1169280590,In > Out
Sept 2020,225,158,4577,5444538435,18424683443,23869221878,713,4162,5,12980145008,In > Out
Sept 2020,225,160,130,9646039,98195609,107841648,66,130,2,88549570,In > Out
Sept 2020,225,168,2972,152525266,271970642,424495908,90,2855,1,119445376,In > Out
Sept 2020,225,170,4,794181,296715,1090896,4,1,4,497466,Out > In
Sept 2020,225,175,49,34262716,2541896701,2576159417,12,49,2,2507633985,In > Out
Sept 2020,225,176,141,52901256,3499274620,3552175876,27,141,2,3446373364,In > Out
Sept 2020,225,177,163,12927026,278221127,291148153,61,163,2,265294101,In > Out
Sept 2020,225,196,279,25052295,394985741,420038036,113,264,4,369933446,In > Out
Sept 2020,225,200,40,122587453,33704753,156292206,15,40,2,88882700,Out > In
Sept 2020,225,204,1188,536777219,1422145461,1958922680,159,1181,3,885368242,In > Out
Sept 2020,225,21,1,14946,724584,739530,1,1,1,709638,In > Out
Sept 2020,225,210,1,70251,45124,115375,1,1,1,25127,Out > In
Sept 2020,225,218,7,399497,418124,817621,2,7,1,18627,In > Out
Sept 2020,225,222,571,53157783,1032924282,1086082065,210,534,4,979766499,In > Out
Sept 2020,225,224,12,59072,3508104,3567176,1,12,12,3449032,In > Out
Sept 2020,225,23,1532,8497480045,9283040846,17780520891,271,1350,2,785560801,In > Out
Sept 2020,225,232,314,1971812,39325581,41297393,10,314,2,37353769,In > Out
Sept 2020,225,48,227,23499146,657080946,680580092,104,226,2,633581800,In > Out
Sept 2020,225,8,5320,11106020942,18673500802,29779521744,748,4636,8,7567479860,In > Out
Sept 2020,225,82,2978,1150050725,347943380,1497994105,85,2847,2,802107345,Out > In
Sept 2020,225,85,597,13642924,239114667,252757591,90,591,16,225471743,In > Out
Sept 2020,225,86,2,270877,19316595,19587472,1,2,1,19045718,In > Out
Sept 2020,225,91,568,86268634,1150970829,1237239463,232,568,1,1064702195,In > Out
Sept 2020,226,73,189,265999086,780990919,1046990005,111,188,3,514991833,In > Out
Sept 2020,226,78,303,98552644,7174169444,7272722088,34,303,2,7075616800,In > Out
Sept 2020,226,91,16,6662049,355232222,361894271,14,16,2,348570173,In > Out
Sept 2020,228,100,386,132598997,8213752124,8346351121,121,383,2,8081153127,In > Out
Sept 2020,228,103,656,85437522,3431484253,3516921775,184,649,5,3346046731,In > Out
Sept 2020,228,104,894,351652697,16640421643,16992074340,289,885,12,16288768946,In > Out
Sept 2020,228,105,1363,144306241,5164552157,5308858398,279,1333,7,5020245916,In > Out
Sept 2020,228,107,14,1438182,2480527,3918709,10,14,2,1042345,In > Out
Sept 2020,228,11,353,78159454,5351736585,5429896039,80,352,6,5273577131,In > Out
Sept 2020,228,110,1017,2846203105,11301860027,14148063132,257,992,7,8455656922,In > Out
Sept 2020,228,113,3641,4884503949,32441814429,37326318378,622,3436,9,27557310480,In > Out
Sept 2020,228,114,287,37495347,1116395043,1153890390,109,286,7,1078899696,In > Out
Sept 2020,228,116,211,31577978,311429506,343007484,74,210,3,279851528,In > Out
Sept 2020,228,117,6,310774,1110051,1420825,3,6,1,799277,In > Out
Sept 2020,228,119,1219,344200670,5038231549,5382432219,283,1173,7,4694030879,In > Out
Sept 2020,228,12,659,394810141,19274796848,19669606989,198,652,49,18879986707,In > Out
Sept 2020,228,123,921,122743972,2800057924,2922801896,235,910,4,2677313952,In > Out
Sept 2020,228,124,8,654667,5503554,6158221,3,8,2,4848887,In > Out
Sept 2020,228,127,160,365959113,1139404050,1505363163,81,160,4,773444937,In > Out
Sept 2020,228,128,214,120111920,2380089674,2500201594,72,214,7,2259977754,In > Out
Sept 2020,228,131,148,42259272,1028236951,1070496223,96,148,6,985977679,In > Out
Sept 2020,228,132,174,1296707145,1840605528,3137312673,95,174,5,543898383,In > Out
Sept 2020,228,134,203,111148730,1044951796,1156100526,95,203,4,933803066,In > Out
Sept 2020,228,135,379,186789337,1410311763,1597101100,124,377,3,1223522426,In > Out
Sept 2020,228,138,779,856453063,2621925729,3478378792,196,766,8,1765472666,In > Out
Sept 2020,228,14,973,180010105,3677605042,3857615147,257,949,7,3497594937,In > Out
Sept 2020,228,140,371,204039333,2269153223,2473192556,131,369,6,2065113890,In > Out
Sept 2020,228,141,618,196297804,1344281570,1540579374,258,612,6,1147983766,In > Out
Sept 2020,228,142,219,24436328,327777900,352214228,103,217,3,303341572,In > Out
Sept 2020,228,145,239,51189164,462961710,514150874,121,237,2,411772546,In > Out
Sept 2020,228,146,254,20575911,533859454,554435365,72,254,4,513283543,In > Out
Sept 2020,228,149,44,535616451,659094530,1194710981,20,44,5,123478079,In > Out
Sept 2020,228,15,351,608908039,1109265461,1718173500,169,350,7,500357422,In > Out
Sept 2020,228,150,517,1297922999,1469957354,2767880353,126,517,4,172034355,In > Out
Sept 2020,228,151,872,136469910,5205567064,5342036974,184,852,5,5069097154,In > Out
Sept 2020,228,152,180,63671356,1949517968,2013189324,71,180,3,1885846612,In > Out
Sept 2020,228,153,3243,790033385,42665572020,43455605405,757,3069,8,41875538635,In > Out
Sept 2020,228,154,851,214236347,7186791940,7401028287,332,844,4,6972555593,In > Out
Sept 2020,228,155,157,55536908,2427699998,2483236906,49,156,1,2372163090,In > Out
Sept 2020,228,159,620,23236586,772251560,795488146,67,620,2,749014974,In > Out
Sept 2020,228,16,855,221561539,7675981422,7897542961,216,844,8,7454419883,In > Out
Sept 2020,228,160,1272,730673991,7539727826,8270401817,425,1235,4,6809053835,In > Out
Sept 2020,228,161,38,557222992,140356207,697579199,23,38,2,416866785,Out > In
Sept 2020,228,164,108,29775295,646781605,676556900,73,107,10,617006310,In > Out
Sept 2020,228,165,751,313110919,6027393453,6340504372,127,734,6,5714282534,In > Out
Sept 2020,228,168,1317,9464804795,13453240570,22918045365,223,1271,16,3988435775,In > Out
Sept 2020,228,169,65,16942797,392844729,409787526,41,65,2,375901932,In > Out
Sept 2020,228,171,1544,256623137,7499789133,7756412270,426,1470,13,7243165996,In > Out
Sept 2020,228,175,694,2455136067,3817744538,6272880605,218,689,12,1362608471,In > Out
Sept 2020,228,178,2021,581278867,13904171966,14485450833,338,1986,8,13322893099,In > Out
Sept 2020,228,18,5239,5747973943,16903204553,22651178496,707,4390,106,11155230610,In > Out
Sept 2020,228,180,782,547543653,8557253344,9104796997,170,773,7,8009709691,In > Out
Sept 2020,228,181,58,14730910,102393231,117124141,35,58,2,87662321,In > Out
Sept 2020,228,183,1313,162344877,2709629266,2871974143,579,1177,177,2547284389,In > Out
Sept 2020,228,184,1549,333496105,9796198452,10129694557,401,1498,9,9462702347,In > Out
Sept 2020,228,187,948,4071141313,6704575592,10775716905,321,930,11,2633434279,In > Out
Sept 2020,228,191,293,23494446,1571925522,1595419968,153,268,64,1548431076,In > Out
Sept 2020,228,193,78,6972386,253442021,260414407,38,78,3,246469635,In > Out
Sept 2020,228,194,1454,2061275160,8731491339,10792766499,381,1401,7,6670216179,In > Out
Sept 2020,228,195,306,306870335,1460342268,1767212603,110,305,5,1153471933,In > Out
Sept 2020,228,196,420,336185362,18978489193,19314674555,168,420,4,18642303831,In > Out
Sept 2020,228,198,2143,1096770394,10926901508,12023671902,403,2100,12,9830131114,In > Out
Sept 2020,228,199,302,34195555,1745551088,1779746643,98,301,4,1711355533,In > Out
Sept 2020,228,200,347,289249427,1858541394,2147790821,144,347,6,1569291967,In > Out
Sept 2020,228,201,116,64721780,205776096,270497876,46,113,4,141054316,In > Out
Sept 2020,228,202,272,45096375,1656308210,1701404585,103,272,5,1611211835,In > Out
Sept 2020,228,203,39,2222473,142767719,144990192,21,39,2,140545246,In > Out
Sept 2020,228,204,1858,3335596581,18289670796,21625267377,604,1801,28,14954074215,In > Out
Sept 2020,228,206,37,5136653,14928229,20064882,17,37,3,9791576,In > Out
Sept 2020,228,208,1945,1101568956,15927772315,17029341271,401,1854,27,14826203359,In > Out
Sept 2020,228,209,4645,3378622363,32805320364,36183942727,868,4172,7,29426698001,In > Out
Sept 2020,228,21,1006,271319771,6466112499,6737432270,303,1004,4,6194792728,In > Out
Sept 2020,228,210,804,101655905,5462080813,5563736718,199,795,5,5360424908,In > Out
Sept 2020,228,211,416,200146764,11298920549,11499067313,123,415,4,11098773785,In > Out
Sept 2020,228,212,993,4389319462,21907891241,26297210703,229,977,9,17518571779,In > Out
Sept 2020,228,214,1442,1344357385,54456385917,55800743302,328,1365,14,53112028532,In > Out
Sept 2020,228,215,547,195899174,12043783508,12239682682,193,547,3,11847884334,In > Out
Sept 2020,228,216,663,492654974,3947095900,4439750874,224,656,7,3454440926,In > Out
Sept 2020,228,217,2418,174902444,15181397866,15356300310,131,2246,6,15006495422,In > Out
Sept 2020,228,218,191,280669084,443970611,724639695,107,191,2,163301527,In > Out
Sept 2020,228,221,812,122310894,3261411742,3383722636,176,784,6,3139100848,In > Out
Sept 2020,228,23,642,1076310817,3234186574,4310497391,222,609,6,2157875757,In > Out
Sept 2020,228,24,1337,698367278,8612474954,9310842232,414,1318,4,7914107676,In > Out
Sept 2020,228,27,277,2705705257,655797904,3361503161,81,269,4,2049907353,Out > In
Sept 2020,228,30,635,62135133,1831566267,1893701400,210,626,5,1769431134,In > Out
Sept 2020,228,31,72,54715987,772595538,827311525,36,67,5,717879551,In > Out
Sept 2020,228,32,1233,4070639508,16141936405,20212575913,298,1213,12,12071296897,In > Out
Sept 2020,228,33,748,86253865,2366739778,2452993643,228,746,6,2280485913,In > Out
Sept 2020,228,35,523,128329747,1325848190,1454177937,170,520,6,1197518443,In > Out
Sept 2020,228,36,62,4286658,55817082,60103740,31,62,2,51530424,In > Out
Sept 2020,228,37,782,877516935,6411831691,7289348626,190,771,7,5534314756,In > Out
Sept 2020,228,38,1246,194671274,7105730304,7300401578,275,1216,5,6911059030,In > Out
Sept 2020,228,39,298,113250112,858414258,971664370,119,293,3,745164146,In > Out
Sept 2020,228,4,209,26445440,890342448,916787888,74,209,3,863897008,In > Out
Sept 2020,228,41,947,580701202,5865206558,6445907760,261,934,8,5284505356,In > Out
Sept 2020,228,43,121,24779376,342777414,367556790,66,119,6,317998038,In > Out
Sept 2020,228,44,119,13180599,2008610457,2021791056,52,119,4,1995429858,In > Out
Sept 2020,228,45,620,290724762,19310012533,19600737295,142,592,5,19019287771,In > Out
Sept 2020,228,46,389,253833735,877518888,1131352623,133,384,4,623685153,In > Out
Sept 2020,228,47,302,53504699,923620225,977124924,165,300,3,870115526,In > Out
Sept 2020,228,48,438,177703065,4233694765,4411397830,142,438,3,4055991700,In > Out
Sept 2020,228,5,235,136121505,662701919,798823424,104,235,4,526580414,In > Out
Sept 2020,228,51,1195,298263586,18682987577,18981251163,280,1188,3,18384723991,In > Out
Sept 2020,228,52,686,120460118,14309879738,14430339856,145,681,2,14189419620,In > Out
Sept 2020,228,53,1057,248800579,9312636374,9561436953,351,1039,6,9063835795,In > Out
Sept 2020,228,55,578,114694266,2372276620,2486970886,176,578,3,2257582354,In > Out
Sept 2020,228,57,493,350190733,1623344784,1973535517,127,490,6,1273154051,In > Out
Sept 2020,228,58,1764,599236706,3080600837,3679837543,419,1735,11,2481364131,In > Out
Sept 2020,228,61,126,16193268,580457685,596650953,51,126,4,564264417,In > Out
Sept 2020,228,62,68,35708274,522792248,558500522,40,68,6,487083974,In > Out
Sept 2020,228,63,147,8478606,274814871,283293477,46,147,2,266336265,In > Out
Sept 2020,228,65,311,1294788516,11521657559,12816446075,139,311,3,10226869043,In > Out
Sept 2020,228,67,2699,720369962,39293979069,40014349031,307,2563,3,38573609107,In > Out
Sept 2020,228,68,1827,235510155,13171608362,13407118517,406,1758,8,12936098207,In > Out
Sept 2020,228,70,509,575303875,4370919787,4946223662,155,503,9,3795615912,In > Out
Sept 2020,228,71,61,3111957,77675163,80787120,30,61,1,74563206,In > Out
Sept 2020,228,72,1804,575926336,5708388149,6284314485,288,1728,7,5132461813,In > Out
Sept 2020,228,74,1015,1415210680,11790563969,13205774649,197,1008,9,10375353289,In > Out
Sept 2020,228,79,994,505809857,88841264954,89347074811,337,979,5,88335455097,In > Out
Sept 2020,228,8,1450,413605256,8991765230,9405370486,484,1393,7,8578159974,In > Out
Sept 2020,228,81,68,20550706,136936424,157487130,37,67,5,116385718,In > Out
Sept 2020,228,82,1835,800937066,11573414958,12374352024,345,1763,10,10772477892,In > Out
Sept 2020,228,85,1379,2166926488,8810448747,10977375235,382,1327,10,6643522259,In > Out
Sept 2020,228,9,700,502332568,2536806792,3039139360,148,678,7,2034474224,In > Out
Sept 2020,228,92,1919,2076747674,25736436875,27813184549,419,1823,13,23659689201,In > Out
Sept 2020,228,95,397,17974374,565795563,583769937,99,397,2,547821189,In > Out
Sept 2020,228,97,1645,1051856854,96279748740,97331605594,404,1577,5,95227891886,In > Out
Sept 2020,228,98,447,548113209,1293344744,1841457953,151,445,5,745231535,In > Out
Sept 2020,229,103,673,316647792,3644043207,3960690999,202,662,4,3327395415,In > Out
Sept 2020,229,104,482,164497520,6937527106,7102024626,159,478,11,6773029586,In > Out
Sept 2020,229,107,644,150402225,4020892265,4171294490,213,624,4,3870490040,In > Out
Sept 2020,229,108,53,2946322,104787932,107734254,20,53,2,101841610,In > Out
Sept 2020,229,109,1787,9195224107,13315402189,22510626296,410,1726,11,4120178082,In > Out
Sept 2020,229,11,544,456037061,947051498,1403088559,219,522,5,491014437,In > Out
Sept 2020,229,110,561,90252044,9406888966,9497141010,222,554,5,9316636922,In > Out
Sept 2020,229,111,842,295265561,11375948116,11671213677,254,837,7,11080682555,In > Out
Sept 2020,229,115,195,20854793,547197398,568052191,85,195,3,526342605,In > Out
Sept 2020,229,118,270,1105257507,4292584591,5397842098,92,270,6,3187327084,In > Out
Sept 2020,229,119,317,190661703,3395867857,3586529560,134,317,6,3205206154,In > Out
Sept 2020,229,120,669,214077697,7416491713,7630569410,257,663,4,7202414016,In > Out
Sept 2020,229,122,1620,355400400,6638498010,6993898410,414,1594,6,6283097610,In > Out
Sept 2020,229,123,25,1793899,22748636,24542535,10,25,1,20954737,In > Out
Sept 2020,229,124,1122,789364535,41592215081,42381579616,260,1101,6,40802850546,In > Out
Sept 2020,229,125,125,10291991,250990205,261282196,70,125,7,240698214,In > Out
Sept 2020,229,126,905,229239815,6756159352,6985399167,160,894,6,6526919537,In > Out
Sept 2020,229,127,538,154670941,6941217620,7095888561,202,529,3,6786546679,In > Out
Sept 2020,229,128,1900,582582685,11506143168,12088725853,151,1793,2,10923560483,In > Out
Sept 2020,229,129,885,373719830,5355700000,5729419830,298,861,9,4981980170,In > Out
Sept 2020,229,130,1568,3095810409,12953955246,16049765655,244,1528,8,9858144837,In > Out
Sept 2020,229,132,393,156940960,2769598136,2926539096,118,390,6,2612657176,In > Out
Sept 2020,229,133,424,95825575,1710165846,1805991421,141,424,5,1614340271,In > Out
Sept 2020,229,134,143,63220828,284088162,347308990,40,142,6,220867334,In > Out
Sept 2020,229,135,533,51891759,1463444431,1515336190,185,531,3,1411552672,In > Out
Sept 2020,229,136,648,166181251,4930493858,5096675109,249,644,7,4764312607,In > Out
Sept 2020,229,137,553,1764863918,9005678341,10770542259,239,549,8,7240814423,In > Out
Sept 2020,229,138,530,71190506,4077130471,4148320977,120,508,5,4005939965,In > Out
Sept 2020,229,139,1569,857009796,9558129549,10415139345,374,1515,7,8701119753,In > Out
Sept 2020,229,14,393,144076874,1950418588,2094495462,97,387,7,1806341714,In > Out
Sept 2020,229,142,1384,222317868,5713085782,5935403650,238,1336,5,5490767914,In > Out
Sept 2020,229,143,361,191752299,1959833715,2151586014,145,357,4,1768081416,In > Out
Sept 2020,229,144,287,40125908,1052886992,1093012900,117,265,26,1012761084,In > Out
Sept 2020,229,145,541,532271212,6817051976,7349323188,174,538,6,6284780764,In > Out
Sept 2020,229,146,686,370260687,1532313884,1902574571,172,677,21,1162053197,In > Out
Sept 2020,229,147,702,229017996,18001498622,18230516618,240,698,8,17772480626,In > Out
Sept 2020,229,148,801,426903936,2554942730,2981846666,244,786,9,2128038794,In > Out
Sept 2020,229,149,2037,502566124,13024266663,13526832787,363,1953,7,12521700539,In > Out
Sept 2020,229,15,597,207010607,3859030465,4066041072,222,587,3,3652019858,In > Out
Sept 2020,229,150,329,1460147196,2411248946,3871396142,130,327,4,951101750,In > Out
Sept 2020,229,151,1995,624696425,9829769687,10454466112,323,1869,7,9205073262,In > Out
Sept 2020,229,153,998,295943903,4136295828,4432239731,259,986,9,3840351925,In > Out
Sept 2020,229,154,331,35561575,3695252481,3730814056,115,329,4,3659690906,In > Out
Sept 2020,229,155,822,382976311,3899074953,4282051264,224,810,5,3516098642,In > Out
Sept 2020,229,156,2277,3861176341,21038192659,24899369000,611,2196,17,17177016318,In > Out
Sept 2020,229,157,1260,1280140871,15760654542,17040795413,342,1244,5,14480513671,In > Out
Sept 2020,229,158,1721,535613726,10598197076,11133810802,373,1658,17,10062583350,In > Out
Sept 2020,229,159,555,616184835,4542615095,5158799930,192,536,3,3926430260,In > Out
Sept 2020,229,160,895,1462760212,7417647210,8880407422,290,882,7,5954886998,In > Out
Sept 2020,229,168,305,22096410,1271229122,1293325532,119,300,5,1249132712,In > Out
Sept 2020,229,170,382,161194877,4550679989,4711874866,99,381,2,4389485112,In > Out
Sept 2020,229,171,429,72773080,2588877911,2661650991,141,424,6,2516104831,In > Out
Sept 2020,229,174,780,381081537,12388101154,12769182691,201,748,5,12007019617,In > Out
Sept 2020,229,175,974,304365055,8723512997,9027878052,329,957,6,8419147942,In > Out
Sept 2020,229,177,1167,435580889,2640149179,3075730068,173,1157,6,2204568290,In > Out
Sept 2020,229,178,85,6723310,64020698,70744008,30,85,5,57297388,In > Out
Sept 2020,229,18,851,144272516,6102177622,6246450138,284,850,2,5957905106,In > Out
Sept 2020,229,180,261,53124041,3953702097,4006826138,116,261,3,3900578056,In > Out
Sept 2020,229,181,1194,170932704,6892163054,7063095758,289,1143,7,6721230350,In > Out
Sept 2020,229,182,255,256180854,720665314,976846168,62,255,4,464484460,In > Out
Sept 2020,229,184,326,130456589,975828323,1106284912,123,325,3,845371734,In > Out
Sept 2020,229,186,640,65824367,3067357820,3133182187,217,635,9,3001533453,In > Out
Sept 2020,229,189,189,61351565,1004666262,1066017827,88,189,2,943314697,In > Out
Sept 2020,229,190,1047,936979690,6320939759,7257919449,386,1038,6,5383960069,In > Out
Sept 2020,229,191,327,68333955,1265732094,1334066049,142,327,5,1197398139,In > Out
Sept 2020,229,192,105,12252338,976400180,988652518,63,103,2,964147842,In > Out
Sept 2020,229,193,1054,220665065,4786679510,5007344575,241,1036,8,4566014445,In > Out
Sept 2020,229,194,1309,155711159,13473509024,13629220183,195,1277,6,13317797865,In > Out
Sept 2020,229,195,781,1800709230,6449870071,8250579301,321,771,10,4649160841,In > Out
Sept 2020,229,199,1257,1568203235,41339110819,42907314054,354,1219,3,39770907584,In > Out
Sept 2020,229,20,889,311006510,5324471176,5635477686,291,873,12,5013464666,In > Out
Sept 2020,229,200,329,38714824,1434468181,1473183005,134,329,18,1395753357,In > Out
Sept 2020,229,203,1866,6990840396,7575167248,14566007644,290,1753,6,584326852,In > Out
Sept 2020,229,208,172,258330608,546694003,805024611,85,168,4,288363395,In > Out
Sept 2020,229,210,83,11702795,511310299,523013094,52,83,2,499607504,In > Out
Sept 2020,229,211,519,63086801,1986602992,2049689793,225,518,5,1923516191,In > Out
Sept 2020,229,212,333,78001773,1274641550,1352643323,108,332,3,1196639777,In > Out
Sept 2020,229,213,213,20903194,809959596,830862790,113,212,6,789056402,In > Out
Sept 2020,229,214,2991,155408472,10459149292,10614557764,336,2918,9,10303740820,In > Out
Sept 2020,229,215,1824,262968401,12799871970,13062840371,290,1790,6,12536903569,In > Out
Sept 2020,229,216,190,22725041,636712184,659437225,85,189,4,613987143,In > Out
Sept 2020,229,217,2029,617248188,11140630327,11757878515,452,1874,108,10523382139,In > Out
Sept 2020,229,218,36,14517665,227891617,242409282,16,36,4,213373952,In > Out
Sept 2020,229,219,554,1224618633,3612154505,4836773138,168,545,10,2387535872,In > Out
Sept 2020,229,222,474,185234723,4584280697,4769515420,154,471,5,4399045974,In > Out
Sept 2020,229,223,248,110456047,2625486844,2735942891,99,248,4,2515030797,In > Out
Sept 2020,229,23,411,365564960,2089005260,2454570220,120,402,7,1723440300,In > Out
Sept 2020,229,26,1565,318698457,17984998825,18303697282,394,1538,3,17666300368,In > Out
Sept 2020,229,27,254,30861640,1659291344,1690152984,96,253,4,1628429704,In > Out
Sept 2020,229,30,120,11095400,134576281,145671681,74,120,3,123480881,In > Out
Sept 2020,229,32,2156,1116767406,15886702729,17003470135,493,2091,8,14769935323,In > Out
Sept 2020,229,38,790,952581863,2382188083,3334769946,201,772,5,1429606220,In > Out
Sept 2020,229,4,1035,564014316,4291890434,4855904750,356,1011,9,3727876118,In > Out
Sept 2020,229,42,955,111434000,4002807655,4114241655,267,937,4,3891373655,In > Out
Sept 2020,229,43,1672,1286452795,20330964123,21617416918,397,1615,10,19044511328,In > Out
Sept 2020,229,44,38,2502179,65015067,67517246,19,38,1,62512888,In > Out
Sept 2020,229,45,1053,816038488,7411450078,8227488566,224,1026,6,6595411590,In > Out
Sept 2020,229,46,28,1408391,125297909,126706300,14,28,3,123889518,In > Out
Sept 2020,229,5,1427,2137836344,3989495846,6127332190,419,1390,9,1851659502,In > Out
Sept 2020,229,52,1339,2084837232,6294564281,8379401513,371,1297,13,4209727049,In > Out
Sept 2020,229,53,1284,339904621,17697795360,18037699981,295,1234,4,17357890739,In > Out
Sept 2020,229,54,1101,108452910,2226512205,2334965115,189,1082,9,2118059295,In > Out
Sept 2020,229,55,383,119945362,2289425580,2409370942,129,383,4,2169480218,In > Out
Sept 2020,229,58,107,7881108,145818811,153699919,60,107,3,137937703,In > Out
Sept 2020,229,59,564,203881277,3872554130,4076435407,195,540,7,3668672853,In > Out
Sept 2020,229,6,524,107250832,2561543474,2668794306,175,518,4,2454292642,In > Out
Sept 2020,229,62,1965,2578460540,13919616558,16498077098,387,1932,14,11341156018,In > Out
Sept 2020,229,63,508,51028474,2856712632,2907741106,201,493,4,2805684158,In > Out
Sept 2020,229,64,252,57119412,657139687,714259099,99,247,6,600020275,In > Out
Sept 2020,229,66,601,893019715,10501654407,11394674122,159,594,7,9608634692,In > Out
Sept 2020,229,67,694,315872119,4013197533,4329069652,180,687,4,3697325414,In > Out
Sept 2020,229,69,256,51942412,296005412,347947824,144,255,3,244063000,In > Out
Sept 2020,229,70,300,92057496,3556820073,3648877569,103,299,7,3464762577,In > Out
Sept 2020,229,71,210,49138585,466555172,515693757,89,208,6,417416587,In > Out
Sept 2020,229,72,915,158440679,2681330489,2839771168,200,717,23,2522889810,In > Out
Sept 2020,229,73,1039,235255674,12172025108,12407280782,277,1022,8,11936769434,In > Out
Sept 2020,229,74,76,7936412,131082657,139019069,51,76,1,123146245,In > Out
Sept 2020,229,76,986,678766752,6889185282,7567952034,281,959,5,6210418530,In > Out
Sept 2020,229,77,1039,166213585,4367546076,4533759661,226,997,6,4201332491,In > Out
Sept 2020,229,78,556,4052141202,4202933883,8255075085,153,542,7,150792681,In > Out
Sept 2020,229,79,52,107853255,741925638,849778893,32,52,3,634072383,In > Out
Sept 2020,229,8,2190,1294427175,15505358061,16799785236,415,2106,17,14210930886,In > Out
Sept 2020,229,80,599,1494237406,3538099074,5032336480,217,596,8,2043861668,In > Out
Sept 2020,229,81,1279,141911154,5405958180,5547869334,353,1239,5,5264047026,In > Out
Sept 2020,229,83,1233,616302265,21593894952,22210197217,427,1191,19,20977592687,In > Out
Sept 2020,229,89,92,9209407,319783142,328992549,40,89,2,310573735,In > Out
Sept 2020,229,90,557,65396698,1136278748,1201675446,182,547,6,1070882050,In > Out
Sept 2020,229,92,1039,288127489,5000585043,5288712532,263,1016,10,4712457554,In > Out
Sept 2020,229,93,945,375687402,6873324545,7249011947,331,932,5,6497637143,In > Out
Sept 2020,229,94,491,50176004,2165068078,2215244082,124,479,5,2114892074,In > Out
Sept 2020,229,96,1153,486957724,5944461302,6431419026,268,1110,6,5457503578,In > Out
Sept 2020,229,99,611,354747374,3014063722,3368811096,239,596,6,2659316348,In > Out
Sept 2020,23,4,174,15907921,766669961,782577882,7,174,1,750762040,In > Out
Sept 2020,234,110,126,81065027,6036739316,6117804343,15,126,1,5955674289,In > Out
Sept 2020,234,114,402,27721026,531132008,558853034,136,395,2,503410982,In > Out
Sept 2020,234,116,116,14003046,659454992,673458038,14,111,4,645451946,In > Out
Sept 2020,234,120,5182,1675001448,22194730296,23869731744,712,4601,13,20519728848,In > Out
Sept 2020,234,123,77,3382303,230567467,233949770,13,77,2,227185164,In > Out
Sept 2020,234,126,23,269943,8123102,8393045,1,23,1,7853159,In > Out
Sept 2020,234,129,495,318244498,1918733813,2236978311,181,490,3,1600489315,In > Out
Sept 2020,234,130,136,67834431,3519460728,3587295159,40,136,2,3451626297,In > Out
Sept 2020,234,132,21,1141489,5285748,6427237,15,21,2,4144259,In > Out
Sept 2020,234,135,1087,7024283662,7592250199,14616533861,335,1058,6,567966537,In > Out
Sept 2020,234,137,285,33108180,1830768710,1863876890,98,285,3,1797660530,In > Out
Sept 2020,234,139,510,20611545,203606806,224218351,124,508,2,182995261,In > Out
Sept 2020,234,144,74,13690688,438780600,452471288,38,74,2,425089912,In > Out
Sept 2020,234,151,1303,317855519,1225854243,1543709762,127,1250,4,907998724,In > Out
Sept 2020,234,18,967,79889528,1866406234,1946295762,126,942,2,1786516706,In > Out
Sept 2020,234,200,134,13235725,457944297,471180022,15,134,3,444708572,In > Out
Sept 2020,234,201,14,1365729,1918361,3284090,1,14,1,552632,In > Out
Sept 2020,234,225,560,34538309,1899814848,1934353157,54,555,3,1865276539,In > Out
Sept 2020,234,228,416,116013954,4144375205,4260389159,139,408,3,4028361251,In > Out
Sept 2020,234,23,81,9604552,29286599,38891151,13,81,16,19682047,In > Out
Sept 2020,234,237,1153,133882239,610307978,744190217,53,1127,2,476425739,In > Out
Sept 2020,234,238,3,8590437,936078,9526515,3,3,1,7654359,Out > In
Sept 2020,234,40,2889,537582421,790302439,1327884860,152,2681,2,252720018,In > Out
Sept 2020,234,46,134,54032411,627633160,681665571,14,134,3,573600749,In > Out
Sept 2020,234,52,360,262501558,9042169380,9304670938,90,358,2,8779667822,In > Out
Sept 2020,234,56,225,153275963,406507143,559783106,108,218,6,253231180,In > Out
Sept 2020,234,66,129,156139359,8008168634,8164307993,13,129,63,7852029275,In > Out
Sept 2020,234,68,19,5703359,1152286342,1157989701,15,19,1,1146582983,In > Out
Sept 2020,234,76,740,1068531558,2079527398,3148058956,226,730,4,1010995840,In > Out
Sept 2020,234,83,124,79833772,5963011600,6042845372,18,124,2,5883177828,In > Out
Sept 2020,234,84,1853,4704516061,600730570,5305246631,73,1761,3,4103785491,Out > In
Sept 2020,234,89,526,164694685,3999729960,4164424645,220,519,2,3835035275,In > Out
Sept 2020,234,90,67,26112256,1833069130,1859181386,26,67,2,1806956874,In > Out
Sept 2020,234,99,959,89061519,2492075243,2581136762,275,929,4,2403013724,In > Out
Sept 2020,235,212,6,37970,2594773,2632743,1,6,1,2556803,In > Out
Sept 2020,235,223,873215,10839842030,436199220005,447039062035,929,28232,2,425359377975,In > Out
Sept 2020,236,253,5166,1258953249,11249341871,12508295120,1198,4567,7,9990388622,In > Out
Sept 2020,239,161,187,39820566,2178804648,2218625214,37,174,2,2138984082,In > Out
Sept 2020,239,162,357,57677961,3039700368,3097378329,40,339,2,2982022407,In > Out
Sept 2020,239,163,520,93668989,4867766065,4961435054,49,440,2,4774097076,In > Out
Sept 2020,239,164,284,50087329,2604405873,2654493202,39,257,2,2554318544,In > Out
Sept 2020,239,166,555,107105498,5725651127,5832756625,53,397,2,5618545629,In > Out
Sept 2020,239,172,399,84617052,4629406942,4714023994,43,292,2,4544789890,In > Out
Sept 2020,239,173,248,165025242,10882336291,11047361533,44,235,2,10717311049,In > Out
Sept 2020,239,175,121,6523678,350306079,356829757,17,121,2,343782401,In > Out
Sept 2020,239,184,94,5660620,333824236,339484856,11,94,2,328163616,In > Out
Sept 2020,239,185,450,177573722,10564703148,10742276870,47,348,2,10387129426,In > Out
Sept 2020,239,186,34,2325707,12774549,15100256,15,34,2,10448842,In > Out
Sept 2020,239,187,243,40382526,2111512806,2151895332,35,223,2,2071130280,In > Out
Sept 2020,239,188,339,56994159,3032184586,3089178745,43,309,2,2975190427,In > Out
Sept 2020,239,192,599,111327821,5804442625,5915770446,53,465,2,5693114804,In > Out
Sept 2020,239,194,191,10913202,607847901,618761103,28,191,2,596934699,In > Out
Sept 2020,239,198,123,41495076,2165738493,2207233569,44,116,2,2124243417,In > Out
Sept 2020,239,199,204,27290183,1326097916,1353388099,37,198,2,1298807733,In > Out
Sept 2020,239,203,360,79309406,4160776782,4240086188,41,298,2,4081467376,In > Out
Sept 2020,239,205,24,169837,8326009,8495846,7,24,1,8156172,In > Out
Sept 2020,239,206,449,92741956,4721718441,4814460397,46,356,2,4628976485,In > Out
Sept 2020,239,207,11,105543574,106648237,212191811,3,11,3,1104663,In > Out
Sept 2020,239,217,481,91155678,4856009896,4947165574,43,346,2,4764854218,In > Out
Sept 2020,239,220,229,22421403,641364336,663785739,47,208,2,618942933,In > Out
Sept 2020,241,136,36,6350935,2232110723,2238461658,4,36,1,2225759788,In > Out
Sept 2020,241,181,23,7940715,595277391,603218106,7,23,2,587336676,In > Out
Sept 2020,241,182,445,43293922,2116160675,2159454597,82,439,2,2072866753,In > Out
Sept 2020,241,196,1973,26129122,1023737070,1049866192,14,1839,2,997607948,In > Out
Sept 2020,241,199,93,5824978,459551871,465376849,7,93,2,453726893,In > Out
Sept 2020,241,223,121,10837002,757610351,768447353,11,121,2,746773349,In > Out
Sept 2020,241,232,4,55814,811349,867163,4,4,1,755535,In > Out
Sept 2020,241,6,15,1747572,254555567,256303139,4,15,1,252807995,In > Out
Sept 2020,242,110,5,49946,515889,565835,1,5,1,465943,In > Out
Sept 2020,242,140,123,11402060,863744266,875146326,38,121,2,852342206,In > Out
Sept 2020,242,39,5,49068,504227,553295,1,5,1,455159,In > Out
Sept 2020,242,41,167,2382963,25148795,27531758,1,166,1,22765832,In > Out
Sept 2020,242,44,12438,1808182048,3546469858,5354651906,517,10031,2,1738287810,In > Out
Sept 2020,242,46,2,120992,120688,241680,1,1,1,304,Out > In
Sept 2020,246,125,98,12710997,613614531,626325528,26,96,2,600903534,In > Out
Sept 2020,246,128,102,12239394,607378375,619617769,26,102,2,595138981,In > Out
Sept 2020,246,129,323,51454393,760992979,812447372,34,164,2,709538586,In > Out
Sept 2020,246,134,134,19680936,636584038,656264974,34,118,2,616903102,In > Out
Sept 2020,246,137,261,75332292,3024469611,3099801903,37,248,2,2949137319,In > Out
Sept 2020,246,141,303,32732834,1145702633,1178435467,43,220,2,1112969799,In > Out
Sept 2020,246,142,97,2666644,26404591,29071235,8,97,2,23737947,In > Out
Sept 2020,246,143,115,16526803,656772756,673299559,28,108,2,640245953,In > Out
Sept 2020,246,144,114,28216939,1195081445,1223298384,40,109,2,1166864506,In > Out
Sept 2020,246,147,89,3191803,119019298,122211101,8,89,2,115827495,In > Out
Sept 2020,246,171,100,12224168,564814508,577038676,26,100,2,552590340,In > Out
Sept 2020,246,172,224,25596109,1381923283,1407519392,35,223,2,1356327174,In > Out
Sept 2020,246,179,96,12351901,563075349,575427250,26,96,2,550723448,In > Out
Sept 2020,246,181,250,28930038,694936467,723866505,36,134,2,666006429,In > Out
Sept 2020,246,185,108,8746463,458152794,466899257,32,108,2,449406331,In > Out
Sept 2020,246,187,175,56152722,2601993229,2658145951,27,171,2,2545840507,In > Out
Sept 2020,246,191,42,3145221,24967392,28112613,15,42,2,21822171,In > Out
Sept 2020,246,192,154,6281180,546472636,552753816,42,154,2,540191456,In > Out
Sept 2020,246,193,113,51444373,1664366102,1715810475,29,112,2,1612921729,In > Out
Sept 2020,246,194,326,53297588,767774085,821071673,42,166,2,714476497,In > Out
Sept 2020,246,199,121,19130446,573450878,592581324,30,104,2,554320432,In > Out
Sept 2020,246,203,93,10217474,478445648,488663122,30,93,2,468228174,In > Out
Sept 2020,246,204,114,15912079,626558233,642470312,29,108,2,610646154,In > Out
Sept 2020,246,209,126,89691642,3378768212,3468459854,30,125,2,3289076570,In > Out
Sept 2020,246,214,101,11843430,623816378,635659808,26,101,2,611972948,In > Out
Sept 2020,246,220,105,13758366,633587610,647345976,28,101,2,619829244,In > Out
Sept 2020,246,227,134,17942221,669096883,687039104,32,119,2,651154662,In > Out
Sept 2020,246,232,304,66695903,881089026,947784929,107,114,2,814393123,In > Out
Sept 2020,246,41,82,11476602,594679057,606155659,26,82,2,583202455,In > Out
Sept 2020,246,42,111,42368747,1007831770,1050200517,37,107,2,965463023,In > Out
Sept 2020,246,43,100,14509835,632256417,646766252,32,93,2,617746582,In > Out
Sept 2020,246,45,96,10263569,421897062,432160631,27,95,2,411633493,In > Out
Sept 2020,246,46,89,12866582,678310963,691177545,23,89,2,665444381,In > Out
Sept 2020,246,47,89,12759513,549002961,561762474,24,89,2,536243448,In > Out
Sept 2020,246,48,82,11821703,224637692,236459395,27,82,2,212815989,In > Out
Sept 2020,246,49,74,11568582,595181974,606750556,21,74,2,583613392,In > Out
Sept 2020,246,50,146,42499650,596154809,638654459,35,110,2,553655159,In > Out
Sept 2020,246,51,85,11591417,613334836,624926253,22,85,2,601743419,In > Out
Sept 2020,246,52,185,110396603,3862129762,3972526365,45,182,2,3751733159,In > Out
Sept 2020,246,53,192,16108766,806258566,822367332,39,192,2,790149800,In > Out
Sept 2020,246,54,90,32247235,708174726,740421961,25,90,2,675927491,In > Out
Sept 2020,246,55,99,32394898,597368454,629763352,29,99,2,564973556,In > Out
Sept 2020,246,56,101,13229187,638905235,652134422,27,101,2,625676048,In > Out
Sept 2020,246,57,99,25232085,837075331,862307416,27,99,2,811843246,In > Out
Sept 2020,246,58,169,25452014,1342253781,1367705795,31,169,2,1316801767,In > Out
Sept 2020,246,59,110,9699234,453075325,462774559,29,109,2,443376091,In > Out
Sept 2020,246,60,222,41697880,785743670,827441550,31,137,2,744045790,In > Out
Sept 2020,246,61,126,12191987,621907323,634099310,32,126,2,609715336,In > Out
Sept 2020,246,62,116,17486853,678104635,695591488,35,109,2,660617782,In > Out
Sept 2020,246,63,88,19220422,973988085,993208507,24,87,2,954767663,In > Out
Sept 2020,246,64,90,13419812,689209455,702629267,28,90,2,675789643,In > Out
Sept 2020,246,65,81,11826810,619729061,631555871,23,81,2,607902251,In > Out
Sept 2020,246,66,90,12898319,641140074,654038393,22,90,2,628241755,In > Out
Sept 2020,246,67,27,2999550,2345661896,2348661446,9,27,2,2342662346,In > Out
Sept 2020,246,68,198,13084136,770586765,783670901,27,197,2,757502629,In > Out
Sept 2020,246,69,106,17556585,583972428,601529013,25,95,2,566415843,In > Out
Sept 2020,246,70,81,12145617,576454195,588599812,24,81,2,564308578,In > Out
Sept 2020,246,71,166,26355934,1404399151,1430755085,27,166,2,1378043217,In > Out
Sept 2020,246,72,90,12793501,678529059,691322560,23,90,2,665735558,In > Out
Sept 2020,246,73,100,13648129,663202938,676851067,22,100,2,649554809,In > Out
Sept 2020,246,74,143,19351853,1045406587,1064758440,29,143,2,1026054734,In > Out
Sept 2020,246,75,176,67219859,2752419881,2819639740,25,171,2,2685200022,In > Out
Sept 2020,246,76,100,30615522,654903283,685518805,25,99,2,624287761,In > Out
Sept 2020,246,77,97,13357347,663099450,676456797,26,97,2,649742103,In > Out
Sept 2020,246,78,199,15499387,838956286,854455673,34,198,2,823456899,In > Out
Sept 2020,246,79,102,9617313,468648292,478265605,27,102,2,459030979,In > Out
Sept 2020,246,80,119,13708768,730079506,743788274,25,118,2,716370738,In > Out
Sept 2020,246,81,101,13124800,679811770,692936570,25,100,2,666686970,In > Out
Sept 2020,246,83,90,12217393,667866110,680083503,22,90,2,655648717,In > Out
Sept 2020,246,84,103,55881487,818895138,874776625,29,103,2,763013651,In > Out
Sept 2020,246,85,92,12627414,616748131,629375545,22,92,2,604120717,In > Out
Sept 2020,246,86,191,30425373,1523137221,1553562594,35,189,2,1492711848,In > Out
Sept 2020,246,87,103,13451987,657994350,671446337,24,102,2,644542363,In > Out
Sept 2020,248,108,36,15576004,3060946996,3076523000,8,36,2,3045370992,In > Out
Sept 2020,248,47,189,21806546,3637869963,3659676509,15,189,2,3616063417,In > Out
Sept 2020,250,116,8,1123057,4539865,5662922,2,8,1,3416808,In > Out
Sept 2020,250,193,489,32947325,1299710654,1332657979,155,483,3,1266763329,In > Out
Sept 2020,250,204,11380,6321205453,26902372499,33223577952,1106,8378,14,20581167046,In > Out
Sept 2020,250,3,33,8208356,6094689,14303045,2,2,2,2113667,Out > In
Sept 2020,250,49,7,811123,256308,1067431,2,7,1,554815,Out > In
Sept 2020,250,51,13,5581889,5059582,10641471,2,10,10,522307,Out > In
Sept 2020,250,56,3574,1193512558,9737914746,10931427304,476,3489,9,8544402188,In > Out
Sept 2020,250,62,1665,144908908,5744887693,5889796601,288,1566,7,5599978785,In > Out
Sept 2020,256,11,6,3450101,65371,3515472,3,1,6,3384730,Out > In
Sept 2020,256,12,79,145808571,5146781,150955352,31,79,1,140661790,Out > In
Sept 2020,256,15,311,63879334,3778751140,3842630474,11,309,4,3714871806,In > Out
Sept 2020,256,248,97649,57482276083,1048568083329,1106050359412,7848,27294,338,991085807246,In > Out
Sept 2020,256,249,107131,60196432410,1035731999604,1095928432014,7984,27285,495,975535567194,In > Out
Sept 2020,256,250,89707,96373795156,640135905195,736509700351,7907,26356,344,543762110039,In > Out
Sept 2020,256,251,91431,62416279361,717939548031,780355827392,8075,27239,308,655523268670,In > Out
Sept 2020,256,252,98854,95115357832,865112751471,960228109303,8273,26912,412,769997393639,In > Out
Sept 2020,256,253,101968,62789523300,706502197936,769291721236,7641,27400,506,643712674636,In > Out
Sept 2020,256,254,83622,42608699548,621891649844,664500349392,7195,27132,284,579282950296,In > Out
Sept 2020,28,129,14,4087921,263210203,267298124,3,14,2,259122282,In > Out
Sept 2020,29,142,391,74729099,4482556119,4557285218,32,391,2,4407827020,In > Out
Sept 2020,29,19,1439,218083078,4496516407,4714599485,418,1388,4,4278433329,In > Out
Sept 2020,29,52,25911,634145331562,48261119353,682406450915,1472,13172,23,585884212209,Out > In
Sept 2020,29,67,1128,225290825,5602304223,5827595048,331,1090,4,5377013398,In > Out
Sept 2020,29,94,287,141991594,963755905,1105747499,107,283,2,821764311,In > Out
Sept 2020,3,195,691,5920069,279715465,285635534,8,680,3,273795396,In > Out
Sept 2020,3,196,334,4007346,633133736,637141082,6,332,1,629126390,In > Out
Sept 2020,3,197,5,85374,10886461,10971835,3,5,1,10801087,In > Out
Sept 2020,3,199,7,84235,12613418,12697653,4,7,1,12529183,In > Out
Sept 2020,3,206,20,470656,19554803,20025459,7,20,1,19084147,In > Out
Sept 2020,3,209,23,505681,19698656,20204337,7,23,1,19192975,In > Out
Sept 2020,3,212,24,511007,17512206,18023213,7,24,1,17001199,In > Out
Sept 2020,3,217,26,573366,21442848,22016214,7,26,1,20869482,In > Out
Sept 2020,35,111,26,3055746,2851680,5907426,1,26,1,204066,Out > In
Sept 2020,35,116,15037,99815816,7377673907,7477489723,5,13495,1,7277858091,In > Out
Sept 2020,35,16,6,54237,5033314,5087551,4,6,1,4979077,In > Out
Sept 2020,35,165,2,29818,2719722,2749540,1,2,1,2689904,In > Out
Sept 2020,35,181,2,33555,3950641,3984196,1,2,1,3917086,In > Out
Sept 2020,35,182,3,48834,4905237,4954071,3,3,1,4856403,In > Out
Sept 2020,35,191,18,840286,40364164,41204450,3,18,2,39523878,In > Out
Sept 2020,35,192,15,2804884,318308829,321113713,3,15,1,315503945,In > Out
Sept 2020,35,195,47,1167331,18087456,19254787,4,47,2,16920125,In > Out
Sept 2020,35,198,1,2698,647430,650128,1,1,1,644732,In > Out
Sept 2020,35,199,1,1560,123888,125448,1,1,1,122328,In > Out
Sept 2020,35,203,1,305030,15216790,15521820,1,1,1,14911760,In > Out
Sept 2020,35,204,1,292562,14864290,15156852,1,1,1,14571728,In > Out
Sept 2020,35,208,13,443714,1383715,1827429,4,13,1,940001,In > Out
Sept 2020,35,23,5,343201,43580996,43924197,3,5,1,43237795,In > Out
Sept 2020,35,52,1,224972,10291077,10516049,1,1,1,10066105,In > Out
Sept 2020,35,53,1,197842,9037093,9234935,1,1,1,8839251,In > Out
Sept 2020,35,55,18,430268,2653942,3084210,4,18,1,2223674,In > Out
Sept 2020,35,98,5,120464,2340052,2460516,3,5,1,2219588,In > Out
Sept 2020,4,104,438,14250611,1689940413,1704191024,34,438,2,1675689802,In > Out
Sept 2020,4,105,875,128960397,1881517210,2010477607,110,849,6,1752556813,In > Out
Sept 2020,4,106,2243,521633030,20069386472,20591019502,188,2124,3,19547753442,In > Out
Sept 2020,4,11,51,2316141,124582422,126898563,12,51,2,122266281,In > Out
Sept 2020,4,112,1628,236496993,889879713,1126376706,112,1551,2,653382720,In > Out
Sept 2020,4,113,318,36494010,431769855,468263865,131,318,2,395275845,In > Out
Sept 2020,4,12,121,18784575,797725278,816509853,20,121,2,778940703,In > Out
Sept 2020,4,14,402,65785482,1546053357,1611838839,106,401,3,1480267875,In > Out
Sept 2020,4,15,792,2548672423,1595646018,4144318441,119,771,5,953026405,Out > In
Sept 2020,4,2,2140,161526915,1219002356,1380529271,161,2025,3,1057475441,In > Out
Sept 2020,4,35,1784,146684490,1327286524,1473971014,144,1728,2,1180602034,In > Out
Sept 2020,43,4,1,28011351,9194124,37205475,1,1,1,18817227,Out > In
Sept 2020,44,211,1998,5023217516,9429259155,14452476671,529,1826,16,4406041639,In > Out
Sept 2020,44,214,7138,9564153748,123183010479,132747164227,1277,5876,70,113618856731,In > Out
Sept 2020,46,100,596,2761988865,24110814017,26872802882,240,379,154,21348825152,In > Out
Sept 2020,46,101,560,340611431,10431361352,10771972783,69,557,17,10090749921,In > Out
Sept 2020,46,108,98,17877980,571918334,589796314,45,97,3,554040354,In > Out
Sept 2020,46,109,2622,2602441009,53238172826,55840613835,557,2424,15,50635731817,In > Out
Sept 2020,46,11,10369,3316412352,202103579659,205419992011,512,8596,74,198787167307,In > Out
Sept 2020,46,114,286,554602596,1866874383,2421476979,130,285,3,1312271787,In > Out
Sept 2020,46,116,2670,3390258927,3946362432,7336621359,321,2535,7,556103505,In > Out
Sept 2020,46,117,671,123531860,2501785894,2625317754,289,642,3,2378254034,In > Out
Sept 2020,46,122,2326,618769622,23128039676,23746809298,603,2235,38,22509270054,In > Out
Sept 2020,46,123,1385,244388415,3376646506,3621034921,410,1370,3,3132258091,In > Out
Sept 2020,46,125,123,86486252,457505819,543992071,38,118,22,371019567,In > Out
Sept 2020,46,126,303,42077159,4013541662,4055618821,138,299,3,3971464503,In > Out
Sept 2020,46,13,13,1345355,10380252,11725607,9,13,2,9034897,In > Out
Sept 2020,46,132,1195,927031529,6439111451,7366142980,232,1180,32,5512079922,In > Out
Sept 2020,46,133,1685,2654471793,27361345996,30015817789,414,1625,12,24706874203,In > Out
Sept 2020,46,137,389,74281759,7627346471,7701628230,72,383,1,7553064712,In > Out
Sept 2020,46,138,121,613190119,30389756670,31002946789,42,116,8,29776566551,In > Out
Sept 2020,46,139,681,144366652,4660731624,4805098276,196,651,3,4516364972,In > Out
Sept 2020,46,144,193,15406215,871966255,887372470,67,192,2,856560040,In > Out
Sept 2020,46,146,4162,8817741344,48057292037,56875033381,651,3644,16,39239550693,In > Out
Sept 2020,46,149,46,18098096,275949530,294047626,32,46,9,257851434,In > Out
Sept 2020,46,150,2141,1130704957,10740040988,11870745945,562,2064,31,9609336031,In > Out
Sept 2020,46,153,47,9996292,19935395,29931687,23,47,2,9939103,In > Out
Sept 2020,46,156,28,79859855,225826376,305686231,21,28,2,145966521,In > Out
Sept 2020,46,158,412,327088439,38073416,365161855,45,412,3,289015023,Out > In
Sept 2020,46,167,1479,1796524322,1412704089,3209228411,221,1403,6,383820233,Out > In
Sept 2020,46,168,4,258838,1541057,1799895,4,4,1,1282219,In > Out
Sept 2020,46,169,2009,2179983785,1776194222,3956178007,258,1971,4,403789563,Out > In
Sept 2020,46,170,937,507963280,76631777993,77139741273,199,905,4,76123814713,In > Out
Sept 2020,46,175,1459,873777479,27746483740,28620261219,315,1286,70,26872706261,In > Out
Sept 2020,46,180,87,153132027,6825912643,6979044670,28,86,4,6672780616,In > Out
Sept 2020,46,181,1252,609964264,8772287694,9382251958,401,1202,6,8162323430,In > Out
Sept 2020,46,189,49,22233575,346423678,368657253,26,49,4,324190103,In > Out
Sept 2020,46,19,131,288215997,3462291121,3750507118,45,130,3,3174075124,In > Out
Sept 2020,46,191,111,135596768,5812227789,5947824557,60,111,8,5676631021,In > Out
Sept 2020,46,194,2700,574847381,30911443097,31486290478,515,2488,3,30336595716,In > Out
Sept 2020,46,199,6301,940633707,32551551513,33492185220,846,5581,14,31610917806,In > Out
Sept 2020,46,20,460,507092536,392620203,899712739,61,459,4,114472333,Out > In
Sept 2020,46,202,630,385761783,2977742552,3363504335,124,610,70,2591980769,In > Out
Sept 2020,46,205,102,83179651,3150420757,3233600408,45,101,11,3067241106,In > Out
Sept 2020,46,210,978,68486841,4357690253,4426177094,292,924,4,4289203412,In > Out
Sept 2020,46,214,42,80537894,335502936,416040830,26,26,12,254965042,In > Out
Sept 2020,46,221,94,9386821,77179406,86566227,62,94,3,67792585,In > Out
Sept 2020,46,223,56,10031968,1131095199,1141127167,22,56,1,1121063231,In > Out
Sept 2020,46,23,5164,3482140595,87131803403,90613943998,728,4416,46,83649662808,In > Out
Sept 2020,46,24,11,2155120,46036713,48191833,10,11,3,43881593,In > Out
Sept 2020,46,29,2633,523743660,20822517592,21346261252,388,2401,13,20298773932,In > Out
Sept 2020,46,30,745,668672229,706702198,1375374427,132,745,5,38029969,In > Out
Sept 2020,46,32,3126,2014515422,58292041083,60306556505,627,2749,107,56277525661,In > Out
Sept 2020,46,36,5885,23921857715,45031206540,68953064255,890,3960,41,21109348825,In > Out
Sept 2020,46,42,437,567385969,608387196,1175773165,67,437,4,41001227,In > Out
Sept 2020,46,45,353,144485234,3706648862,3851134096,120,307,3,3562163628,In > Out
Sept 2020,46,47,239,202793024,7439327478,7642120502,51,231,12,7236534454,In > Out
Sept 2020,46,5,266,397639687,54056546,451696233,39,266,3,343583141,Out > In
Sept 2020,46,57,521,977949514,23982185982,24960135496,215,519,3,23004236468,In > Out
Sept 2020,46,58,220,15273738,283145174,298418912,90,218,2,267871436,In > Out
Sept 2020,46,65,32,5219715,83198183,88417898,15,32,5,77978468,In > Out
Sept 2020,46,70,10,255782,3427886,3683668,5,10,2,3172104,In > Out
Sept 2020,46,71,1937,708948170,10017749908,10726698078,445,1903,4,9308801738,In > Out
Sept 2020,46,72,257,207270717,179476685,386747402,57,257,4,27794032,Out > In
Sept 2020,46,75,18,29338242,2977170,32315412,14,18,2,26361072,Out > In
Sept 2020,46,87,507,9871144601,442438204715,452309349316,95,504,9,432567060114,In > Out
Sept 2020,46,88,165,101764665,4895662255,4997426920,77,158,3,4793897590,In > Out
Sept 2020,46,90,181,103204753,1213494569,1316699322,87,135,19,1110289816,In > Out
Sept 2020,46,91,42,3574854,11290958,14865812,27,42,1,7716104,In > Out
Sept 2020,46,96,13,5793606,184890045,190683651,3,13,3,179096439,In > Out
Sept 2020,46,99,902,548815900,34518312344,35067128244,138,863,12,33969496444,In > Out
Sept 2020,48,15,14973,2690960137,78955750507,81646710644,706,11339,78,76264790370,In > Out
Sept 2020,48,173,4878,1126581153,96685230503,97811811656,404,4615,34,95558649350,In > Out
Sept 2020,48,56,5828,7263419489,80007167458,87270586947,961,5029,30,72743747969,In > Out
Sept 2020,48,95,3228,3114931894,11813311308,14928243202,895,3003,49,8698379414,In > Out
Sept 2020,49,113,31450,3929391692,124772142917,128701534609,1234,14459,8,120842751225,In > Out
Sept 2020,49,114,31230,10047431292,663068005731,673115437023,1552,14958,18,653020574439,In > Out
Sept 2020,49,115,25882,7254668601,194741730245,201996398846,1491,16035,149,187487061644,In > Out
Sept 2020,49,116,29092,6768429463,129384095864,136152525327,956,16285,8,122615666401,In > Out
Sept 2020,49,117,35690,95887342573,246666795611,342554138184,2011,18433,16,150779453038,In > Out
Sept 2020,49,118,54251,43825195554,201815476974,245640672528,1940,20031,26,157990281420,In > Out
Sept 2020,49,119,51040,35466788539,267730620906,303197409445,1779,22278,1252,232263832367,In > Out
Sept 2020,49,120,36849,25766180991,189982119943,215748300934,1454,17849,20,164215938952,In > Out
Sept 2020,49,121,36214,20977749784,187845674669,208823424453,1708,17006,19,166867924885,In > Out
Sept 2020,49,122,24153,19244558166,142012338244,161256896410,1359,13423,18,122767780078,In > Out
Sept 2020,49,123,28927,14256294420,179552157423,193808451843,1754,14754,72,165295863003,In > Out
Sept 2020,49,124,19651,8150244788,114828387506,122978632294,1352,11952,9,106678142718,In > Out
Sept 2020,49,125,70016,39249338470,969488887573,1008738226043,1112,16151,10,930239549103,In > Out
Sept 2020,49,126,71177,18646185227,927974396972,946620582199,1404,16234,10,909328211745,In > Out
Sept 2020,49,180,1,128700,131684,260384,1,1,1,2984,In > Out
Sept 2020,49,244,2,2106380,677796,2784176,1,1,1,1428584,Out > In
Sept 2020,5,103,5,1336489,398525,1735014,2,1,5,937964,Out > In
Sept 2020,5,13,7,1092692,220197368,221290060,1,7,1,219104676,In > Out
Sept 2020,5,22,55,2647754,141418165,144065919,27,49,5,138770411,In > Out
Sept 2020,5,23,8,1195990,273759832,274955822,2,8,1,272563842,In > Out
Sept 2020,5,25,551,58958880,3790295543,3849254423,164,538,4,3731336663,In > Out
Sept 2020,5,27,161,7038015,761167865,768205880,32,159,2,754129850,In > Out
Sept 2020,5,30,13,853829,83118356,83972185,9,13,1,82264527,In > Out
Sept 2020,5,31,33,4043834,391630559,395674393,11,33,1,387586725,In > Out
Sept 2020,5,6,46,156713928,682874,157396802,2,46,1,156031054,Out > In
Sept 2020,50,241,4,27294,1003584,1030878,3,4,1,976290,In > Out
Sept 2020,50,51,272,5609276,904681951,910291227,5,272,2,899072675,In > Out
Sept 2020,50,52,14,934306,57606114,58540420,3,14,1,56671808,In > Out
Sept 2020,51,10,15,2497146,264403636,266900782,5,15,2,261906490,In > Out
Sept 2020,51,151,1177,3134476334,1532858837,4667335171,160,1143,5,1601617497,Out > In
Sept 2020,51,152,259,140046287,1081363950,1221410237,118,257,5,941317663,In > Out
Sept 2020,51,153,318,15720934,475740156,491461090,23,315,2,460019222,In > Out
Sept 2020,51,154,602,99291239,11193806772,11293098011,120,595,200,11094515533,In > Out
Sept 2020,51,156,6,517590,4283251,4800841,3,6,2,3765661,In > Out
Sept 2020,51,160,174,45780393,182179375,227959768,33,143,5,136398982,In > Out
Sept 2020,51,161,301,87055845,1544719848,1631775693,115,288,2,1457664003,In > Out
Sept 2020,51,162,182,60821868,612958774,673780642,63,182,3,552136906,In > Out
Sept 2020,51,163,1134,266403641,37237438,303641079,14,1093,2,229166203,Out > In
Sept 2020,51,167,5,43122,2386951,2430073,5,5,1,2343829,In > Out
Sept 2020,51,168,16,295644,52723159,53018803,6,16,2,52427515,In > Out
Sept 2020,51,172,431,33673627,1582975775,1616649402,67,422,2,1549302148,In > Out
Sept 2020,51,174,214,19231735,621602405,640834140,45,214,2,602370670,In > Out
Sept 2020,51,177,160,20951109,74210122,95161231,42,160,2,53259013,In > Out
Sept 2020,51,179,1482,947531163,111161450,1058692613,107,1412,2,836369713,Out > In
Sept 2020,51,180,83,3390553,73866593,77257146,22,83,2,70476040,In > Out
Sept 2020,51,182,632,12171331907,11950828281,24122160188,15,618,331,220503626,Out > In
Sept 2020,51,183,1,223641,220401,444042,1,1,1,3240,Out > In
Sept 2020,51,184,1145,109077086,1562151431,1671228517,224,1096,2,1453074345,In > Out
Sept 2020,51,196,2,129430,71500647,71630077,1,2,1,71371217,In > Out
Sept 2020,51,197,2,229697,14596354,14826051,2,2,2,14366657,In > Out
Sept 2020,51,202,5,302072,33014217,33316289,2,5,2,32712145,In > Out
Sept 2020,51,207,403,53733102,1263773366,1317506468,143,401,2,1210040264,In > Out
Sept 2020,51,209,533,165595525,1175065677,1340661202,117,529,5,1009470152,In > Out
Sept 2020,51,210,318,29083240,3229828908,3258912148,141,318,2,3200745668,In > Out
Sept 2020,51,211,7,951470,156155395,157106865,4,7,1,155203925,In > Out
Sept 2020,51,213,396,490512003,12133647209,12624159212,174,394,2,11643135206,In > Out
Sept 2020,51,220,2,23960,1133024,1156984,2,2,1,1109064,In > Out
Sept 2020,51,224,1,82369,10264491,10346860,1,1,1,10182122,In > Out
Sept 2020,51,226,317,22108804,803441038,825549842,56,316,2,781332234,In > Out
Sept 2020,51,239,605,136711571,9509227150,9645938721,148,584,3,9372515579,In > Out
Sept 2020,51,30,5829,33036169781,32737808756,65773978537,276,4928,5,298361025,Out > In
Sept 2020,51,35,1066,228768047,369305624,598073671,129,949,97,140537577,In > Out
Sept 2020,51,4,18,2947363,386321338,389268701,4,18,1,383373975,In > Out
Sept 2020,51,45,1479,203233594,1472312669,1675546263,137,1409,2,1269079075,In > Out
Sept 2020,51,5,20,2896038,430111505,433007543,4,20,1,427215467,In > Out
Sept 2020,51,50,7925,35940832778,33253502898,69194335676,564,6227,8,2687329880,Out > In
Sept 2020,51,51,115,5003494,478636192,483639686,28,115,6,473632698,In > Out
Sept 2020,51,53,80,3666984,383414677,387081661,15,80,2,379747693,In > Out
Sept 2020,51,56,2,126776,16423766,16550542,1,2,1,16296990,In > Out
Sept 2020,51,57,9,524993,48352394,48877387,5,9,1,47827401,In > Out
Sept 2020,51,58,92,8280742,1334662904,1342943646,9,92,2,1326382162,In > Out
Sept 2020,51,6,14,2543118,367659817,370202935,4,14,1,365116699,In > Out
Sept 2020,51,78,3,172203,18969937,19142140,2,3,2,18797734,In > Out
Sept 2020,52,10,71,85002438,320631077,405633515,26,71,3,235628639,In > Out
Sept 2020,52,113,1242,156293906,1077214067,1233507973,64,1239,2,920920161,In > Out
Sept 2020,52,116,599,21516277,2105505937,2127022214,47,584,2,2083989660,In > Out
Sept 2020,52,118,64,8457965,641980312,650438277,28,64,2,633522347,In > Out
Sept 2020,52,119,2006,875081075,1614177258,2489258333,92,1886,4,739096183,In > Out
Sept 2020,52,12,50,4524759,629620250,634145009,18,45,3,625095491,In > Out
Sept 2020,52,120,355,16201913,1199338186,1215540099,94,351,2,1183136273,In > Out
Sept 2020,52,141,31,5042429,534727489,539769918,5,31,2,529685060,In > Out
Sept 2020,52,142,6,108785,18166442,18275227,4,6,2,18057657,In > Out
Sept 2020,52,143,99,8525041,692454159,700979200,35,99,2,683929118,In > Out
Sept 2020,52,149,21,2356323,328885259,331241582,5,21,2,326528936,In > Out
Sept 2020,52,15,13,63918,2171730,2235648,9,13,1,2107812,In > Out
Sept 2020,52,16,14,58238,2105595,2163833,8,14,1,2047357,In > Out
Sept 2020,52,164,44,5927494,165346244,171273738,9,44,2,159418750,In > Out
Sept 2020,52,172,11,60670,1806328,1866998,8,11,1,1745658,In > Out
Sept 2020,52,199,16,1666636,256183641,257850277,4,16,1,254517005,In > Out
Sept 2020,52,22,11,53873,1692308,1746181,5,11,1,1638435,In > Out
Sept 2020,52,24,32,3153800,333933757,337087557,6,32,2,330779957,In > Out
Sept 2020,52,25,67,2894685,290349802,293244487,24,67,2,287455117,In > Out
Sept 2020,52,251,54,230542312,456189165,686731477,30,54,4,225646853,In > Out
Sept 2020,52,252,2,185131,32231503,32416634,2,2,1,32046372,In > Out
Sept 2020,52,253,1,15076,330056,345132,1,1,1,314980,In > Out
Sept 2020,52,29,33,2950521,325452633,328403154,6,33,2,322502112,In > Out
Sept 2020,52,33,15,1654028,169343560,170997588,4,15,1,167689532,In > Out
Sept 2020,52,35,52,29974746,3699562596,3729537342,5,52,24,3669587850,In > Out
Sept 2020,52,36,31,2491327,330551459,333042786,6,31,2,328060132,In > Out
Sept 2020,52,37,47,11148439,2657563147,2668711586,7,47,16,2646414708,In > Out
Sept 2020,52,38,82,54881131,7331758476,7386639607,7,82,50,7276877345,In > Out
Sept 2020,52,4,39,1757285,259727752,261485037,11,39,2,257970467,In > Out
Sept 2020,52,6,66,4643952,466138718,470782670,12,66,2,461494766,In > Out
Sept 2020,52,8,31,2921328,344879996,347801324,5,31,2,341958668,In > Out
Sept 2020,52,9,31,1783910,363248913,365032823,5,31,2,361465003,In > Out
Sept 2020,52,97,10,1918831,122549424,124468255,7,5,7,120630593,In > Out
Sept 2020,54,105,72,2198002,116401457,118599459,27,72,2,114203455,In > Out
Sept 2020,54,109,42,2295976,138599165,140895141,15,42,2,136303189,In > Out
Sept 2020,54,110,79,45308490,2918123962,2963432452,24,79,2,2872815472,In > Out
Sept 2020,54,115,31,422274,12891815,13314089,12,31,2,12469541,In > Out
Sept 2020,54,116,102,43337694,2847007987,2890345681,26,102,2,2803670293,In > Out
Sept 2020,54,117,60,39164547,2569056399,2608220946,17,60,2,2529891852,In > Out
Sept 2020,54,118,60,43725217,2879598952,2923324169,16,59,2,2835873735,In > Out
Sept 2020,54,119,59,38589177,2518122405,2556711582,15,59,1,2479533228,In > Out
Sept 2020,54,120,31,453031,10152911,10605942,12,31,2,9699880,In > Out
Sept 2020,54,121,30,1199198,27661710,28860908,12,30,2,26462512,In > Out
Sept 2020,54,122,49,3238264,164670255,167908519,19,49,2,161431991,In > Out
Sept 2020,54,127,201,53747916,3387136919,3440884835,26,201,2,3333389003,In > Out
Sept 2020,54,128,68,659860,105666071,106325931,26,67,2,105006211,In > Out
Sept 2020,54,131,163,7842446,417139428,424981874,26,163,2,409296982,In > Out
Sept 2020,54,134,227,11358882,626256089,637614971,27,226,2,614897207,In > Out
Sept 2020,54,140,42,1682156,98903888,100586044,14,42,2,97221732,In > Out
Sept 2020,54,141,49,1031112,49028195,50059307,23,48,2,47997083,In > Out
Sept 2020,54,145,44,1887786,103741069,105628855,16,44,2,101853283,In > Out
Sept 2020,54,155,21,12140849,1178938067,1191078916,5,21,1,1166797218,In > Out
Sept 2020,54,156,170,24024086,1114204974,1138229060,5,170,2,1090180888,In > Out
Sept 2020,54,158,108,587595189,1086761823,1674357012,51,107,3,499166634,In > Out
Sept 2020,54,166,48,9847048,286260214,296107262,27,48,2,276413166,In > Out
Sept 2020,54,20,24,6853049,457940456,464793505,7,24,2,451087407,In > Out
Sept 2020,54,21,25,5256962,446704940,451961902,7,25,2,441447978,In > Out
Sept 2020,54,22,26,7488156,542254226,549742382,10,26,2,534766070,In > Out
Sept 2020,54,23,113,9675079,587339350,597014429,50,112,2,577664271,In > Out
Sept 2020,54,24,21,8084215,702619454,710703669,7,21,2,694535239,In > Out
Sept 2020,54,25,11,4157880,388381046,392538926,5,11,2,384223166,In > Out
Sept 2020,54,26,24,7389956,617632100,625022056,6,24,2,610242144,In > Out
Sept 2020,54,27,22,6898500,563320772,570219272,8,22,2,556422272,In > Out
Sept 2020,54,28,66,6944535,525227992,532172527,28,65,2,518283457,In > Out
Sept 2020,54,29,23,4770705,348249436,353020141,6,23,2,343478731,In > Out
Sept 2020,54,30,26,5564960,539329981,544894941,7,26,2,533765021,In > Out
Sept 2020,54,31,24,8617907,722044580,730662487,7,24,2,713426673,In > Out
Sept 2020,54,32,21,5242957,508843608,514086565,7,21,2,503600651,In > Out
Sept 2020,54,33,23,7442170,510722965,518165135,6,23,2,503280795,In > Out
Sept 2020,54,35,131,7968214,620396818,628365032,9,131,2,612428604,In > Out
Sept 2020,54,36,12,3782275,339964519,343746794,5,12,2,336182244,In > Out
Sept 2020,54,37,22,8493738,632000800,640494538,8,22,2,623507062,In > Out
Sept 2020,54,38,25,6618746,499923771,506542517,6,25,2,493305025,In > Out
Sept 2020,54,39,23,5332151,576608357,581940508,8,23,2,571276206,In > Out
Sept 2020,54,40,23,8552200,695490636,704042836,9,23,2,686938436,In > Out
Sept 2020,54,41,24,6302128,419145580,425447708,7,24,2,412843452,In > Out
Sept 2020,54,42,24,7792620,486003118,493795738,7,24,2,478210498,In > Out
Sept 2020,54,43,14,3321716,300883478,304205194,7,14,2,297561762,In > Out
Sept 2020,54,44,20,6336506,545550175,551886681,7,20,2,539213669,In > Out
Sept 2020,54,45,36,6662603,538518366,545180969,10,36,2,531855763,In > Out
Sept 2020,54,46,142,15566574,535515607,551082181,69,141,2,519949033,In > Out
Sept 2020,54,47,60,10630897,724987305,735618202,27,60,2,714356408,In > Out
Sept 2020,54,48,20,5135567,333205333,338340900,6,20,2,328069766,In > Out
Sept 2020,54,49,10,2946568,295169565,298116133,6,10,2,292222997,In > Out
Sept 2020,54,50,54,8084457,558219399,566303856,26,54,2,550134942,In > Out
Sept 2020,54,51,26,9379065,741310808,750689873,7,26,2,731931743,In > Out
Sept 2020,54,52,55,25225450,583692212,608917662,25,55,2,558466762,In > Out
Sept 2020,54,53,24,4458587,353751063,358209650,7,24,2,349292476,In > Out
Sept 2020,54,54,74,9939893,608649635,618589528,35,74,2,598709742,In > Out
Sept 2020,54,55,11,4055045,365611565,369666610,5,11,2,361556520,In > Out
Sept 2020,54,56,23,5659658,335211703,340871361,7,23,2,329552045,In > Out
Sept 2020,54,58,22,6100463,508127056,514227519,6,22,2,502026593,In > Out
Sept 2020,54,59,13,3013044,217176880,220189924,6,13,2,214163836,In > Out
Sept 2020,54,60,27,8242426,651582075,659824501,7,27,2,643339649,In > Out
Sept 2020,54,61,25,6128061,458420563,464548624,6,25,2,452292502,In > Out
Sept 2020,54,62,22,2818203,240179349,242997552,6,22,2,237361146,In > Out
Sept 2020,54,63,21,7376801,617655181,625031982,7,21,2,610278380,In > Out
Sept 2020,54,64,24,7734748,606751036,614485784,7,24,2,599016288,In > Out
Sept 2020,54,67,25,5089109,457512275,462601384,7,25,2,452423166,In > Out
Sept 2020,54,68,24,6774254,631187975,637962229,7,24,2,624413721,In > Out
Sept 2020,54,69,23,3791433,249895595,253687028,6,23,2,246104162,In > Out
Sept 2020,54,70,23,7444959,677927473,685372432,6,23,2,670482514,In > Out
Sept 2020,54,71,23,5033067,349729559,354762626,7,23,2,344696492,In > Out
Sept 2020,54,72,24,7358480,600603714,607962194,6,24,2,593245234,In > Out
Sept 2020,54,73,22,5690373,444954064,450644437,6,22,2,439263691,In > Out
Sept 2020,54,74,22,7145188,583356724,590501912,6,22,2,576211536,In > Out
Sept 2020,54,79,11,4253619,320683610,324937229,6,11,2,316429991,In > Out
Sept 2020,54,80,23,7357906,557575477,564933383,7,23,2,550217571,In > Out
Sept 2020,54,81,25,5416853,366152460,371569313,6,25,2,360735607,In > Out
Sept 2020,54,82,23,7221129,572464207,579685336,8,23,2,565243078,In > Out
Sept 2020,54,83,22,7263687,539455584,546719271,6,22,2,532191897,In > Out
Sept 2020,54,84,12,3015277,241109731,244125008,5,12,2,238094454,In > Out
Sept 2020,54,85,24,7258272,534782966,542041238,7,24,2,527524694,In > Out
Sept 2020,54,86,23,6376615,583021518,589398133,7,23,2,576644903,In > Out
Sept 2020,54,91,27,352435,11069264,11421699,9,27,2,10716829,In > Out
Sept 2020,54,92,58,41621955,2809554489,2851176444,16,58,2,2767932534,In > Out
Sept 2020,54,93,29,480511,9272364,9752875,12,29,2,8791853,In > Out
Sept 2020,54,95,63,41279632,2593902698,2635182330,16,63,2,2552623066,In > Out
Sept 2020,54,96,65,43441596,2843375033,2886816629,16,65,2,2799933437,In > Out
Sept 2020,54,97,27,391615,10916955,11308570,11,27,2,10525340,In > Out
Sept 2020,54,98,61,46646076,3019847141,3066493217,15,61,2,2973201065,In > Out
Sept 2020,54,99,25,506240,10223867,10730107,11,25,2,9717627,In > Out
Sept 2020,55,105,121,16453467,663292873,679746340,49,121,2,646839406,In > Out
Sept 2020,55,13,4,272629,47309533,47582162,4,4,1,47036904,In > Out
Sept 2020,55,143,6,352308,339864,692172,2,6,1,12444,Out > In
Sept 2020,56,131,2,216330,636131,852461,2,2,1,419801,In > Out
Sept 2020,56,134,72,9940189,213976847,223917036,35,71,2,204036658,In > Out
Sept 2020,56,142,122,41302802,664193055,705495857,38,122,2,622890253,In > Out
Sept 2020,56,147,171,38647620,448875725,487523345,57,171,2,410228105,In > Out
Sept 2020,56,148,100,56935827,1555353037,1612288864,48,100,2,1498417210,In > Out
Sept 2020,56,151,30,2851755,427065855,429917610,5,30,2,424214100,In > Out
Sept 2020,56,153,15,1784987,185150474,186935461,4,15,1,183365487,In > Out
Sept 2020,56,154,1570,153360440,1555415540,1708775980,121,1476,3,1402055100,In > Out
Sept 2020,56,155,55,3466498,396698625,400165123,4,55,1,393232127,In > Out
Sept 2020,56,158,232,73797919,3473719433,3547517352,31,224,2,3399921514,In > Out
Sept 2020,56,164,283,16399970,945542203,961942173,53,283,2,929142233,In > Out
Sept 2020,56,169,896,14673292,1835215860,1849889152,32,896,2,1820542568,In > Out
Sept 2020,56,176,26,2339385,644773013,647112398,8,26,2,642433628,In > Out
Sept 2020,56,177,255,27253773,2417121082,2444374855,115,254,2,2389867309,In > Out
Sept 2020,56,181,129,12427052,393486914,405913966,31,129,1,381059862,In > Out
Sept 2020,56,184,77,9895309,455800193,465695502,42,77,2,445904884,In > Out
Sept 2020,56,189,2412,247909057,2042078591,2289987648,145,2236,3,1794169534,In > Out
Sept 2020,56,194,24,792468,14358989,15151457,12,24,1,13566521,In > Out
Sept 2020,56,196,1833,387992420,4428583385,4816575805,169,1730,3,4040590965,In > Out
Sept 2020,56,199,110,2314126,14432096,16746222,6,110,2,12117970,In > Out
Sept 2020,56,221,146,20313160,2609196832,2629509992,36,145,2,2588883672,In > Out
Sept 2020,56,223,403,10183709,3744034789,3754218498,32,402,2,3733851080,In > Out
Sept 2020,56,224,311,10060320,3920223963,3930284283,32,310,2,3910163643,In > Out
Sept 2020,56,225,397,12378688,4273073639,4285452327,33,396,2,4260694951,In > Out
Sept 2020,56,226,322,9749499,3832409347,3842158846,36,319,2,3822659848,In > Out
Sept 2020,56,228,3,198471,35378413,35576884,2,3,1,35179942,In > Out
Sept 2020,56,229,9,1221709,104747869,105969578,7,9,1,103526160,In > Out
Sept 2020,56,231,2746,750324416,1222266213,1972590629,93,2524,3,471941797,In > Out
Sept 2020,56,240,232,3448176,342895841,346344017,11,232,2,339447665,In > Out
Sept 2020,56,241,71,142118406,59011092,201129498,38,70,2,83107314,Out > In
Sept 2020,56,242,3286,4301059957,6248946855,10550006812,109,3286,2,1947886898,In > Out
Sept 2020,56,243,35,1947649,367417049,369364698,13,35,2,365469400,In > Out
Sept 2020,56,244,42,6625636,322152156,328777792,16,42,2,315526520,In > Out
Sept 2020,56,246,210,71196069,3361456014,3432652083,34,208,2,3290259945,In > Out
Sept 2020,56,250,234,81905877,3533846870,3615752747,33,234,2,3451940993,In > Out
Sept 2020,56,252,27,2836781,163550891,166387672,4,27,1,160714110,In > Out
Sept 2020,56,253,176,12485704,591980680,604466384,88,176,2,579494976,In > Out
Sept 2020,57,129,1,236724,38906,275630,1,1,1,197818,Out > In
Sept 2020,57,147,53,571907,24862252,25434159,6,52,2,24290345,In > Out
Sept 2020,57,150,142,67824872,3575861510,3643686382,40,139,2,3508036638,In > Out
Sept 2020,57,170,2,12602,251716,264318,2,2,1,239114,In > Out
Sept 2020,57,172,185,98201375,6924796356,7022997731,34,184,2,6826594981,In > Out
Sept 2020,57,174,32,10066601,350841382,360907983,6,32,2,340774781,In > Out
Sept 2020,57,179,445,139518358,4097828407,4237346765,215,442,3,3958310049,In > Out
Sept 2020,57,180,1585,745530984,292212968,1037743952,8,1503,3,453318016,Out > In
Sept 2020,57,2,9,2515717,137947135,140462852,4,9,2,135431418,In > Out
Sept 2020,57,203,446,68818255,4481608644,4550426899,35,445,2,4412790389,In > Out
Sept 2020,57,212,116,1612766,109814516,111427282,5,116,2,108201750,In > Out
Sept 2020,57,216,1129,126037906,2071719998,2197757904,383,1087,2,1945682092,In > Out
Sept 2020,57,221,34,2002922,10253783,12256705,21,34,1,8250861,In > Out
Sept 2020,57,229,42,1402640,42114254,43516894,14,42,1,40711614,In > Out
Sept 2020,57,231,108,45740504,3236967844,3282708348,30,108,2,3191227340,In > Out
Sept 2020,57,232,38,1879191,62064227,63943418,27,38,1,60185036,In > Out
Sept 2020,57,235,193,31982990,1957723158,1989706148,99,193,3,1925740168,In > Out
Sept 2020,57,239,101,6108592,266678958,272787550,41,101,3,260570366,In > Out
Sept 2020,57,240,60,57717227,196618296,254335523,43,60,3,138901069,In > Out
Sept 2020,57,241,364,118901547,8630954666,8749856213,117,364,5,8512053119,In > Out
Sept 2020,57,242,41,2418306,26212236,28630542,19,41,3,23793930,In > Out
Sept 2020,58,208,504,17872356,1177593181,1195465537,70,504,2,1159720825,In > Out
Sept 2020,58,218,1382,811385433,2416545889,3227931322,324,1353,3,1605160456,In > Out
Sept 2020,58,222,115,6779084,467257218,474036302,15,114,3,460478134,In > Out
Sept 2020,58,228,7,388525,421040,809565,2,7,1,32515,In > Out
Sept 2020,58,234,790,221137838,11346509153,11567646991,104,790,3,11125371315,In > Out
Sept 2020,59,16,2487,1830520982,612007790,2442528772,49,2301,2,1218513192,Out > In
Sept 2020,59,18,254,25659755260,19448065531,45107820791,96,232,251,6211689729,Out > In
Sept 2020,59,19,2592,1612371765,534559104,2146930869,28,2488,1,1077812661,Out > In
Sept 2020,59,20,87,2750851,215492678,218243529,8,87,1,212741827,In > Out
Sept 2020,59,21,188,14805379864,16933147908,31738527772,89,164,179,2127768044,In > Out
Sept 2020,6,150,1761,23848901,1552031251,1575880152,59,1697,2,1528182350,In > Out
Sept 2020,6,167,201,35086608,1337794879,1372881487,40,201,2,1302708271,In > Out
Sept 2020,6,194,4,190419,13657774,13848193,3,4,2,13467355,In > Out
Sept 2020,6,4,235,15140851,695165339,710306190,34,234,2,680024488,In > Out
Sept 2020,6,43,1324,187646013,15270259183,15457905196,170,1287,2,15082613170,In > Out
Sept 2020,6,45,161,43043027,1057354355,1100397382,62,161,2,1014311328,In > Out
Sept 2020,6,6,324,152015389,846981594,998996983,162,324,2,694966205,In > Out
Sept 2020,6,8,230,20639462,1052906420,1073545882,38,229,2,1032266958,In > Out
Sept 2020,63,128,28,2560282,116386664,118946946,17,27,2,113826382,In > Out
Sept 2020,63,168,50,5941495,360124350,366065845,21,50,2,354182855,In > Out
Sept 2020,63,182,968,48669764,3200643719,3249313483,34,967,2,3151973955,In > Out
Sept 2020,63,223,193,11531613,987923100,999454713,41,193,2,976391487,In > Out
Sept 2020,63,61,137,10769381,801053527,811822908,37,137,2,790284146,In > Out
Sept 2020,63,81,191,12940994,32462802,45403796,60,191,2,19521808,In > Out
Sept 2020,65,106,1,2250,107726,109976,1,1,1,105476,In > Out
Sept 2020,65,128,1445,2619284235,18317552325,20936836560,366,1436,5,15698268090,In > Out
Sept 2020,65,144,922,28024504833,1912125322,29936630155,152,907,2,26112379511,Out > In
Sept 2020,65,153,1598,180765810,7122428319,7303194129,95,1598,3,6941662509,In > Out
Sept 2020,65,158,384,44682115,3657452781,3702134896,29,383,2,3612770666,In > Out
Sept 2020,65,165,76,85462776,3180913106,3266375882,27,75,2,3095450330,In > Out
Sept 2020,65,178,50,2377449,127148232,129525681,10,50,2,124770783,In > Out
Sept 2020,65,186,1,33166,2257340,2290506,1,1,1,2224174,In > Out
Sept 2020,65,19,560,18556528,627197914,645754442,50,560,2,608641386,In > Out
Sept 2020,65,219,11,1884266,201410739,203295005,6,11,1,199526473,In > Out
Sept 2020,65,226,339,19036108,1157758650,1176794758,58,335,2,1138722542,In > Out
Sept 2020,65,236,1152,172495152,1234241446,1406736598,46,1098,2,1061746294,In > Out
Sept 2020,65,44,247,117774346,3574602391,3692376737,116,245,2,3456828045,In > Out
Sept 2020,65,76,732,180315979,4354581865,4534897844,221,723,3,4174265886,In > Out
Sept 2020,65,99,241,117535243,4019474099,4137009342,31,241,2,3901938856,In > Out
Sept 2020,7,107,1186,152926652,660846430,813773082,59,1186,3,507919778,In > Out
Sept 2020,7,108,40,1533036,27884776,29417812,9,39,1,26351740,In > Out
Sept 2020,7,11,270,832148981,9563036639,10395185620,86,265,10,8730887658,In > Out
Sept 2020,7,119,27402,17714341399,241912930286,259627271685,1015,14404,1010,224198588887,In > Out
Sept 2020,7,12,4465,4535883071,13073049070,17608932141,915,3951,15,8537165999,In > Out
Sept 2020,7,129,244,11041394,502871767,513913161,27,243,2,491830373,In > Out
Sept 2020,7,165,27,942480,36349710,37292190,1,27,1,35407230,In > Out
Sept 2020,7,172,765,83100135,466006838,549106973,12,740,3,382906703,In > Out
Sept 2020,7,186,1,494616,18747,513363,1,1,1,475869,Out > In
Sept 2020,7,202,444,14004969,2288926793,2302931762,27,432,3,2274921824,In > Out
Sept 2020,7,208,49,2808353,238811894,241620247,12,49,2,236003541,In > Out
Sept 2020,7,213,150,7299621,1399113538,1406413159,13,150,3,1391813917,In > Out
Sept 2020,7,248,59,6416218,39259295,45675513,19,59,1,32843077,In > Out
Sept 2020,7,47,36,313262,14967360,15280622,5,36,1,14654098,In > Out
Sept 2020,7,49,34,1234449,35125682,36360131,3,34,1,33891233,In > Out
Sept 2020,7,56,940,131268191,541514736,672782927,44,940,2,410246545,In > Out
Sept 2020,7,58,47,72725865,58262034,130987899,14,47,3,14463831,Out > In
Sept 2020,7,69,15,91530,4319227,4410757,3,15,1,4227697,In > Out
Sept 2020,7,77,2,11699012,9599558,21298570,1,1,1,2099454,Out > In
Sept 2020,7,84,32,3166277,224592266,227758543,15,32,3,221425989,In > Out
Sept 2020,7,90,1792,236551467,1079384488,1315935955,79,1661,2,842833021,In > Out
Sept 2020,7,91,42,3118324,7100885,10219209,8,42,1,3982561,In > Out
Sept 2020,70,10,1201,181397720,21007248693,21188646413,326,1187,10,20825850973,In > Out
Sept 2020,70,100,717,576006127,1534897390,2110903517,269,714,5,958891263,In > Out
Sept 2020,70,101,317,197844987,1325761903,1523606890,135,310,9,1127916916,In > Out
Sept 2020,70,103,550,734372286,4678545451,5412917737,207,542,6,3944173165,In > Out
Sept 2020,70,104,1354,337527170,8632547288,8970074458,317,1320,10,8295020118,In > Out
Sept 2020,70,106,682,262918301,2624714900,2887633201,162,678,5,2361796599,In > Out
Sept 2020,70,107,524,242462742,3713378215,3955840957,179,523,5,3470915473,In > Out
Sept 2020,70,108,1178,828083230,8832842667,9660925897,241,1152,4,8004759437,In > Out
Sept 2020,70,11,430,60308614,2470231054,2530539668,187,425,5,2409922440,In > Out
Sept 2020,70,113,625,586546437,2045067893,2631614330,270,620,5,1458521456,In > Out
Sept 2020,70,114,1680,1212148116,12045879832,13258027948,498,1623,6,10833731716,In > Out
Sept 2020,70,115,425,102537035,6977853496,7080390531,149,421,4,6875316461,In > Out
Sept 2020,70,121,572,290037706,5878976864,6169014570,237,569,4,5588939158,In > Out
Sept 2020,70,124,665,929034328,3156114371,4085148699,252,655,10,2227080043,In > Out
Sept 2020,70,128,279,107800387,2731164806,2838965193,98,275,15,2623364419,In > Out
Sept 2020,70,13,615,208660185,4603889874,4812550059,204,609,4,4395229689,In > Out
Sept 2020,70,131,468,93254193,2651538481,2744792674,161,464,5,2558284288,In > Out
Sept 2020,70,134,1038,3388157862,6622934468,10011092330,320,1020,11,3234776606,In > Out
Sept 2020,70,135,1793,320347876,8289881756,8610229632,354,1643,7,7969533880,In > Out
Sept 2020,70,136,1237,525804263,17219326145,17745130408,393,1207,18,16693521882,In > Out
Sept 2020,70,138,1706,611147010,10704755149,11315902159,339,1629,5,10093608139,In > Out
Sept 2020,70,139,686,76305150,2958807159,3035112309,251,670,6,2882502009,In > Out
Sept 2020,70,14,695,171644349,4052726875,4224371224,133,684,7,3881082526,In > Out
Sept 2020,70,140,690,462431441,5385166992,5847598433,228,686,5,4922735551,In > Out
Sept 2020,70,141,828,356167238,2978125681,3334292919,189,818,9,2621958443,In > Out
Sept 2020,70,142,840,188198582,5333404677,5521603259,296,836,9,5145206095,In > Out
Sept 2020,70,143,162,48284561,957079775,1005364336,74,162,3,908795214,In > Out
Sept 2020,70,146,1050,255621157,7176277792,7431898949,359,1010,5,6920656635,In > Out
Sept 2020,70,148,466,535239385,3389343045,3924582430,154,457,5,2854103660,In > Out
Sept 2020,70,149,565,233903423,3662916989,3896820412,188,554,6,3429013566,In > Out
Sept 2020,70,15,671,4253513893,2577286075,6830799968,230,657,10,1676227818,Out > In
Sept 2020,70,151,771,193626061,8526765835,8720391896,219,757,8,8333139774,In > Out
Sept 2020,70,158,448,545594470,2221014937,2766609407,144,439,5,1675420467,In > Out
Sept 2020,70,159,277,76336576,1458848680,1535185256,130,274,9,1382512104,In > Out
Sept 2020,70,165,900,229652463,5854943550,6084596013,289,873,8,5625291087,In > Out
Sept 2020,70,166,548,191458292,1070394369,1261852661,154,544,5,878936077,In > Out
Sept 2020,70,168,750,251056216,1173087513,1424143729,243,743,17,922031297,In > Out
Sept 2020,70,171,322,363184848,13120303145,13483487993,92,322,4,12757118297,In > Out
Sept 2020,70,174,412,297298897,8155842234,8453141131,168,410,5,7858543337,In > Out
Sept 2020,70,175,1847,590872040,15213924270,15804796310,415,1794,11,14623052230,In > Out
Sept 2020,70,177,1139,358663465,12815070538,13173734003,332,1101,6,12456407073,In > Out
Sept 2020,70,178,6246,13789169950,267552954702,281342124652,882,5595,7,253763784752,In > Out
Sept 2020,70,179,712,329080002,5609748731,5938828733,230,706,13,5280668729,In > Out
Sept 2020,70,18,3112,1117183045,19722496376,20839679421,852,2862,6,18605313331,In > Out
Sept 2020,70,181,435,211861467,10426792470,10638653937,154,430,8,10214931003,In > Out
Sept 2020,70,183,641,967594106,4423019353,5390613459,250,626,8,3455425247,In > Out
Sept 2020,70,187,955,171043656,3090577926,3261621582,250,932,5,2919534270,In > Out
Sept 2020,70,188,314,119016607,1966956596,2085973203,132,310,7,1847939989,In > Out
Sept 2020,70,189,501,134729487,1559241628,1693971115,207,487,6,1424512141,In > Out
Sept 2020,70,19,392,95719959,1101823322,1197543281,78,392,5,1006103363,In > Out
Sept 2020,70,192,933,136378741,7688809100,7825187841,290,928,10,7552430359,In > Out
Sept 2020,70,193,1585,1957987362,9088762788,11046750150,464,1542,12,7130775426,In > Out
Sept 2020,70,197,50,5396834,43443165,48839999,26,50,1,38046331,In > Out
Sept 2020,70,199,651,94546803,3150357557,3244904360,184,642,5,3055810754,In > Out
Sept 2020,70,20,868,4319785033,8785348133,13105133166,175,850,7,4465563100,In > Out
Sept 2020,70,200,62,23535924,4530344581,4553880505,22,62,2,4506808657,In > Out
Sept 2020,70,201,1650,650758480,12536860681,13187619161,494,1590,7,11886102201,In > Out
Sept 2020,70,204,1626,864289099,22755623308,23619912407,484,1536,8,21891334209,In > Out
Sept 2020,70,206,275,522068915,6970459519,7492528434,123,275,5,6448390604,In > Out
Sept 2020,70,207,758,554746254,4851866613,5406612867,254,738,7,4297120359,In > Out
Sept 2020,70,208,497,72164431,1606912201,1679076632,134,494,7,1534747770,In > Out
Sept 2020,70,209,712,417894103,16720386412,17138280515,230,704,6,16302492309,In > Out
Sept 2020,70,21,821,530449754,14529568855,15060018609,292,809,5,13999119101,In > Out
Sept 2020,70,210,835,397390748,6057090751,6454481499,233,826,8,5659700003,In > Out
Sept 2020,70,211,973,136094414,2779926325,2916020739,328,954,5,2643831911,In > Out
Sept 2020,70,214,247,24837534,665456860,690294394,112,246,4,640619326,In > Out
Sept 2020,70,217,255,93704418,1402246070,1495950488,151,253,8,1308541652,In > Out
Sept 2020,70,218,1578,562422014,11534628026,12097050040,280,1526,6,10972206012,In > Out
Sept 2020,70,222,500,84127541,4741464989,4825592530,140,497,3,4657337448,In > Out
Sept 2020,70,223,655,939953839,3592595902,4532549741,208,638,7,2652642063,In > Out
Sept 2020,70,23,495,278986712,3937457755,4216444467,199,490,6,3658471043,In > Out
Sept 2020,70,25,755,103316237,3826046678,3929362915,264,745,7,3722730441,In > Out
Sept 2020,70,26,2189,661090959,13081115429,13742206388,486,2088,14,12420024470,In > Out
Sept 2020,70,27,531,223355197,4325770231,4549125428,177,526,4,4102415034,In > Out
Sept 2020,70,28,409,3604861234,5592129060,9196990294,186,403,6,1987267826,In > Out
Sept 2020,70,30,986,158447147,2669333162,2827780309,240,947,7,2510886015,In > Out
Sept 2020,70,32,296,361123610,1152349741,1513473351,121,294,8,791226131,In > Out
Sept 2020,70,33,373,45498018,2813371063,2858869081,136,372,4,2767873045,In > Out
Sept 2020,70,34,912,244158070,2687500031,2931658101,261,905,11,2443341961,In > Out
Sept 2020,70,35,455,90951461,4715044968,4805996429,152,450,7,4624093507,In > Out
Sept 2020,70,37,526,561379142,2734088043,3295467185,202,521,7,2172708901,In > Out
Sept 2020,70,4,361,40520615,2980658971,3021179586,131,359,5,2940138356,In > Out
Sept 2020,70,40,2025,255605685,8992504433,9248110118,448,1946,4,8736898748,In > Out
Sept 2020,70,43,471,38243019,2284849126,2323092145,111,468,3,2246606107,In > Out
Sept 2020,70,44,347,31125894,999972075,1031097969,168,347,4,968846181,In > Out
Sept 2020,70,47,513,202225764,3231767961,3433993725,222,511,5,3029542197,In > Out
Sept 2020,70,48,923,421280839,6946824084,7368104923,231,912,6,6525543245,In > Out
Sept 2020,70,51,817,868832413,3646314271,4515146684,192,811,3,2777481858,In > Out
Sept 2020,70,54,1061,203278238,11912070113,12115348351,326,1039,7,11708791875,In > Out
Sept 2020,70,56,343,120689695,4029518472,4150208167,140,343,6,3908828777,In > Out
Sept 2020,70,58,1581,616206097,33900179230,34516385327,435,1439,4,33283973133,In > Out
Sept 2020,70,59,634,348450780,5441440782,5789891562,215,622,11,5092990002,In > Out
Sept 2020,70,6,943,100881657,4496244689,4597126346,225,894,11,4395363032,In > Out
Sept 2020,70,61,370,281765331,5140486680,5422252011,152,370,3,4858721349,In > Out
Sept 2020,70,62,1071,115319968,4569937619,4685257587,368,1046,5,4454617651,In > Out
Sept 2020,70,64,2411,483402525,12429390098,12912792623,330,2323,11,11945987573,In > Out
Sept 2020,70,66,326,58709819,2400123172,2458832991,101,325,5,2341413353,In > Out
Sept 2020,70,67,440,71638457,779411833,851050290,152,439,4,707773376,In > Out
Sept 2020,70,68,717,503317700,36056781282,36560098982,224,709,7,35553463582,In > Out
Sept 2020,70,7,453,190373861,2480770148,2671144009,116,452,2,2290396287,In > Out
Sept 2020,70,70,367,103155669,3567584893,3670740562,135,363,3,3464429224,In > Out
Sept 2020,70,71,941,104412839,3129874851,3234287690,186,935,8,3025462012,In > Out
Sept 2020,70,72,1094,161243879,8947070986,9108314865,334,1092,6,8785827107,In > Out
Sept 2020,70,74,482,218980715,18015258794,18234239509,163,479,4,17796278079,In > Out
Sept 2020,70,75,558,360407481,5991162694,6351570175,274,556,7,5630755213,In > Out
Sept 2020,70,76,616,667910132,1944374031,2612284163,232,611,6,1276463899,In > Out
Sept 2020,70,77,675,1051506136,2057214933,3108721069,150,662,6,1005708797,In > Out
Sept 2020,70,79,306,175422470,1123182366,1298604836,112,305,8,947759896,In > Out
Sept 2020,70,83,488,204939631,4123637751,4328577382,163,477,6,3918698120,In > Out
Sept 2020,70,85,504,1760497191,11242506366,13003003557,137,488,18,9482009175,In > Out
Sept 2020,70,89,476,1794116409,5309841522,7103957931,163,461,9,3515725113,In > Out
Sept 2020,70,91,989,987693071,6818398414,7806091485,176,941,4,5830705343,In > Out
Sept 2020,70,92,1100,5644023452,8412702316,14056725768,298,1092,8,2768678864,In > Out
Sept 2020,70,94,381,117855775,5072933439,5190789214,159,381,5,4955077664,In > Out
Sept 2020,70,95,534,58455907,1558283648,1616739555,217,524,6,1499827741,In > Out
Sept 2020,70,96,1513,194947733,9696449874,9891397607,274,1388,4,9501502141,In > Out
Sept 2020,73,10,377,7792361,60745233,68537594,6,377,2,52952872,In > Out
Sept 2020,73,100,805,32908070,2403021522,2435929592,35,805,2,2370113452,In > Out
Sept 2020,73,104,4,431476,1351341,1782817,3,4,1,919865,In > Out
Sept 2020,73,105,1551,822832497,3634271705,4457104202,111,1481,4,2811439208,In > Out
Sept 2020,73,106,814,37570001,2425855560,2463425561,21,814,2,2388285559,In > Out
Sept 2020,73,107,1081,56466184,1848027428,1904493612,167,1033,3,1791561244,In > Out
Sept 2020,73,108,419,37888952,485337549,523226501,154,415,2,447448597,In > Out
Sept 2020,73,109,1219,135260136,720077319,855337455,77,1199,2,584817183,In > Out
Sept 2020,73,11,62,12654835,1194783172,1207438007,19,62,2,1182128337,In > Out
Sept 2020,73,111,5879,360966738,8553102232,8914068970,698,5022,3,8192135494,In > Out
Sept 2020,73,113,767,48797485,2676509520,2725307005,28,767,2,2627712035,In > Out
Sept 2020,73,115,175,23646605,413878126,437524731,65,173,3,390231521,In > Out
Sept 2020,73,117,2918,413068657,4922660320,5335728977,609,2646,5,4509591663,In > Out
Sept 2020,73,12,54,6637633,104181501,110819134,27,54,2,97543868,In > Out
Sept 2020,73,120,2559,236214187,3083368130,3319582317,243,2417,4,2847153943,In > Out
Sept 2020,73,121,790,3152552280,6920179682,10072731962,188,767,5,3767627402,In > Out
Sept 2020,73,122,751,27544898,2294779454,2322324352,35,751,2,2267234556,In > Out
Sept 2020,73,123,639,42489208,3067368338,3109857546,49,639,2,3024879130,In > Out
Sept 2020,73,127,3529,251415003,3342380611,3593795614,311,3148,3,3090965608,In > Out
Sept 2020,73,13,1410,99122623,4614283675,4713406298,306,1342,2,4515161052,In > Out
Sept 2020,73,130,2519,254409123,3099684468,3354093591,244,2374,6,2845275345,In > Out
Sept 2020,73,134,916,178492160,8019503938,8197996098,295,899,2,7841011778,In > Out
Sept 2020,73,136,101,24315372,756266380,780581752,19,101,2,731951008,In > Out
Sept 2020,73,137,138,29703525,991734758,1021438283,45,138,3,962031233,In > Out
Sept 2020,73,138,3056,583530097,17580508093,18164038190,395,2841,3,16996977996,In > Out
Sept 2020,73,139,5454,264797201,9402068996,9666866197,598,4704,2,9137271795,In > Out
Sept 2020,73,14,28,1406712,19972555,21379267,12,28,1,18565843,In > Out
Sept 2020,73,143,1919,246821976,1357278036,1604100012,236,1804,3,1110456060,In > Out
Sept 2020,73,144,883,33735652,2673686206,2707421858,44,883,2,2639950554,In > Out
Sept 2020,73,145,234,30856949,892687418,923544367,49,234,2,861830469,In > Out
Sept 2020,73,150,1747,686860062,14793036635,15479896697,150,1687,4,14106176573,In > Out
Sept 2020,73,157,69,207110669,68054823,275165492,30,8,48,139055846,Out > In
Sept 2020,73,16,1972,914668311,9112316269,10026984580,357,1869,2,8197647958,In > Out
Sept 2020,73,160,123,6255118,50529832,56784950,19,123,2,44274714,In > Out
Sept 2020,73,162,7,5172121,327986237,333158358,3,7,2,322814116,In > Out
Sept 2020,73,163,675,103548542,1169201179,1272749721,48,661,2,1065652637,In > Out
Sept 2020,73,166,184,4943477,136065919,141009396,18,184,1,131122442,In > Out
Sept 2020,73,169,2631,637964923,4186307778,4824272701,385,2435,5,3548342855,In > Out
Sept 2020,73,17,981,121484106,6732872798,6854356904,148,951,3,6611388692,In > Out
Sept 2020,73,170,202,15171841,78012550,93184391,32,201,1,62840709,In > Out
Sept 2020,73,181,34908,97420419936,176337712953,273758132889,3087,15797,33,78917293017,In > Out
Sept 2020,73,182,2,1601221,86388034,87989255,2,2,2,84786813,In > Out
Sept 2020,73,189,2,1775574,86302056,88077630,2,2,2,84526482,In > Out
Sept 2020,73,190,108,1359686,14762573,16122259,4,108,3,13402887,In > Out
Sept 2020,73,193,5,1844201,104355913,106200114,3,5,2,102511712,In > Out
Sept 2020,73,194,1,95304,38645,133949,1,1,1,56659,Out > In
Sept 2020,73,195,16,3058845,1872627,4931472,11,13,3,1186218,Out > In
Sept 2020,73,196,686,129865575,10883742273,11013607848,182,686,4,10753876698,In > Out
Sept 2020,73,198,32,1023413,8066773,9090186,4,32,4,7043360,In > Out
Sept 2020,73,20,21,647596,37107175,37754771,6,21,2,36459579,In > Out
Sept 2020,73,206,539,3450465676,3782335063,7232800739,186,526,4,331869387,In > Out
Sept 2020,73,208,1371,1024859507,16029031700,17053891207,303,1331,3,15004172193,In > Out
Sept 2020,73,21,34,3793760,69597007,73390767,15,34,2,65803247,In > Out
Sept 2020,73,211,6934,1436380122,13376320961,14812701083,868,6053,10,11939940839,In > Out
Sept 2020,73,215,1679,6184607917,6105688652,12290296569,280,1615,3,78919265,Out > In
Sept 2020,73,217,38,120349277,25082747,145432024,7,33,37,95266530,Out > In
Sept 2020,73,218,283,30378397,1846229813,1876608210,59,283,4,1815851416,In > Out
Sept 2020,73,22,756,44988298,2153924282,2198912580,36,756,2,2108935984,In > Out
Sept 2020,73,220,154,13944049,22274813,36218862,4,152,3,8330764,In > Out
Sept 2020,73,23,81,8754696,492827756,501582452,24,81,2,484073060,In > Out
Sept 2020,73,237,485,54587748157,927718881,55515467038,369,1,244,53660029276,Out > In
Sept 2020,73,245,123,3488001,117371571,120859572,27,122,2,113883570,In > Out
Sept 2020,73,25,931,449319991,3079601256,3528921247,221,894,4,2630281265,In > Out
Sept 2020,73,27,269,24475112,1395749281,1420224393,50,269,2,1371274169,In > Out
Sept 2020,73,28,559,70354636,869004326,939358962,33,559,2,798649690,In > Out
Sept 2020,73,29,6,331798,358624,690422,2,6,1,26826,In > Out
Sept 2020,73,3,2,113393855,11761600,125155455,2,1,1,101632255,Out > In
Sept 2020,73,30,62,14133508,796190323,810323831,30,62,2,782056815,In > Out
Sept 2020,73,32,26,262452168,66772616,329224784,23,1,6,195679552,Out > In
Sept 2020,73,34,758,65271389,2089334423,2154605812,100,752,2,2024063034,In > Out
Sept 2020,73,37,409,21225885,1282749667,1303975552,33,409,2,1261523782,In > Out
Sept 2020,73,38,2294,352600826,3460189694,3812790520,154,2093,4,3107588868,In > Out
Sept 2020,73,39,589,69761735,3267463099,3337224834,37,589,2,3197701364,In > Out
Sept 2020,73,4,1094,255425461,11832801794,12088227255,10,1072,25,11577376333,In > Out
Sept 2020,73,41,1430,206560451,1167867459,1374427910,67,1357,2,961307008,In > Out
Sept 2020,73,42,1333,2748971788,5481078679,8230050467,154,1261,7,2732106891,In > Out
Sept 2020,73,45,2986,323985287,2622535160,2946520447,569,2759,4,2298549873,In > Out
Sept 2020,73,47,2410,1366403535,11042575686,12408979221,372,2292,3,9676172151,In > Out
Sept 2020,73,48,2388,217477690,11337921796,11555399486,386,2309,2,11120444106,In > Out
Sept 2020,73,5,59,4176794,95493549,99670343,25,59,2,91316755,In > Out
Sept 2020,73,53,49,8154713,496539627,504694340,20,49,2,488384914,In > Out
Sept 2020,73,54,2259,161306072,4121734231,4283040303,186,2174,4,3960428159,In > Out
Sept 2020,73,56,1403,782407695,2925288372,3707696067,165,1364,3,2142880677,In > Out
Sept 2020,73,57,13,2310918,78008746,80319664,5,13,1,75697828,In > Out
Sept 2020,73,58,3121,1532597790,6042932036,7575529826,306,2868,5,4510334246,In > Out
Sept 2020,73,59,1467,460307028,4594575474,5054882502,261,1414,4,4134268446,In > Out
Sept 2020,73,6,57,3410354,68795781,72206135,26,57,2,65385427,In > Out
Sept 2020,73,60,169,19368142,710625611,729993753,51,168,2,691257469,In > Out
Sept 2020,73,62,2618,281657657,2147295620,2428953277,60,2416,3,1865637963,In > Out
Sept 2020,73,63,2,190652,345840,536492,2,1,2,155188,In > Out
Sept 2020,73,64,2182,278419765,2391804649,2670224414,230,2057,3,2113384884,In > Out
Sept 2020,73,69,224,350543961,22169554565,22520098526,2,224,1,21819010604,In > Out
Sept 2020,73,7,14,9815541,19697843,29513384,10,14,1,9882302,In > Out
Sept 2020,73,72,3424,660717985,6179053029,6839771014,481,3177,4,5518335044,In > Out
Sept 2020,73,74,1,2376996,185754532,188131528,1,1,1,183377536,In > Out
Sept 2020,73,76,252,26391836,339086097,365477933,63,252,2,312694261,In > Out
Sept 2020,73,77,1,173530,11569,185099,1,1,1,161961,Out > In
Sept 2020,73,78,1194,304398648,5231584272,5535982920,138,1161,4,4927185624,In > Out
Sept 2020,73,79,3003,4091382704,12236769337,16328152041,282,2801,6,8145386633,In > Out
Sept 2020,73,8,13,77824,5148576,5226400,1,13,13,5070752,In > Out
Sept 2020,73,80,8003,1234071588,4712581881,5946653469,254,6367,4,3478510293,In > Out
Sept 2020,73,81,1,315869,16463,332332,1,1,1,299406,Out > In
Sept 2020,73,83,506,67590147,2444287124,2511877271,131,499,2,2376696977,In > Out
Sept 2020,73,86,599,37345331,3320155638,3357500969,35,599,2,3282810307,In > Out
Sept 2020,73,88,5,748749,26310701,27059450,4,5,2,25561952,In > Out
Sept 2020,73,89,454,43453030,583799787,627252817,78,451,2,540346757,In > Out
Sept 2020,73,9,7,2964310,497489704,500454014,2,7,1,494525394,In > Out
Sept 2020,73,90,172,10530823,1239670018,1250200841,31,172,2,1229139195,In > Out
Sept 2020,73,91,711,74532014,3056513900,3131045914,233,708,2,2981981886,In > Out
Sept 2020,73,92,92,2784409,227587972,230372381,37,92,2,224803563,In > Out
Sept 2020,73,94,2,1588206,105249948,106838154,2,2,2,103661742,In > Out
Sept 2020,73,96,985,134106022,783925565,918031587,60,962,2,649819543,In > Out
Sept 2020,73,98,166,15311614,643592381,658903995,47,166,2,628280767,In > Out
Sept 2020,73,99,6204,395586764,4466519517,4862106281,619,5270,4,4070932753,In > Out
Sept 2020,74,10,1546,234599818,5062637598,5297237416,327,1496,3,4828037780,In > Out
Sept 2020,74,104,86,3426517,6831735,10258252,6,86,1,3405218,In > Out
Sept 2020,74,105,142,21736370,911755825,933492195,35,142,3,890019455,In > Out
Sept 2020,74,106,364,83824606,1258645012,1342469618,111,364,2,1174820406,In > Out
Sept 2020,74,108,1873,373509705,2008344046,2381853751,205,1768,3,1634834341,In > Out
Sept 2020,74,113,303,25789146,940740689,966529835,29,302,2,914951543,In > Out
Sept 2020,74,114,1802,637195064,14523802354,15160997418,577,1719,7,13886607290,In > Out
Sept 2020,74,115,1013,120190767,1402819276,1523010043,235,1013,2,1282628509,In > Out
Sept 2020,74,117,23,156605,7151979,7308584,15,23,1,6995374,In > Out
Sept 2020,74,118,12,173802,9823146,9996948,6,12,2,9649344,In > Out
Sept 2020,74,121,293,9006650,728600442,737607092,46,293,2,719593792,In > Out
Sept 2020,74,123,976,112079499,1945605433,2057684932,57,959,3,1833525934,In > Out
Sept 2020,74,127,485,249407663,5775142873,6024550536,187,484,3,5525735210,In > Out
Sept 2020,74,134,296,50441617,173598946,224040563,75,295,2,123157329,In > Out
Sept 2020,74,14,841,160970692,3709347495,3870318187,296,818,2,3548376803,In > Out
Sept 2020,74,142,136,31978638,130430974,162409612,59,135,2,98452336,In > Out
Sept 2020,74,149,82,9987403,265026901,275014304,34,82,2,255039498,In > Out
Sept 2020,74,152,223,174238551,580706538,754945089,79,222,2,406467987,In > Out
Sept 2020,74,156,19,386066,31128153,31514219,6,19,2,30742087,In > Out
Sept 2020,74,164,357,372298220,1531641310,1903939530,121,357,2,1159343090,In > Out
Sept 2020,74,167,62,18901049,72641979,91543028,41,62,2,53740930,In > Out
Sept 2020,74,169,688,284035679,3935070917,4219106596,107,673,2,3651035238,In > Out
Sept 2020,74,172,502,81821322,354669193,436490515,144,496,2,272847871,In > Out
Sept 2020,74,179,129,7530878,453849978,461380856,62,129,2,446319100,In > Out
Sept 2020,74,180,2016,4013880313,250349999549,254363879862,192,1885,4,246336119236,In > Out
Sept 2020,74,184,59,7166208,167397304,174563512,23,59,2,160231096,In > Out
Sept 2020,74,185,94,7775698,431699320,439475018,36,94,2,423923622,In > Out
Sept 2020,74,195,332,186601716,6954262520,7140864236,30,321,2,6767660804,In > Out
Sept 2020,74,201,126,11268586,461782487,473051073,49,126,2,450513901,In > Out
Sept 2020,74,202,555,540966995,1952314283,2493281278,169,547,3,1411347288,In > Out
Sept 2020,74,203,406,124725055,845522909,970247964,112,402,4,720797854,In > Out
Sept 2020,74,204,6,115847,4818946,4934793,5,6,1,4703099,In > Out
Sept 2020,74,207,159,12361917,120855412,133217329,69,157,2,108493495,In > Out
Sept 2020,74,21,1106,222475881,2744746401,2967222282,219,1106,3,2522270520,In > Out
Sept 2020,74,211,271,1000340833,1454423432,2454764265,85,270,3,454082599,In > Out
Sept 2020,74,217,476,94264644,256713289,350977933,74,473,2,162448645,In > Out
Sept 2020,74,219,583,330033619,3096379425,3426413044,185,567,3,2766345806,In > Out
Sept 2020,74,225,2115,3405192230,10476108059,13881300289,468,2036,11,7070915829,In > Out
Sept 2020,74,229,2693,10347926848,12317618509,22665545357,411,2428,8,1969691661,In > Out
Sept 2020,74,23,44,1834775,95805743,97640518,6,44,3,93970968,In > Out
Sept 2020,74,234,3350,563000037,9192128522,9755128559,485,3049,4,8629128485,In > Out
Sept 2020,74,237,47,14921526,437896120,452817646,24,46,2,422974594,In > Out
Sept 2020,74,239,2296,2331218617,1343810618,3675029235,330,2162,2,987407999,Out > In
Sept 2020,74,25,151,84421812,3993883135,4078304947,55,151,2,3909461323,In > Out
Sept 2020,74,250,21,62932262,2444417521,2507349783,13,21,2,2381485259,In > Out
Sept 2020,74,28,5,1035104,21739479,22774583,4,5,2,20704375,In > Out
Sept 2020,74,39,75,3538208,50204195,53742403,30,75,3,46665987,In > Out
Sept 2020,74,4,1855,167749917,1671230982,1838980899,442,1727,2,1503481065,In > Out
Sept 2020,74,40,122,71996438,3075521395,3147517833,34,122,2,3003524957,In > Out
Sept 2020,74,41,1253,116457377,5778220938,5894678315,58,1253,2,5661763561,In > Out
Sept 2020,74,44,61,8167444,443357907,451525351,27,61,2,435190463,In > Out
Sept 2020,74,45,14,52554,2051122,2103676,8,14,1,1998568,In > Out
Sept 2020,74,46,719,174803931,8936882031,9111685962,99,719,2,8762078100,In > Out
Sept 2020,74,52,61,87977652,44271625,132249277,48,11,10,43706027,Out > In
Sept 2020,74,53,222,12922966,2629243483,2642166449,56,222,3,2616320517,In > Out
Sept 2020,74,57,6,298116,3112808,3410924,6,6,2,2814692,In > Out
Sept 2020,74,58,1622,406694670,2710167769,3116862439,386,1381,4,2303473099,In > Out
Sept 2020,74,6,667,56015827,2001503359,2057519186,252,642,3,1945487532,In > Out
Sept 2020,74,61,1886,228446148,9623433058,9851879206,574,1809,8,9394986910,In > Out
Sept 2020,74,65,214,18215475,917380391,935595866,39,212,2,899164916,In > Out
Sept 2020,74,85,26,4546134,105106372,109652506,19,26,1,100560238,In > Out
Sept 2020,74,89,7,456792,13750480,14207272,6,7,2,13293688,In > Out
Sept 2020,74,9,426,64258422,725458317,789716739,124,421,2,661199895,In > Out
Sept 2020,74,91,2478,906184626,2576869986,3483054612,603,2281,3,1670685360,In > Out
Sept 2020,74,93,276,3969405478,1345881243,5315286721,109,274,3,2623524235,Out > In
Sept 2020,75,213,2641,61462670,2464218343,2525681013,40,2487,2,2402755673,In > Out
Sept 2020,77,121,51,2133384,5317526,7450910,5,8,2,3184142,In > Out
Sept 2020,77,122,532,32933387,66620772,99554159,5,8,2,33687385,In > Out
Sept 2020,77,123,7,157350,1759951,1917301,1,7,1,1602601,In > Out
Sept 2020,77,134,83,245592,16721918,16967510,1,83,1,16476326,In > Out
Sept 2020,77,231,8062,2594958997,27918124207,30513083204,1742,6760,307,25323165210,In > Out
Sept 2020,79,11,6945,497765150,48722688398,49220453548,60,6494,31,48224923248,In > Out
Sept 2020,79,16,1015,1212029322,59551298072,60763327394,72,989,43,58339268750,In > Out
Sept 2020,79,22,17,1026209,330075227,331101436,4,17,1,329049018,In > Out
Sept 2020,80,108,376,128236633,6696670861,6824907494,165,280,99,6568434228,In > Out
Sept 2020,80,133,81,6483843,321942808,328426651,12,81,2,315458965,In > Out
Sept 2020,80,33,32,2812140,69068600,71880740,26,32,4,66256460,In > Out
Sept 2020,80,9,253,10221449460,35456928996,45678378456,108,253,8,25235479536,In > Out
Sept 2020,80,93,95,27592201,1358509798,1386101999,10,95,2,1330917597,In > Out
Sept 2020,81,139,1556,3799472454,103195149,3902667603,2,1341,1,3696277305,Out > In
Sept 2020,81,26,28,2449739891,69510989,2519250880,3,28,2,2380228902,Out > In
Sept 2020,81,28,5,738875,7888587,8627462,2,5,1,7149712,In > Out
Sept 2020,81,30,29,1746540104,52851654,1799391758,9,29,2,1693688450,Out > In
Sept 2020,81,31,48,349726868,10812561,360539429,6,48,2,338914307,Out > In
Sept 2020,81,32,9,11091680,287898,11379578,3,9,2,10803782,Out > In
Sept 2020,81,33,5,1131592,309426,1441018,1,5,1,822166,Out > In
Sept 2020,81,35,90,7548022,266797723,274345745,27,89,2,259249701,In > Out
Sept 2020,81,45,529,209859591,103811817,313671408,4,520,3,106047774,Out > In
Sept 2020,82,10,90,7093783,28950701,36044484,38,90,2,21856918,In > Out
Sept 2020,82,100,1075,217916394,9903528935,10121445329,286,1047,2,9685612541,In > Out
Sept 2020,82,101,522,51260463,617051618,668312081,64,514,2,565791155,In > Out
Sept 2020,82,103,2468,53814787,3657773139,3711587926,102,2305,2,3603958352,In > Out
Sept 2020,82,104,13,316017,14060808,14376825,4,13,1,13744791,In > Out
Sept 2020,82,106,48,2688509,61075619,63764128,29,48,1,58387110,In > Out
Sept 2020,82,109,25,308359,9802678,10111037,10,25,2,9494319,In > Out
Sept 2020,82,120,1089,77635427,992247269,1069882696,133,1065,2,914611842,In > Out
Sept 2020,82,121,20,1245500,48355010,49600510,11,20,2,47109510,In > Out
Sept 2020,82,129,2,214133,242552,456685,2,2,2,28419,In > Out
Sept 2020,82,133,82,46120269,104187750,150308019,44,82,2,58067481,In > Out
Sept 2020,82,134,3875,2198736350,14248482296,16447218646,700,3525,6,12049745946,In > Out
Sept 2020,82,142,2796,276762461,3667796232,3944558693,538,2557,4,3391033771,In > Out
Sept 2020,82,146,8532,3884506206,2121351196,6005857402,68,8531,3,1763155010,Out > In
Sept 2020,82,150,130,12994662,61615187,74609849,28,130,3,48620525,In > Out
Sept 2020,82,151,397,26019659,616068772,642088431,60,397,3,590049113,In > Out
Sept 2020,82,162,101,29388614,1763542309,1792930923,23,101,2,1734153695,In > Out
Sept 2020,82,169,548,58633043,702262642,760895685,199,493,17,643629599,In > Out
Sept 2020,82,208,60,5186441,101324539,106510980,26,60,1,96138098,In > Out
Sept 2020,82,224,164,93692794,273017101,366709895,79,164,2,179324307,In > Out
Sept 2020,82,239,21,140040,14383642,14523682,13,21,1,14243602,In > Out
Sept 2020,82,39,27,1766649,21375665,23142314,19,26,1,19609016,In > Out
Sept 2020,82,53,68,6181254,3078138146,3084319400,21,68,2,3071956892,In > Out
Sept 2020,82,54,1015,1121902335,6161276795,7283179130,289,982,4,5039374460,In > Out
Sept 2020,82,56,4816,3385771099,20369223872,23754994971,1039,4334,43,16983452773,In > Out
Sept 2020,82,58,31,1764720,36627036,38391756,11,31,3,34862316,In > Out
Sept 2020,82,82,2,221516,139352,360868,2,2,1,82164,Out > In
Sept 2020,82,83,72,7747866,32249742,39997608,32,72,2,24501876,In > Out
Sept 2020,82,85,13,4700753,21832411,26533164,6,13,2,17131658,In > Out
Sept 2020,82,87,511,62707529,821449191,884156720,128,508,2,758741662,In > Out
Sept 2020,82,92,1024,788586516,996213117,1784799633,248,1000,3,207626601,In > Out
Sept 2020,82,97,15,1100486,61261687,62362173,4,15,1,60161201,In > Out
Sept 2020,82,99,2,13482,699550,713032,2,2,1,686068,In > Out
Sept 2020,83,105,3379,871199367,3510760878,4381960245,443,3109,3,2639561511,In > Out
Sept 2020,83,107,2258,280574043,2304558456,2585132499,418,2064,2,2023984413,In > Out
Sept 2020,83,112,501,65517017,498640441,564157458,239,498,3,433123424,In > Out
Sept 2020,83,113,1577,3538452165,1076667934,4615120099,167,1507,2,2461784231,Out > In
Sept 2020,83,114,1115,190047137,1171042499,1361089636,220,1083,2,980995362,In > Out
Sept 2020,83,121,55,22136195,517015466,539151661,29,55,2,494879271,In > Out
Sept 2020,83,124,1167,76133051,1952958391,2029091442,282,1141,2,1876825340,In > Out
Sept 2020,83,125,740,52142737,963328126,1015470863,265,714,2,911185389,In > Out
Sept 2020,83,145,14,797645,7404049,8201694,8,14,3,6606404,In > Out
Sept 2020,83,146,213,26601282,606978116,633579398,105,213,2,580376834,In > Out
Sept 2020,83,147,77,12892413,277700210,290592623,38,77,2,264807797,In > Out
Sept 2020,83,149,963,660617780,2758479583,3419097363,359,939,4,2097861803,In > Out
Sept 2020,83,150,978,611363771,2516957692,3128321463,280,959,3,1905593921,In > Out
Sept 2020,83,151,272,91792779,516479059,608271838,97,272,3,424686280,In > Out
Sept 2020,83,152,745,80876274,4103331275,4184207549,242,745,2,4022455001,In > Out
Sept 2020,83,154,1441,526712659,3496298919,4023011578,390,1389,3,2969586260,In > Out
Sept 2020,83,155,405,49838511,990835495,1040674006,154,402,4,940996984,In > Out
Sept 2020,83,156,1654,581428197,3978752775,4560180972,528,1573,3,3397324578,In > Out
Sept 2020,83,157,54,740528761,925587288,1666116049,22,54,2,185058527,In > Out
Sept 2020,83,158,729,233926626,1291481798,1525408424,222,717,4,1057555172,In > Out
Sept 2020,83,159,3804,931790431,10793015191,11724805622,930,3501,10,9861224760,In > Out
Sept 2020,83,160,74,18574215,544360462,562934677,38,74,2,525786247,In > Out
Sept 2020,83,162,550,90125893,2004052972,2094178865,243,544,3,1913927079,In > Out
Sept 2020,83,165,72,11484538,329978922,341463460,33,72,3,318494384,In > Out
Sept 2020,83,166,425,38446613,622458588,660905201,160,416,2,584011975,In > Out
Sept 2020,83,167,1325,189829701,4327727446,4517557147,352,1277,4,4137897745,In > Out
Sept 2020,84,36,3623,1027172436,5996585442,7023757878,337,3252,9,4969413006,In > Out
Sept 2020,85,100,1823,120792038,630535919,751327957,278,1740,2,509743881,In > Out
Sept 2020,85,101,14,331106,47095452,47426558,8,14,2,46764346,In > Out
Sept 2020,85,102,722,59248083,1018221234,1077469317,225,705,2,958973151,In > Out
Sept 2020,85,103,574,78161069,2139591405,2217752474,120,566,2,2061430336,In > Out
Sept 2020,85,104,3,105079,14609622,14714701,2,3,1,14504543,In > Out
Sept 2020,85,105,1,23908,5819870,5843778,1,1,1,5795962,In > Out
Sept 2020,85,106,129,2164652119,4662412464,6827064583,68,129,4,2497760345,In > Out
Sept 2020,85,107,463,14088177298,1188186788,15276364086,145,460,4,12899990510,Out > In
Sept 2020,85,108,748,665434613,1730861100,2396295713,137,734,2,1065426487,In > Out
Sept 2020,85,109,85,218074534,424352431,642426965,33,85,4,206277897,In > Out
Sept 2020,85,110,102,1321370021,449980480,1771350501,42,102,5,871389541,Out > In
Sept 2020,85,111,100,6591297,625018269,631609566,32,100,2,618426972,In > Out
Sept 2020,85,112,370,458311750,1362687727,1820999477,183,367,6,904375977,In > Out
Sept 2020,85,113,75,5600974566,208819833,5809794399,40,74,2,5392154733,Out > In
Sept 2020,85,114,268,6999107416,3905957672,10905065088,85,268,2,3093149744,Out > In
Sept 2020,85,116,174,8690339,332747321,341437660,58,174,2,324056982,In > Out
Sept 2020,85,117,181,3525806328,4198168231,7723974559,54,181,4,672361903,In > Out
Sept 2020,85,118,2,21596,1613760,1635356,2,2,2,1592164,In > Out
Sept 2020,85,119,38,1962360,50007596,51969956,21,38,2,48045236,In > Out
Sept 2020,85,120,1182,3424166549,9539843292,12964009841,253,1153,4,6115676743,In > Out
Sept 2020,85,121,523,1161454633,11963189628,13124644261,215,515,4,10801734995,In > Out
Sept 2020,85,122,177,9401464,231402703,240804167,65,177,2,222001239,In > Out
Sept 2020,85,123,651,580002171,3386295885,3966298056,132,639,2,2806293714,In > Out
Sept 2020,85,124,6,191333,11641209,11832542,5,6,1,11449876,In > Out
Sept 2020,85,125,392,6708561876,2724144386,9432706262,160,392,4,3984417490,Out > In
Sept 2020,85,126,2256,10787271754,18070560015,28857831769,302,2098,7,7283288261,In > Out
Sept 2020,85,127,155,23085492,351599209,374684701,50,155,2,328513717,In > Out
Sept 2020,85,128,534,3829235641,651034003,4480269644,181,524,3,3178201638,Out > In
Sept 2020,85,129,518,8824082793,3379541470,12203624263,221,513,4,5444541323,Out > In
Sept 2020,85,130,1051,4742025166,6570364588,11312389754,280,1028,12,1828339422,In > Out
Sept 2020,85,131,340,832685550,1597603148,2430288698,123,338,4,764917598,In > Out
Sept 2020,85,132,1166,15649391934,6284060958,21933452892,278,1126,6,9365330976,Out > In
Sept 2020,85,133,1188,1276770968,2716412225,3993183193,370,1175,12,1439641257,In > Out
Sept 2020,85,134,709,76836039,155698967,232535006,56,709,2,78862928,In > Out
Sept 2020,85,135,2168,39049301,2620560613,2659609914,179,2051,2,2581511312,In > Out
Sept 2020,85,136,339,4559945447,4528939499,9088884946,152,335,5,31005948,Out > In
Sept 2020,85,137,32,17367119,8347471828,8364838947,12,32,2,8330104709,In > Out
Sept 2020,85,138,122,5330453,162348672,167679125,60,122,1,157018219,In > Out
Sept 2020,85,139,1802,721137108,5571337993,6292475101,261,1761,5,4850200885,In > Out
Sept 2020,85,140,631,48198018,1246733985,1294932003,184,625,2,1198535967,In > Out
Sept 2020,85,141,14,1006930,8564356,9571286,6,14,1,7557426,In > Out
Sept 2020,85,142,507,32066642,2701484292,2733550934,69,507,2,2669417650,In > Out
Sept 2020,85,143,292,4386082249,852221582,5238303831,120,291,4,3533860667,Out > In
Sept 2020,85,144,943,4156872278,3867851250,8024723528,293,926,5,289021028,Out > In
Sept 2020,85,145,12,1217788,31117499,32335287,6,12,2,29899711,In > Out
Sept 2020,85,147,295,9845337,1000691198,1010536535,35,293,2,990845861,In > Out
Sept 2020,85,15,41,3892841,93839809,97732650,17,41,2,89946968,In > Out
Sept 2020,85,153,50,649741,98446131,99095872,19,50,2,97796390,In > Out
Sept 2020,85,16,21,12496646508,12501993800,24998640308,16,1,5,5347292,In > Out
Sept 2020,85,168,20,612018,176488024,177100042,15,20,2,175876006,In > Out
Sept 2020,85,172,1487,105300070,3192478890,3297778960,221,1457,2,3087178820,In > Out
Sept 2020,85,2,2,312539,49027,361566,2,1,1,263512,Out > In
Sept 2020,85,23,29,791454,49813977,50605431,8,29,2,49022523,In > Out
Sept 2020,85,24,9,265360,16002041,16267401,4,9,2,15736681,In > Out
Sept 2020,85,28,311,31419360,372352736,403772096,112,311,2,340933376,In > Out
Sept 2020,85,48,564,432465714,513708443,946174157,23,556,3,81242729,In > Out
Sept 2020,85,49,1,78455,12567289,12645744,1,1,1,12488834,In > Out
Sept 2020,85,51,258,8894702,878831545,887726247,40,258,2,869936843,In > Out
Sept 2020,85,52,192,98222520,269501563,367724083,65,191,2,171279043,In > Out
Sept 2020,85,53,598,33221052,2005602138,2038823190,197,591,2,1972381086,In > Out
Sept 2020,85,54,1224,184399976,925397929,1109797905,247,1187,2,740997953,In > Out
Sept 2020,85,55,267,123565985,2926913760,3050479745,69,267,2,2803347775,In > Out
Sept 2020,85,57,1133,87053364,3979454853,4066508217,270,1091,2,3892401489,In > Out
Sept 2020,85,59,94,37405104,136731589,174136693,20,94,2,99326485,In > Out
Sept 2020,85,6,119,65520641,2743253177,2808773818,48,119,2,2677732536,In > Out
Sept 2020,85,60,39,22801085,58716191,81517276,8,39,2,35915106,In > Out
Sept 2020,85,61,16,8137426,19170105,27307531,9,16,2,11032679,In > Out
Sept 2020,85,62,20,12298626,33255017,45553643,9,20,2,20956391,In > Out
Sept 2020,85,63,47,20150525,115730260,135880785,20,47,2,95579735,In > Out
Sept 2020,85,64,24,6231649,36885473,43117122,8,24,2,30653824,In > Out
Sept 2020,85,65,211,8766919,94784518,103551437,72,205,2,86017599,In > Out
Sept 2020,85,66,276,29566915,389085664,418652579,121,274,3,359518749,In > Out
Sept 2020,85,67,325,45091431,321660876,366752307,131,323,2,276569445,In > Out
Sept 2020,85,69,1,150570,13274,163844,1,1,1,137296,Out > In
Sept 2020,85,75,1052,101821583,2217165311,2318986894,356,1020,2,2115343728,In > Out
Sept 2020,85,77,204,194538038,703279787,897817825,83,201,2,508741749,In > Out
Sept 2020,85,78,14,316377,4738268,5054645,8,14,1,4421891,In > Out
Sept 2020,85,79,93,8353418,66967836,75321254,39,93,2,58614418,In > Out
Sept 2020,85,81,40,3047050,12248084,15295134,21,40,2,9201034,In > Out
Sept 2020,85,82,20,6045313,16247262,22292575,10,20,2,10201949,In > Out
Sept 2020,85,83,23,14306739,29192295,43499034,6,23,2,14885556,In > Out
Sept 2020,85,84,28,580011,17731807,18311818,11,28,2,17151796,In > Out
Sept 2020,85,85,29,435054,31391821,31826875,17,29,2,30956767,In > Out
Sept 2020,85,86,5,50283,973077,1023360,3,5,1,922794,In > Out
Sept 2020,85,87,7,137769,5167925,5305694,4,7,2,5030156,In > Out
Sept 2020,85,88,18,3293856,15277416,18571272,4,18,2,11983560,In > Out
Sept 2020,85,89,15,3963694,25192580,29156274,4,15,2,21228886,In > Out
Sept 2020,85,93,17,92443,3331904,3424347,7,17,1,3239461,In > Out
Sept 2020,86,198,8,40183,995902,1036085,1,8,1,955719,In > Out
Sept 2020,89,100,271,97223998,3710366925,3807590923,65,269,3,3613142927,In > Out
Sept 2020,89,104,145,9795801,1321581217,1331377018,37,145,2,1311785416,In > Out
Sept 2020,89,109,77,7396739,147880008,155276747,37,77,2,140483269,In > Out
Sept 2020,89,111,452,13268146,1351184838,1364452984,48,450,2,1337916692,In > Out
Sept 2020,89,115,536,93816901,1819976057,1913792958,97,532,2,1726159156,In > Out
Sept 2020,89,121,482,541177406,2436638555,2977815961,188,479,3,1895461149,In > Out
Sept 2020,89,127,1298,208441932,1696443331,1904885263,55,1298,2,1488001399,In > Out
Sept 2020,89,128,389,117233687,4388943401,4506177088,97,378,2,4271709714,In > Out
Sept 2020,89,130,4206,2347075931,13512773185,15859849116,192,3793,4,11165697254,In > Out
Sept 2020,89,131,213,92299463,3307599058,3399898521,45,212,2,3215299595,In > Out
Sept 2020,89,136,1371,101038552,1443790731,1544829283,270,1325,4,1342752179,In > Out
Sept 2020,89,14,1,37950330,226276,38176606,1,1,1,37724054,Out > In
Sept 2020,89,140,71,15884454,549837216,565721670,37,71,2,533952762,In > Out
Sept 2020,89,141,1630,1129314089,3214189856,4343503945,552,1584,3,2084875767,In > Out
Sept 2020,89,20,14,32992,5224240,5257232,1,14,14,5191248,In > Out
Sept 2020,89,21,13,36464,4502586,4539050,1,13,13,4466122,In > Out
Sept 2020,89,51,13,435795,28040193,28475988,5,13,2,27604398,In > Out
Sept 2020,89,52,826,202384848,2010224709,2212609557,266,811,3,1807839861,In > Out
Sept 2020,89,56,3,402156,20101043,20503199,3,3,1,19698887,In > Out
Sept 2020,89,60,1643,330579708,4578053188,4908632896,67,1571,2,4247473480,In > Out
Sept 2020,89,61,1070,1692267147,6689271736,8381538883,225,1034,4,4997004589,In > Out
Sept 2020,89,62,131,8911999,448664605,457576604,70,131,2,439752606,In > Out
Sept 2020,89,64,8,158581,3367766,3526347,4,8,2,3209185,In > Out
Sept 2020,89,65,86,3401071,74180630,77581701,46,86,2,70779559,In > Out
Sept 2020,89,67,17,515559,25315336,25830895,7,17,2,24799777,In > Out
Sept 2020,89,69,3358,528347702,6251177594,6779525296,556,3108,2,5722829892,In > Out
Sept 2020,89,70,29,3032225,568169875,571202100,11,29,2,565137650,In > Out
Sept 2020,89,72,8,276730,3659679,3936409,4,8,2,3382949,In > Out
Sept 2020,89,73,607,222895819,8302380403,8525276222,254,584,2,8079484584,In > Out
Sept 2020,89,74,377,5970065,1266191180,1272161245,37,377,2,1260221115,In > Out
Sept 2020,89,76,294,169616617,177197948,346814565,75,293,4,7581331,In > Out
Sept 2020,89,77,1240,138993988,2669332242,2808326230,404,1225,2,2530338254,In > Out
Sept 2020,89,79,14,1426106,92990121,94416227,4,14,1,91564015,In > Out
Sept 2020,89,80,1,736359,122462625,123198984,1,1,1,121726266,In > Out
Sept 2020,89,83,32,1856174,64628692,66484866,10,32,2,62772518,In > Out
Sept 2020,89,84,2115,338667683,1360737473,1699405156,260,1995,2,1022069790,In > Out
Sept 2020,89,85,62,6313839,255381692,261695531,25,61,2,249067853,In > Out
Sept 2020,89,87,318,1667846256,1996874638,3664720894,135,315,6,329028382,In > Out
Sept 2020,89,88,233,4867637,69555526,74423163,18,231,2,64687889,In > Out
Sept 2020,89,94,1056,309940045,733804209,1043744254,138,1024,2,423864164,In > Out
Sept 2020,89,96,122,4829153,566875928,571705081,45,122,2,562046775,In > Out
Sept 2020,89,98,3518,775096781,4733166713,5508263494,208,3177,3,3958069932,In > Out
Sept 2020,9,153,39,32814662,1851262358,1884077020,20,39,2,1818447696,In > Out
Sept 2020,9,154,1314,534800258,45018137338,45552937596,66,901,2,44483337080,In > Out
Sept 2020,9,155,15,694337,34310370,35004707,6,15,2,33616033,In > Out
Sept 2020,9,157,29,3210626,155931468,159142094,9,29,2,152720842,In > Out
Sept 2020,9,158,115,2602059,531902673,534504732,35,115,2,529300614,In > Out
Sept 2020,9,162,214,94197987,3633808017,3728006004,35,214,2,3539610030,In > Out
Sept 2020,9,51,443,23858492,7694107683,7717966175,54,442,2,7670249191,In > Out
Sept 2020,9,52,560,16122396,1888198002,1904320398,43,560,2,1872075606,In > Out
Sept 2020,9,53,267,51897738,3601223779,3653121517,74,263,3,3549326041,In > Out
Sept 2020,9,54,8,577227,17908179,18485406,7,8,2,17330952,In > Out
Sept 2020,9,56,314,91310461,3666362569,3757673030,43,314,2,3575052108,In > Out
Sept 2020,9,59,349,100244355,3541387807,3641632162,31,349,2,3441143452,In > Out
Sept 2020,9,62,9,2361510,139741,2501251,6,9,1,2221769,Out > In
Sept 2020,90,10,27,3189014,18322513,21511527,23,27,2,15133499,In > Out
Sept 2020,90,100,259,179107748,3317309068,3496416816,72,258,3,3138201320,In > Out
Sept 2020,90,104,39,7402659,86425512,93828171,19,39,2,79022853,In > Out
Sept 2020,90,105,659,143707679,1984259837,2127967516,181,631,2,1840552158,In > Out
Sept 2020,90,11,216,2369821,52431920,54801741,8,216,3,50062099,In > Out
Sept 2020,90,112,78,16276257,725611967,741888224,32,78,2,709335710,In > Out
Sept 2020,90,117,1,3221,120727,123948,1,1,1,117506,In > Out
Sept 2020,90,118,264,23276269,7739553479,7762829748,54,263,2,7716277210,In > Out
Sept 2020,90,12,3422,470686682,9794960594,10265647276,735,3109,4,9324273912,In > Out
Sept 2020,90,127,4,291930,112755526,113047456,4,4,1,112463596,In > Out
Sept 2020,90,14,726,41540701,1507511342,1549052043,71,716,2,1465970641,In > Out
Sept 2020,90,16,1874,178697306,1120258538,1298955844,112,1764,2,941561232,In > Out
Sept 2020,90,17,858,73261763,2596490840,2669752603,49,824,2,2523229077,In > Out
Sept 2020,90,18,12,528849,32218792,32747641,1,12,1,31689943,In > Out
Sept 2020,90,21,628,94100937,2263159030,2357259967,222,616,2,2169058093,In > Out
Sept 2020,90,214,9,611993,19266310,19878303,7,9,2,18654317,In > Out
Sept 2020,90,215,1,98323,31941,130264,1,1,1,66382,Out > In
Sept 2020,90,22,251,420895346,897637594,1318532940,13,246,2,476742248,In > Out
Sept 2020,90,220,92,6444725,28321890,34766615,19,92,2,21877165,In > Out
Sept 2020,90,23,846,28407128,5535262382,5563669510,54,837,2,5506855254,In > Out
Sept 2020,90,230,50,3757813,154220423,157978236,9,50,2,150462610,In > Out
Sept 2020,90,235,290,9670703595,542968823,10213672418,173,65,131,9127734772,Out > In
Sept 2020,90,24,117,179003425,9974951739,10153955164,62,115,2,9795948314,In > Out
Sept 2020,90,253,9603,1397937328,132909598389,134307535717,475,8329,5,131511661061,In > Out
Sept 2020,90,26,2230,279363447,1646467320,1925830767,139,2097,2,1367103873,In > Out
Sept 2020,90,29,12721,1736007505,13962919763,15698927268,468,9366,5,12226912258,In > Out
Sept 2020,90,3,243,440803004,6470426338,6911229342,98,241,2,6029623334,In > Out
Sept 2020,90,31,189,25699105,159940859,185639964,59,189,2,134241754,In > Out
Sept 2020,90,33,1162,232041436,8577309991,8809351427,247,1162,3,8345268555,In > Out
Sept 2020,90,35,256,32336339,501395748,533732087,25,254,2,469059409,In > Out
Sept 2020,90,36,54,7658113,258202105,265860218,9,54,2,250543992,In > Out
Sept 2020,90,38,1956,255681542,3444358616,3700040158,323,1836,4,3188677074,In > Out
Sept 2020,90,39,7154,2031699511,32425041778,34456741289,126,5810,2,30393342267,In > Out
Sept 2020,90,4,71,7042494,239066729,246109223,29,66,2,232024235,In > Out
Sept 2020,90,40,809,104163707,4555778008,4659941715,107,782,2,4451614301,In > Out
Sept 2020,90,42,13,5216929,354733838,359950767,11,13,1,349516909,In > Out
Sept 2020,90,43,1116,314854862,1989732954,2304587816,134,1084,3,1674878092,In > Out
Sept 2020,90,44,125,31439505,1322888605,1354328110,36,125,2,1291449100,In > Out
Sept 2020,90,45,341,31829261,1097649700,1129478961,81,340,2,1065820439,In > Out
Sept 2020,90,46,15,641879,25912806,26554685,10,15,2,25270927,In > Out
Sept 2020,90,47,290,130038271,1371198813,1501237084,65,285,3,1241160542,In > Out
Sept 2020,90,48,6005,653632434,7857620073,8511252507,1037,4996,4,7203987639,In > Out
Sept 2020,90,49,726,121967086,1051192820,1173159906,132,722,3,929225734,In > Out
Sept 2020,90,5,2026,3541395113,10942361043,14483756156,352,1978,4,7400965930,In > Out
Sept 2020,90,50,2652,257758403,8513577138,8771335541,439,2356,3,8255818735,In > Out
Sept 2020,90,51,113,18607449,827708064,846315513,43,113,2,809100615,In > Out
Sept 2020,90,52,583,73360804,1683186848,1756547652,105,559,2,1609826044,In > Out
Sept 2020,90,6,15,9063267,311543771,320607038,4,15,1,302480504,In > Out
Sept 2020,90,63,891,79616392,2856500360,2936116752,31,891,2,2776883968,In > Out
Sept 2020,90,7,178,27514990,580612409,608127399,62,178,2,553097419,In > Out
Sept 2020,90,8,271,1927290375,2221558609,4148848984,122,268,4,294268234,In > Out
Sept 2020,90,80,321,52253293,1505093522,1557346815,113,319,2,1452840229,In > Out
Sept 2020,90,82,456,16248191,4543918049,4560166240,58,451,2,4527669858,In > Out
Sept 2020,91,10,4,947977,102709831,103657808,2,4,1,101761854,In > Out
Sept 2020,91,11,497,74352493,4929904750,5004257243,38,496,2,4855552257,In > Out
Sept 2020,91,113,290,6455540,449455681,455911221,21,289,2,443000141,In > Out
Sept 2020,91,12,76,5648298,182065460,187713758,32,75,2,176417162,In > Out
Sept 2020,91,13,184,4237573,485417368,489654941,7,182,1,481179795,In > Out
Sept 2020,91,14,1426,168789576,870282289,1039071865,119,1371,3,701492713,In > Out
Sept 2020,91,15,2593,632716631,20609908886,21242625517,443,2448,3,19977192255,In > Out
Sept 2020,91,16,2922,251338581,12739175404,12990513985,655,2640,3,12487836823,In > Out
Sept 2020,91,17,180,9917989,511771708,521689697,7,180,1,501853719,In > Out
Sept 2020,91,19,182,4051027,501976734,506027761,8,180,1,497925707,In > Out
Sept 2020,91,20,297,79472077,1553384504,1632856581,47,295,2,1473912427,In > Out
Sept 2020,91,200,11,1348132,331120918,332469050,3,11,1,329772786,In > Out
Sept 2020,91,21,857,118192716,573020612,691213328,31,846,3,454827896,In > Out
Sept 2020,91,214,58,5399132,162991921,168391053,11,58,2,157592789,In > Out
Sept 2020,91,22,92,460444160,1358615847,1819060007,51,92,3,898171687,In > Out
Sept 2020,91,225,73,37718055,2162560057,2200278112,9,73,2,2124842002,In > Out
Sept 2020,91,226,3176,716763533,7815000826,8531764359,679,3111,8,7098237293,In > Out
Sept 2020,91,227,4,546446,105631903,106178349,2,4,1,105085457,In > Out
Sept 2020,91,228,404,14041248,236914736,250955984,69,400,3,222873488,In > Out
Sept 2020,91,239,231,2628707,161016191,163644898,17,230,2,158387484,In > Out
Sept 2020,91,27,10,31550759,8974626417,9006177176,5,10,2,8943075658,In > Out
Sept 2020,91,3,16,278648,47879340,48157988,2,16,1,47600692,In > Out
Sept 2020,91,33,554,54387351,2409255783,2463643134,134,550,4,2354868432,In > Out
Sept 2020,91,37,1210,78572628,2192225066,2270797694,264,1190,2,2113652438,In > Out
Sept 2020,91,4,3664,198496450,4229586984,4428083434,492,3366,6,4031090534,In > Out
Sept 2020,91,40,47,8622852,1416109427,1424732279,10,47,1,1407486575,In > Out
Sept 2020,91,43,10,476314,33015588,33491902,3,10,2,32539274,In > Out
Sept 2020,91,44,565,34068671,2081465041,2115533712,56,565,2,2047396370,In > Out
Sept 2020,91,48,257,11807459,583429962,595237421,19,257,2,571622503,In > Out
Sept 2020,91,5,177,1018022768,819385257,1837408025,111,177,3,198637511,Out > In
Sept 2020,91,57,166,15136800,427598209,442735009,19,165,2,412461409,In > Out
Sept 2020,91,58,1513,3534038002,13976646352,17510684354,402,1445,14,10442608350,In > Out
Sept 2020,91,64,233,46438590,1662417898,1708856488,109,230,2,1615979308,In > Out
Sept 2020,91,69,369,63285847,4249014937,4312300784,39,366,2,4185729090,In > Out
Sept 2020,91,77,370,66781473,1162203516,1228984989,183,370,3,1095422043,In > Out
Sept 2020,91,8,146,20538856,668419768,688958624,37,145,2,647880912,In > Out
Sept 2020,91,87,324,33544379,1815681477,1849225856,40,323,2,1782137098,In > Out
Sept 2020,91,90,263,27607868,2933455383,2961063251,72,263,2,2905847515,In > Out
Sept 2020,91,93,506,24503967,640464436,664968403,39,501,2,615960469,In > Out
Sept 2020,91,94,4,270822,106409693,106680515,4,4,1,106138871,In > Out
Sept 2020,92,213,18,2835738,55027219,57862957,7,18,2,52191481,In > Out
Sept 2020,92,225,4,1148055,86515,1234570,2,4,1,1061540,Out > In
Sept 2020,92,227,4,16921135,193124,17114259,1,4,4,16728011,Out > In
Sept 2020,92,228,88,7106747,185319387,192426134,34,88,2,178212640,In > Out
Sept 2020,92,230,2,1555231,42146,1597377,2,2,1,1513085,Out > In
Sept 2020,92,250,114,8499911,376504901,385004812,21,114,2,368004990,In > Out
Sept 2020,92,37,686,300852194,927678700,1228530894,203,674,4,626826506,In > Out
Sept 2020,92,5,2749,260194010,4684186001,4944380011,452,2637,2,4423991991,In > Out
Sept 2020,92,51,713,31968288,936500055,968468343,61,712,3,904531767,In > Out
Sept 2020,92,56,21,820800,19283628,20104428,9,21,2,18462828,In > Out
Sept 2020,92,7,6,595761,2068602,2664363,4,6,2,1472841,In > Out
Sept 2020,94,21,175,54654792,79705839,134360631,152,175,2,25051047,In > Out
Sept 2020,94,22,909,651038518,33755465,684793983,26,856,845,617283053,Out > In
Sept 2020,94,29,189394,84564212201,426516634338,511080846539,5754,25134,120,341952422137,In > Out
Sept 2020,94,30,132,112777181,103592557,216369738,3,129,1,9184624,Out > In
Sept 2020,94,51,1074,1246461900,26247232,1272709132,1,1060,1045,1220214668,Out > In
Sept 2020,96,125,4,1072674,61957,1134631,4,1,4,1010717,Out > In
Sept 2020,96,60,25,720253875,271857390,992111265,18,1,25,448396485,Out > In
Sept 2020,96,78,10,11279355,2487671,13767026,7,2,10,8791684,Out > In
Sept 2020,98,10,20,7158966,96549247,103708213,9,20,2,89390281,In > Out
Sept 2020,98,101,665,71886251,3500007462,3571893713,222,655,3,3428121211,In > Out
Sept 2020,98,102,252,44638650,1399360584,1443999234,125,249,5,1354721934,In > Out
Sept 2020,98,103,19,3424594,133832894,137257488,14,19,2,130408300,In > Out
Sept 2020,98,104,1855,1343538803,22751240744,24094779547,517,1800,8,21407701941,In > Out
Sept 2020,98,107,412,671470304,3159939800,3831410104,103,410,7,2488469496,In > Out
Sept 2020,98,108,874,217358030,3715328558,3932686588,259,864,7,3497970528,In > Out
Sept 2020,98,11,4173,3575771718,15672921595,19248693313,640,3804,102,12097149877,In > Out
Sept 2020,98,110,72,6092622,181478050,187570672,40,72,1,175385428,In > Out
Sept 2020,98,111,934,140322144,5418387289,5558709433,211,906,6,5278065145,In > Out
Sept 2020,98,113,83,51372482,1098427927,1149800409,43,83,2,1047055445,In > Out
Sept 2020,98,114,172,24072175,1540438062,1564510237,76,171,4,1516365887,In > Out
Sept 2020,98,115,378,1211772708,2065484629,3277257337,55,374,3,853711921,In > Out
Sept 2020,98,12,1146,2987439201,12461450422,15448889623,239,1136,7,9474011221,In > Out
Sept 2020,98,120,84,144362743,669132498,813495241,51,84,4,524769755,In > Out
Sept 2020,98,122,2503,337456642,14008433190,14345889832,500,2283,3,13670976548,In > Out
Sept 2020,98,123,259,65094715,1712588840,1777683555,150,258,4,1647494125,In > Out
Sept 2020,98,124,203,23483046,1103747474,1127230520,68,203,3,1080264428,In > Out
Sept 2020,98,125,429,35214452,1897430255,1932644707,127,421,4,1862215803,In > Out
Sept 2020,98,126,281,119767791,894533604,1014301395,106,281,7,774765813,In > Out
Sept 2020,98,128,325,82175429,3560424938,3642600367,106,323,7,3478249509,In > Out
Sept 2020,98,13,423,62584743,2045798255,2108382998,135,420,5,1983213512,In > Out
Sept 2020,98,130,1177,2854464207,10300897135,13155361342,287,1151,11,7446432928,In > Out
Sept 2020,98,132,34,4209747,198760286,202970033,21,34,3,194550539,In > Out
Sept 2020,98,133,235,18092340,1279369882,1297462222,71,235,2,1261277542,In > Out
Sept 2020,98,134,406,36963499,4802386676,4839350175,212,404,3,4765423177,In > Out
Sept 2020,98,135,850,1538990698,3780100440,5319091138,276,836,10,2241109742,In > Out
Sept 2020,98,136,812,676377085,12320645804,12997022889,202,798,4,11644268719,In > Out
Sept 2020,98,137,5364,2866962271,15822476178,18689438449,553,3343,29,12955513907,In > Out
Sept 2020,98,138,357,44750074,1490453246,1535203320,72,355,5,1445703172,In > Out
Sept 2020,98,139,355,1578756412,2861017997,4439774409,138,349,7,1282261585,In > Out
Sept 2020,98,14,527,55536216,1850716087,1906252303,200,522,7,1795179871,In > Out
Sept 2020,98,140,555,248427064,2056675852,2305102916,183,539,3,1808248788,In > Out
Sept 2020,98,141,309,193227787,2119992668,2313220455,142,309,9,1926764881,In > Out
Sept 2020,98,142,74,9140815,354010944,363151759,36,74,4,344870129,In > Out
Sept 2020,98,143,390,33948827,663408952,697357779,73,386,3,629460125,In > Out
Sept 2020,98,145,35,3385606,18078745,21464351,26,33,3,14693139,In > Out
Sept 2020,98,146,408,43521594,541362276,584883870,171,402,3,497840682,In > Out
Sept 2020,98,147,87,11861866,296896667,308758533,32,86,1,285034801,In > Out
Sept 2020,98,148,438,157957286,8073331677,8231288963,186,434,3,7915374391,In > Out
Sept 2020,98,149,179,11833366,233437046,245270412,80,178,4,221603680,In > Out
Sept 2020,98,15,154,19820399,466710058,486530457,65,154,3,446889659,In > Out
Sept 2020,98,150,88,7919872,154138189,162058061,45,88,1,146218317,In > Out
Sept 2020,98,152,882,189399388,2126133155,2315532543,280,861,6,1936733767,In > Out
Sept 2020,98,153,908,121116970,4383404642,4504521612,219,900,4,4262287672,In > Out
Sept 2020,98,154,96,24011411,482081213,506092624,47,96,6,458069802,In > Out
Sept 2020,98,156,129,14395172,439743913,454139085,50,129,17,425348741,In > Out
Sept 2020,98,157,551,107869611,3385326276,3493195887,161,547,8,3277456665,In > Out
Sept 2020,98,16,43,101511791,9867557713,9969069504,26,43,3,9766045922,In > Out
Sept 2020,98,162,1333,742999249,7167927686,7910926935,259,1303,11,6424928437,In > Out
Sept 2020,98,163,287,598274816,2985555172,3583829988,141,286,5,2387280356,In > Out
Sept 2020,98,164,348,51066295,1095597700,1146663995,151,347,3,1044531405,In > Out
Sept 2020,98,168,1109,221727364,3147010686,3368738050,395,1080,9,2925283322,In > Out
Sept 2020,98,169,614,206759222,5254677557,5461436779,110,609,5,5047918335,In > Out
Sept 2020,98,17,379,49340482,2106439654,2155780136,86,377,3,2057099172,In > Out
Sept 2020,98,170,300,103749545,1200020954,1303770499,87,299,5,1096271409,In > Out
Sept 2020,98,171,415,49287731,1175728744,1225016475,156,415,6,1126441013,In > Out
Sept 2020,98,172,168,30992733,729352410,760345143,65,168,4,698359677,In > Out
Sept 2020,98,173,523,1054662925,1290161530,2344824455,138,523,5,235498605,In > Out
Sept 2020,98,177,673,232147237,12881099872,13113247109,210,673,5,12648952635,In > Out
Sept 2020,98,179,885,130811001,3488637025,3619448026,172,870,5,3357826024,In > Out
Sept 2020,98,18,1,43275,101254,144529,1,1,1,57979,In > Out
Sept 2020,98,180,951,1263503978,3418328818,4681832796,213,913,11,2154824840,In > Out
Sept 2020,98,181,244,199356005,10697228466,10896584471,77,241,4,10497872461,In > Out
Sept 2020,98,182,1143,404225821,14721706281,15125932102,284,1104,8,14317480460,In > Out
Sept 2020,98,184,1887,780022382,15298618657,16078641039,467,1791,5,14518596275,In > Out
Sept 2020,98,185,426,115658824,1143553063,1259211887,136,426,4,1027894239,In > Out
Sept 2020,98,186,735,744034678,8175770805,8919805483,341,729,6,7431736127,In > Out
Sept 2020,98,188,91,7841649,196096990,203938639,60,91,2,188255341,In > Out
Sept 2020,98,194,1785,175801842,10011895056,10187696898,286,1727,6,9836093214,In > Out
Sept 2020,98,195,1616,87949577,5526160167,5614109744,145,1613,4,5438210590,In > Out
Sept 2020,98,196,492,114588237,2339078698,2453666935,179,486,6,2224490461,In > Out
Sept 2020,98,198,893,258408304,4403233680,4661641984,235,865,11,4144825376,In > Out
Sept 2020,98,199,214,26795115,280784970,307580085,56,214,3,253989855,In > Out
Sept 2020,98,20,409,586799503,4529210396,5116009899,138,404,5,3942410893,In > Out
Sept 2020,98,200,425,2110813323,7560295470,9671108793,107,421,4,5449482147,In > Out
Sept 2020,98,203,154,41954884,7081423003,7123377887,48,151,2,7039468119,In > Out
Sept 2020,98,204,296,207938658,37668003138,37875941796,122,296,4,37460064480,In > Out
Sept 2020,98,206,283,523201493,1615302779,2138504272,124,279,7,1092101286,In > Out
Sept 2020,98,208,1094,1709211887,22960718022,24669929909,402,1045,9,21251506135,In > Out
Sept 2020,98,210,663,209072230,5603381442,5812453672,159,659,6,5394309212,In > Out
Sept 2020,98,211,1303,785778580,7853651476,8639430056,302,1260,8,7067872896,In > Out
Sept 2020,98,212,6160,2182571819,34789947433,36972519252,791,5355,3,32607375614,In > Out
Sept 2020,98,216,1049,379408803,5201733608,5581142411,191,1025,7,4822324805,In > Out
Sept 2020,98,219,1411,12474412736,17332743670,29807156406,299,1379,11,4858330934,In > Out
Sept 2020,98,22,459,138216100,4905061466,5043277566,204,458,4,4766845366,In > Out
Sept 2020,98,220,81,45790996,61616664,107407660,42,81,2,15825668,In > Out
Sept 2020,98,221,1171,1946890201,11506955361,13453845562,354,1113,23,9560065160,In > Out
Sept 2020,98,222,445,35664037,514431888,550095925,149,437,4,478767851,In > Out
Sept 2020,98,223,1325,599811185,10540763684,11140574869,287,1258,5,9940952499,In > Out
Sept 2020,98,23,276,42068922,1429381132,1471450054,75,275,4,1387312210,In > Out
Sept 2020,98,26,1138,446552189,6633781775,7080333964,305,1136,7,6187229586,In > Out
Sept 2020,98,27,2999,2355888149,33318999561,35674887710,692,2803,6,30963111412,In > Out
Sept 2020,98,28,29,2679174,54349740,57028914,18,29,1,51670566,In > Out
Sept 2020,98,29,3265,3460570759,50959918966,54420489725,472,3007,3,47499348207,In > Out
Sept 2020,98,30,313,276933870,547295525,824229395,74,310,3,270361655,In > Out
Sept 2020,98,31,207,56048287,2894658055,2950706342,52,207,2,2838609768,In > Out
Sept 2020,98,34,208,41276373,2497040033,2538316406,81,207,2,2455763660,In > Out
Sept 2020,98,35,1358,1452396299,3030834950,4483231249,178,1351,4,1578438651,In > Out
Sept 2020,98,37,1060,238572682,7355572714,7594145396,363,1044,5,7117000032,In > Out
Sept 2020,98,4,483,863978343,7459861361,8323839704,181,475,10,6595883018,In > Out
Sept 2020,98,40,149,886883172,1952814670,2839697842,92,148,8,1065931498,In > Out
Sept 2020,98,43,1046,444771641,6936406970,7381178611,309,1043,5,6491635329,In > Out
Sept 2020,98,44,532,498112685,3572420664,4070533349,182,529,7,3074307979,In > Out
Sept 2020,98,46,812,298801445,9793540464,10092341909,349,804,20,9494739019,In > Out
Sept 2020,98,49,233,77503057,4163615223,4241118280,91,232,2,4086112166,In > Out
Sept 2020,98,51,206,29922189,715910655,745832844,79,206,3,685988466,In > Out
Sept 2020,98,54,214,31765591,800004301,831769892,114,213,5,768238710,In > Out
Sept 2020,98,56,750,201624618,11844911525,12046536143,281,749,6,11643286907,In > Out
Sept 2020,98,57,3259,1434013710,60431991885,61866005595,746,3076,24,58997978175,In > Out
Sept 2020,98,59,531,173755169,1764453160,1938208329,136,529,8,1590697991,In > Out
Sept 2020,98,60,502,46523341,1874880020,1921403361,182,499,4,1828356679,In > Out
Sept 2020,98,61,223,735051684,901989255,1637040939,105,220,7,166937571,In > Out
Sept 2020,98,62,748,143171580,2994997777,3138169357,194,732,3,2851826197,In > Out
Sept 2020,98,64,1031,956750372,3357333112,4314083484,308,1001,6,2400582740,In > Out
Sept 2020,98,65,225,28715823,1209174308,1237890131,129,223,3,1180458485,In > Out
Sept 2020,98,66,449,91012619,6182995436,6274008055,224,448,4,6091982817,In > Out
Sept 2020,98,68,501,86720855,5039878688,5126599543,147,496,4,4953157833,In > Out
Sept 2020,98,70,946,1123850922,12757271799,13881122721,339,935,16,11633420877,In > Out
Sept 2020,98,72,109,61376802,4146641263,4208018065,71,109,1,4085264461,In > Out
Sept 2020,98,73,25,5129472,4840897,9970369,14,25,3,288575,Out > In
Sept 2020,98,75,386,71422104,1828636601,1900058705,110,384,4,1757214497,In > Out
Sept 2020,98,76,305,4377669241,954656635,5332325876,153,305,4,3423012606,Out > In
Sept 2020,98,77,371,305531853,2634810303,2940342156,160,370,4,2329278450,In > Out
Sept 2020,98,78,600,70709700,1712895884,1783605584,134,598,5,1642186184,In > Out
Sept 2020,98,79,249,55293741,2402244203,2457537944,101,246,2,2346950462,In > Out
Sept 2020,98,8,53,12310230,1415930189,1428240419,36,53,2,1403619959,In > Out
Sept 2020,98,80,22,6793802,479055744,485849546,14,22,3,472261942,In > Out
Sept 2020,98,81,243,24226081,644627591,668853672,114,242,3,620401510,In > Out
Sept 2020,98,82,191,79389278,5522142980,5601532258,66,190,4,5442753702,In > Out
Sept 2020,98,83,265,401734539,2768974632,3170709171,134,265,4,2367240093,In > Out
Sept 2020,98,86,1460,138716647,4816604139,4955320786,187,1435,6,4677887492,In > Out
Sept 2020,98,87,446,154062948,7337273637,7491336585,197,440,4,7183210689,In > Out
Sept 2020,98,90,1277,401879363,4985339198,5387218561,338,1243,7,4583459835,In > Out
Sept 2020,98,93,876,220900468,2821774065,3042674533,193,845,4,2600873597,In > Out
Sept 2020,98,94,301,36203321,1146548610,1182751931,133,299,4,1110345289,In > Out
Sept 2020,98,96,87,5857905,245512379,251370284,50,87,4,239654474,In > Out
Sept 2020,98,97,44,1185774,22529135,23714909,15,44,2,21343361,In > Out
Sept 2020,98,98,178,507650074,2154172442,2661822516,99,178,4,1646522368,In > Out
Sept 2020,98,99,2167,429479750,24342691665,24772171415,275,2089,5,23913211915,In > Out
Sept 2020,99,101,40,2926831,14744251,17671082,29,40,3,11817420,In > Out
Sept 2020,99,102,9,1390772,39043413,40434185,8,9,2,37652641,In > Out
Sept 2020,99,103,63,16282951,75517744,91800695,21,63,3,59234793,In > Out
Sept 2020,99,121,379,176641906,9567142019,9743783925,111,378,4,9390500113,In > Out
Sept 2020,99,130,185,386742431,31634217361,32020959792,56,183,3,31247474930,In > Out
Sept 2020,99,131,8,5795712,177794425,183590137,6,8,2,171998713,In > Out
Sept 2020,99,153,2056,335762551,4158582249,4494344800,83,1928,3,3822819698,In > Out
Sept 2020,99,162,13,891686,75909655,76801341,4,13,1,75017969,In > Out
Sept 2020,99,168,181,58264434,375221740,433486174,45,180,5,316957306,In > Out
Sept 2020,99,178,2027,465743938,7340501793,7806245731,220,1908,4,6874757855,In > Out
Sept 2020,99,185,135,542505522,180602549,723108071,50,135,4,361902973,Out > In
Sept 2020,99,50,1122,4531737209,603462611,5135199820,59,1102,5,3928274598,Out > In
Sept 2020,99,75,291,42192523,8535742657,8577935180,53,291,3,8493550134,In > Out
Sept 2021,1,110,3,3717,1832481,1836198,1,1,1,1828764,In > Out
Sept 2021,10,4,1,6932,284754,291686,1,1,1,277822,In > Out
Sept 2021,101,102,1968,506749882,4385975195,4892725077,111,1850,2,3879225313,In > Out
Sept 2021,101,104,41,5809523,386751813,392561336,23,41,3,380942290,In > Out
Sept 2021,101,120,310,19268814,2251215785,2270484599,64,310,3,2231946971,In > Out
Sept 2021,101,139,3,34004,1197029,1231033,2,3,1,1163025,In > Out
Sept 2021,101,160,1141,259709257,1887334039,2147043296,275,1018,89,1627624782,In > Out
Sept 2021,101,176,185,31276191,1270133360,1301409551,88,184,2,1238857169,In > Out
Sept 2021,101,177,816,1617879097,1365148238,2983027335,212,802,5,252730859,Out > In
Sept 2021,101,195,55,3390635,266998811,270389446,20,55,2,263608176,In > Out
Sept 2021,101,201,3,310005,35628766,35938771,3,3,1,35318761,In > Out
Sept 2021,101,207,1821,197558150,2075990985,2273549135,306,1728,3,1878432835,In > Out
Sept 2021,101,212,991,121690377,1075445515,1197135892,265,963,2,953755138,In > Out
Sept 2021,101,223,346,56850636,1200172603,1257023239,57,343,2,1143321967,In > Out
Sept 2021,101,229,411,131829998,1465517071,1597347069,157,409,3,1333687073,In > Out
Sept 2021,101,28,573,70203363,1767803934,1838007297,53,565,3,1697600571,In > Out
Sept 2021,101,33,105,12771274,162214361,174985635,53,104,2,149443087,In > Out
Sept 2021,101,36,1138,167327352,1851562801,2018890153,245,1092,3,1684235449,In > Out
Sept 2021,101,89,1969,406012866,9095571301,9501584167,281,1855,3,8689558435,In > Out
Sept 2021,101,91,772,84453700,2981575037,3066028737,210,755,3,2897121337,In > Out
Sept 2021,102,101,12,986470,221328461,222314931,6,12,2,220341991,In > Out
Sept 2021,102,55,5,211084,23822275,24033359,4,5,2,23611191,In > Out
Sept 2021,102,65,1,3836,191385,195221,1,1,1,187549,In > Out
Sept 2021,103,237,6995,2591630667,22684364434,25275995101,830,5628,6,20092733767,In > Out
Sept 2021,103,247,132,31370558,1568865864,1600236422,62,132,3,1537495306,In > Out
Sept 2021,104,109,2647,1140491911,1946136774,3086628685,330,2456,7,805644863,In > Out
Sept 2021,104,135,1254,4090769275,1112050262,5202819537,130,1205,7,2978719013,Out > In
Sept 2021,104,138,429,109194529,929722520,1038917049,60,419,4,820527991,In > Out
Sept 2021,104,141,550,58170306,954333604,1012503910,96,545,3,896163298,In > Out
Sept 2021,104,142,656,84920377,998775549,1083695926,104,642,3,913855172,In > Out
Sept 2021,104,150,1516,144265439,6071851641,6216117080,430,1486,3,5927586202,In > Out
Sept 2021,104,158,1370,280303728,2285868684,2566172412,95,1331,2,2005564956,In > Out
Sept 2021,104,174,96,12302716,264255233,276557949,45,96,2,251952517,In > Out
Sept 2021,104,179,1867,302120711,4474042838,4776163549,212,1823,4,4171922127,In > Out
Sept 2021,104,187,21,23899072,65504165,89403237,10,21,2,41605093,In > Out
Sept 2021,104,248,4200,2302683891,11706183583,14008867474,696,3708,7,9403499692,In > Out
Sept 2021,104,57,842,80097762,399808502,479906264,145,816,2,319710740,In > Out
Sept 2021,104,61,2085,197699814,3167208760,3364908574,67,1947,2,2969508946,In > Out
Sept 2021,104,75,15,3895612,5822459,9718071,10,15,2,1926847,In > Out
Sept 2021,104,76,580,49777841,418015340,467793181,165,570,2,368237499,In > Out
Sept 2021,104,85,1066,194968026,2324137359,2519105385,142,1035,2,2129169333,In > Out
Sept 2021,104,96,1480,449113322,6948400313,7397513635,341,1412,7,6499286991,In > Out
Sept 2021,110,132,398,178824184,3317734545,3496558729,30,390,2,3138910361,In > Out
Sept 2021,110,75,790,57452016,602310034,659762050,284,766,3,544858018,In > Out
Sept 2021,111,5,172,38819978,43582984,82402962,3,4,2,4763006,In > Out
Sept 2021,112,10,466,145911319,1095201749,1241113068,147,462,6,949290430,In > Out
Sept 2021,112,100,1247,86079584,4293055248,4379134832,228,1206,7,4206975664,In > Out
Sept 2021,112,104,1483,532054080,17586497672,18118551752,455,1422,14,17054443592,In > Out
Sept 2021,112,105,725,10802385683,19797102201,30599487884,258,707,9,8994716518,In > Out
Sept 2021,112,107,2097,849894552,4692907771,5542802323,414,1987,15,3843013219,In > Out
Sept 2021,112,108,649,910090174,3076149304,3986239478,268,636,5,2166059130,In > Out
Sept 2021,112,109,25060,754542842,28252142732,29006685574,295,12029,6,27497599890,In > Out
Sept 2021,112,111,168,13734265,443319714,457053979,71,168,3,429585449,In > Out
Sept 2021,112,114,411,648375512,2917616843,3565992355,188,404,9,2269241331,In > Out
Sept 2021,112,115,1141,1633347663,9650596057,11283943720,405,1104,6,8017248394,In > Out
Sept 2021,112,117,612,103420335,7355439407,7458859742,209,610,5,7252019072,In > Out
Sept 2021,112,119,122,8193857,276287494,284481351,64,122,2,268093637,In > Out
Sept 2021,112,123,481,369875518,5835385888,6205261406,161,470,5,5465510370,In > Out
Sept 2021,112,125,1858,263742614,5644392227,5908134841,303,1802,8,5380649613,In > Out
Sept 2021,112,126,1028,6782719695,4329037647,11111757342,431,993,6,2453682048,Out > In
Sept 2021,112,127,1787,2041038254,36398477021,38439515275,258,1713,9,34357438767,In > Out
Sept 2021,112,128,917,152601643,4655280376,4807882019,369,891,5,4502678733,In > Out
Sept 2021,112,129,468,44373717,1597078317,1641452034,164,461,5,1552704600,In > Out
Sept 2021,112,130,369,113542497,4615736833,4729279330,167,363,5,4502194336,In > Out
Sept 2021,112,131,505,243698725,1783275179,2026973904,182,497,5,1539576454,In > Out
Sept 2021,112,132,1429,307019370,17510152957,17817172327,280,1378,3,17203133587,In > Out
Sept 2021,112,133,851,141203412,3679710171,3820913583,313,831,7,3538506759,In > Out
Sept 2021,112,134,316,143323321,14922463428,15065786749,86,316,6,14779140107,In > Out
Sept 2021,112,135,419,77529984,1937990593,2015520577,167,410,5,1860460609,In > Out
Sept 2021,112,136,908,132178932,3082552563,3214731495,222,890,5,2950373631,In > Out
Sept 2021,112,137,1266,836773154,27925516097,28762289251,292,1213,21,27088742943,In > Out
Sept 2021,112,138,164,8732750,294155634,302888384,69,164,1,285422884,In > Out
Sept 2021,112,139,573,71395069,2369740375,2441135444,215,567,4,2298345306,In > Out
Sept 2021,112,14,1044,3285897219,8934749381,12220646600,343,1040,6,5648852162,In > Out
Sept 2021,112,141,243,1091863643,2643916794,3735780437,105,240,5,1552053151,In > Out
Sept 2021,112,142,644,49717202,1558313597,1608030799,187,639,5,1508596395,In > Out
Sept 2021,112,143,3952,2601310458,19012030991,21613341449,577,3544,37,16410720533,In > Out
Sept 2021,112,144,799,349989472,3592377554,3942367026,207,783,7,3242388082,In > Out
Sept 2021,112,145,2397,188310308,4655061209,4843371517,304,2267,7,4466750901,In > Out
Sept 2021,112,146,986,122886771,3221986328,3344873099,340,967,5,3099099557,In > Out
Sept 2021,112,147,893,388892806,3767151892,4156044698,328,873,7,3378259086,In > Out
Sept 2021,112,148,1897,714301951,6855234535,7569536486,232,1812,8,6140932584,In > Out
Sept 2021,112,149,319,31279141,1180529758,1211808899,144,319,4,1149250617,In > Out
Sept 2021,112,15,984,480105276,9363456420,9843561696,302,958,18,8883351144,In > Out
Sept 2021,112,150,1590,2255514411,5239441185,7494955596,228,1536,10,2983926774,In > Out
Sept 2021,112,151,851,908267767,7375261088,8283528855,327,843,8,6466993321,In > Out
Sept 2021,112,152,828,169003707,2453852994,2622856701,244,810,5,2284849287,In > Out
Sept 2021,112,153,603,81618012,3866138935,3947756947,202,589,5,3784520923,In > Out
Sept 2021,112,154,806,451524447,13828450647,14279975094,229,789,7,13376926200,In > Out
Sept 2021,112,155,336,57648274,591000324,648648598,109,333,3,533352050,In > Out
Sept 2021,112,156,1142,313569825,5895753644,6209323469,337,1118,10,5582183819,In > Out
Sept 2021,112,158,1510,872109843,26180620286,27052730129,392,1445,21,25308510443,In > Out
Sept 2021,112,159,770,189972557,1624774258,1814746815,302,760,12,1434801701,In > Out
Sept 2021,112,160,717,104856866,3501268447,3606125313,295,711,5,3396411581,In > Out
Sept 2021,112,161,713,1067629777,7807793977,8875423754,240,704,13,6740164200,In > Out
Sept 2021,112,162,888,249554457,1397370039,1646924496,256,873,5,1147815582,In > Out
Sept 2021,112,164,1107,408606558,4474821002,4883427560,340,1076,6,4066214444,In > Out
Sept 2021,112,165,959,1743051393,28236625017,29979676410,241,940,10,26493573624,In > Out
Sept 2021,112,168,666,477394975,11328698812,11806093787,265,659,4,10851303837,In > Out
Sept 2021,112,169,210,17693382,319137105,336830487,109,210,5,301443723,In > Out
Sept 2021,112,170,726,338518289,1028943115,1367461404,227,699,5,690424826,In > Out
Sept 2021,112,173,703,206906858,1211329917,1418236775,273,681,5,1004423059,In > Out
Sept 2021,112,174,1264,252834298,11004922050,11257756348,390,1214,6,10752087752,In > Out
Sept 2021,112,175,1123,387299567,33554451896,33941751463,300,1064,2,33167152329,In > Out
Sept 2021,112,176,383,2184035421,4967593088,7151628509,139,379,5,2783557667,In > Out
Sept 2021,112,177,1417,1099975432,18825483461,19925458893,425,1349,6,17725508029,In > Out
Sept 2021,112,178,1035,512132133,6361924061,6874056194,348,1000,7,5849791928,In > Out
Sept 2021,112,180,681,376097204,5782292391,6158389595,224,673,4,5406195187,In > Out
Sept 2021,112,181,558,64404607,1623889634,1688294241,114,548,3,1559485027,In > Out
Sept 2021,112,182,819,180132324,2126066640,2306198964,273,806,6,1945934316,In > Out
Sept 2021,112,183,481,197951756,1703181506,1901133262,194,475,10,1505229750,In > Out
Sept 2021,112,184,649,253277395,2000357306,2253634701,190,639,6,1747079911,In > Out
Sept 2021,112,185,957,132498086,3759236590,3891734676,235,929,20,3626738504,In > Out
Sept 2021,112,186,236,38801632,1266677050,1305478682,118,235,4,1227875418,In > Out
Sept 2021,112,187,423,61350867,993799437,1055150304,184,421,6,932448570,In > Out
Sept 2021,112,188,308,87398867,1699333298,1786732165,99,306,3,1611934431,In > Out
Sept 2021,112,189,1039,225430434,9716038344,9941468778,328,1036,2,9490607910,In > Out
Sept 2021,112,190,527,3127816454,6994035069,10121851523,178,520,5,3866218615,In > Out
Sept 2021,112,191,676,63513799,2209357398,2272871197,260,650,6,2145843599,In > Out
Sept 2021,112,193,1472,691270166,11623178902,12314449068,405,1407,18,10931908736,In > Out
Sept 2021,112,199,752,163493249,4420580977,4584074226,211,740,2,4257087728,In > Out
Sept 2021,112,201,626,2164666647,4173573841,6338240488,157,613,7,2008907194,In > Out
Sept 2021,112,202,683,73477523,2068570587,2142048110,219,677,6,1995093064,In > Out
Sept 2021,112,204,183,38897026,2460787586,2499684612,85,182,2,2421890560,In > Out
Sept 2021,112,205,710,327619973,7968528796,8296148769,206,698,5,7640908823,In > Out
Sept 2021,112,206,983,238777296,2615621838,2854399134,266,961,18,2376844542,In > Out
Sept 2021,112,207,407,41521823,495777579,537299402,177,401,19,454255756,In > Out
Sept 2021,112,208,411,266798041,5760355788,6027153829,168,410,3,5493557747,In > Out
Sept 2021,112,209,619,104845370,2825057117,2929902487,63,615,4,2720211747,In > Out
Sept 2021,112,211,683,125920752,2438049887,2563970639,304,674,6,2312129135,In > Out
Sept 2021,112,212,917,401485678,9903961282,10305446960,261,900,10,9502475604,In > Out
Sept 2021,112,213,262,86199165,8430417370,8516616535,118,257,4,8344218205,In > Out
Sept 2021,112,216,302,182505032,16516167437,16698672469,96,301,3,16333662405,In > Out
Sept 2021,112,219,1206,737361198,4319391106,5056752304,362,1166,5,3582029908,In > Out
Sept 2021,112,22,931,92260409,1240287672,1332548081,211,905,3,1148027263,In > Out
Sept 2021,112,220,78,25517874,99436970,124954844,41,78,6,73919096,In > Out
Sept 2021,112,223,411,252406624,625175462,877582086,191,402,3,372768838,In > Out
Sept 2021,112,25,362,86812635,4658095873,4744908508,173,360,5,4571283238,In > Out
Sept 2021,112,28,315,94616960,966614600,1061231560,116,313,3,871997640,In > Out
Sept 2021,112,31,571,931090362,1843133527,2774223889,235,557,5,912043165,In > Out
Sept 2021,112,32,658,310640578,1855062666,2165703244,180,657,4,1544422088,In > Out
Sept 2021,112,33,765,198130980,3785704202,3983835182,311,741,4,3587573222,In > Out
Sept 2021,112,36,2021,411350843,12003869059,12415219902,346,1930,14,11592518216,In > Out
Sept 2021,112,38,2051,1381823247,16074769854,17456593101,516,1953,5,14692946607,In > Out
Sept 2021,112,39,743,229160815,1669734353,1898895168,200,736,5,1440573538,In > Out
Sept 2021,112,40,926,102099142,3170530609,3272629751,368,917,9,3068431467,In > Out
Sept 2021,112,41,602,476375302,7437100494,7913475796,220,597,7,6960725192,In > Out
Sept 2021,112,42,462,129235929,2196483721,2325719650,140,458,7,2067247792,In > Out
Sept 2021,112,45,671,837581842,984821872,1822403714,144,668,11,147240030,In > Out
Sept 2021,112,49,195,9786718,439827496,449614214,88,194,2,430040778,In > Out
Sept 2021,112,50,569,91803768,2747159460,2838963228,229,564,5,2655355692,In > Out
Sept 2021,112,53,841,281694183,2853898560,3135592743,376,802,15,2572204377,In > Out
Sept 2021,112,54,690,4400318547,7060142993,11460461540,209,684,6,2659824446,In > Out
Sept 2021,112,59,367,187976154,2365653519,2553629673,199,366,8,2177677365,In > Out
Sept 2021,112,6,1121,1113302427,5524546195,6637848622,278,1118,4,4411243768,In > Out
Sept 2021,112,64,415,395439730,1191482661,1586922391,114,407,5,796042931,In > Out
Sept 2021,112,68,205,83369684,3819947376,3903317060,92,204,2,3736577692,In > Out
Sept 2021,112,71,656,308527192,7653556140,7962083332,172,652,6,7345028948,In > Out
Sept 2021,112,72,464,468705545,2633195764,3101901309,180,459,5,2164490219,In > Out
Sept 2021,112,73,675,76454989,2247988389,2324443378,230,657,6,2171533400,In > Out
Sept 2021,112,74,745,107996450,1485596949,1593593399,257,731,4,1377600499,In > Out
Sept 2021,112,76,331,68433146,1095572094,1164005240,135,323,2,1027138948,In > Out
Sept 2021,112,78,996,419181701,8742345959,9161527660,329,974,12,8323164258,In > Out
Sept 2021,112,84,295,146334337,4922853048,5069187385,125,293,3,4776518711,In > Out
Sept 2021,112,85,2,1562,692311,693873,1,1,1,690749,In > Out
Sept 2021,112,86,1277,1172050138,6854889512,8026939650,364,1224,7,5682839374,In > Out
Sept 2021,112,88,491,45972937,1394314796,1440287733,194,484,6,1348341859,In > Out
Sept 2021,112,9,382,74296485,378013265,452309750,82,380,8,303716780,In > Out
Sept 2021,112,90,342,51901321,1586194774,1638096095,176,341,3,1534293453,In > Out
Sept 2021,112,91,1665,984230254,11556931361,12541161615,289,1622,13,10572701107,In > Out
Sept 2021,112,93,1192,3434837290,9801074514,13235911804,262,1156,6,6366237224,In > Out
Sept 2021,112,94,602,61894394,1842549813,1904444207,181,590,5,1780655419,In > Out
Sept 2021,112,96,400,469598215,2109121741,2578719956,155,393,13,1639523526,In > Out
Sept 2021,112,97,693,63245080,7489024244,7552269324,238,680,6,7425779164,In > Out
Sept 2021,112,99,428,234536068,1951032365,2185568433,170,426,6,1716496297,In > Out
Sept 2021,115,103,960,105011360,211063273,316074633,32,924,2,106051913,In > Out
Sept 2021,115,175,3909,698244651,2834461326,3532705977,547,3504,2,2136216675,In > Out
Sept 2021,115,75,292,54826565,496479578,551306143,63,289,2,441653013,In > Out
Sept 2021,115,95,1095,222537814,2710482912,2933020726,228,1043,3,2487945098,In > Out
Sept 2021,115,96,16,773854,8013496,8787350,12,16,1,7239642,In > Out
Sept 2021,117,148,881,13454211,2348003878,2361458089,8,879,2,2334549667,In > Out
Sept 2021,117,149,25,1195989,6465783,7661772,8,24,2,5269794,In > Out
Sept 2021,117,150,62,4273642726,91627743,4365270469,26,60,4,4182014983,Out > In
Sept 2021,117,151,16,15529028,40418585,55947613,5,10,4,24889557,In > Out
Sept 2021,117,152,85,11218487,789109591,800328078,37,75,2,777891104,In > Out
Sept 2021,117,155,32,1515752,57481898,58997650,10,32,2,55966146,In > Out
Sept 2021,117,16,358,45894546,1292879898,1338774444,73,358,3,1246985352,In > Out
Sept 2021,117,177,751,160884146,4106211471,4267095617,227,733,4,3945327325,In > Out
Sept 2021,117,208,7,986537,117926,1104463,5,7,1,868611,Out > In
Sept 2021,117,209,6029,45697360579,11569589129,57266949708,1119,5772,16,34127771450,Out > In
Sept 2021,117,233,1,70928,42840,113768,1,1,1,28088,Out > In
Sept 2021,117,236,454,101229046,74384716,175613762,6,409,40,26844330,Out > In
Sept 2021,117,246,71,63586640,2302770,65889410,6,1,71,61283870,Out > In
Sept 2021,117,50,393,99298298,217862435,317160733,30,383,4,118564137,In > Out
Sept 2021,117,58,1862,801294943,25115360671,25916655614,517,1784,12,24314065728,In > Out
Sept 2021,117,61,733,127269753,117550217,244819970,23,726,3,9719536,Out > In
Sept 2021,117,76,12,13488700,7425732,20914432,1,1,1,6062968,Out > In
Sept 2021,117,82,321,6102118280,103408078,6205526358,33,33,4,5998710202,Out > In
Sept 2021,117,90,390874,346237937342,3164458070483,3510696007825,18476,33115,747,2818220133141,In > Out
Sept 2021,118,100,2,18106,677270,695376,2,2,1,659164,In > Out
Sept 2021,118,108,405,38105895,1435372852,1473478747,122,403,2,1397266957,In > Out
Sept 2021,118,119,13,142818,12793573,12936391,6,13,1,12650755,In > Out
Sept 2021,118,124,1092,1398481363,437484435,1835965798,101,1055,5,960996928,Out > In
Sept 2021,118,128,271,5381342194,647854669,6029196863,81,271,2,4733487525,Out > In
Sept 2021,118,130,1482,291890298,2255546055,2547436353,492,1414,2,1963655757,In > Out
Sept 2021,118,132,59,6181724,117648044,123829768,37,59,2,111466320,In > Out
Sept 2021,118,133,242,14362066,316888151,331250217,69,242,2,302526085,In > Out
Sept 2021,118,137,1376,322176637,1075685965,1397862602,172,1328,4,753509328,In > Out
Sept 2021,118,140,1885,483183717,1991432205,2474615922,109,1782,3,1508248488,In > Out
Sept 2021,118,143,345,47886021,2148162680,2196048701,47,344,2,2100276659,In > Out
Sept 2021,118,144,707,47684086,2001923977,2049608063,176,693,5,1954239891,In > Out
Sept 2021,118,157,64,3983861,43146203,47130064,13,63,1,39162342,In > Out
Sept 2021,118,168,2663,223574059,7726308814,7949882873,478,2434,6,7502734755,In > Out
Sept 2021,118,177,7931,1276257739,21982858416,23259116155,1074,6013,5,20706600677,In > Out
Sept 2021,118,179,1051,139688605,893244127,1032932732,110,1024,6,753555522,In > Out
Sept 2021,118,182,373,39815777,1142600245,1182416022,84,370,3,1102784468,In > Out
Sept 2021,118,188,149,4995498,43803710,48799208,23,149,2,38808212,In > Out
Sept 2021,118,191,1456,763056183,5696440053,6459496236,532,1394,4,4933383870,In > Out
Sept 2021,118,194,113,12028447,278179735,290208182,29,113,2,266151288,In > Out
Sept 2021,118,205,1,87055,71875,158930,1,1,1,15180,Out > In
Sept 2021,118,207,1161,252067118,1519633096,1771700214,171,1121,2,1267565978,In > Out
Sept 2021,118,212,659,1595368276,4456795911,6052164187,224,644,6,2861427635,In > Out
Sept 2021,118,218,1048,232579368,2490035183,2722614551,59,1014,2,2257455815,In > Out
Sept 2021,118,225,283,29065697,721743875,750809572,91,280,3,692678178,In > Out
Sept 2021,118,227,355,20801027,853294683,874095710,59,355,2,832493656,In > Out
Sept 2021,118,228,376,44126816,360285195,404412011,59,373,2,316158379,In > Out
Sept 2021,118,237,4,31099,940990,972089,4,4,1,909891,In > Out
Sept 2021,118,28,5,343275,405300,748575,1,2,1,62025,In > Out
Sept 2021,118,33,276,112128095,4004492234,4116620329,43,275,2,3892364139,In > Out
Sept 2021,118,46,201,8925603,159894218,168819821,56,198,2,150968615,In > Out
Sept 2021,118,47,192,15810388,185449460,201259848,50,191,4,169639072,In > Out
Sept 2021,118,48,82,4604619,307381700,311986319,24,82,2,302777081,In > Out
Sept 2021,118,54,7,1689967,199390,1889357,6,7,2,1490577,Out > In
Sept 2021,118,63,42,223879262,203284349,427163611,25,42,4,20594913,Out > In
Sept 2021,118,70,270,35823637,4769926176,4805749813,33,269,2,4734102539,In > Out
Sept 2021,118,71,568,1816083803,2746563307,4562647110,147,544,3,930479504,In > Out
Sept 2021,118,73,12,1422508,66312270,67734778,8,12,2,64889762,In > Out
Sept 2021,118,81,7,5246430,83533007,88779437,5,7,1,78286577,In > Out
Sept 2021,118,83,284,10897088,454416852,465313940,72,282,2,443519764,In > Out
Sept 2021,118,85,1895,423491053,1582607926,2006098979,100,1807,3,1159116873,In > Out
Sept 2021,118,96,146,11143493,136947774,148091267,87,144,2,125804281,In > Out
Sept 2021,119,102,12,1143175,234873576,236016751,5,12,1,233730401,In > Out
Sept 2021,119,103,58,787126046,1509237609,2296363655,6,58,4,722111563,In > Out
Sept 2021,119,105,3,50902,3047018,3097920,3,3,1,2996116,In > Out
Sept 2021,119,108,387,38774773,289215793,327990566,57,384,2,250441020,In > Out
Sept 2021,119,109,743,84791434,513798702,598590136,46,723,2,429007268,In > Out
Sept 2021,119,122,338,31983402,1564853099,1596836501,48,337,3,1532869697,In > Out
Sept 2021,119,125,3716,486179981,6627096248,7113276229,888,3343,2,6140916267,In > Out
Sept 2021,119,128,473,64287949,211817823,276105772,59,467,3,147529874,In > Out
Sept 2021,119,148,1443,148593132,2315424916,2464018048,135,1388,2,2166831784,In > Out
Sept 2021,119,149,1131,287436152,1849263622,2136699774,126,1083,2,1561827470,In > Out
Sept 2021,119,151,118,27751500,250539673,278291173,75,118,2,222788173,In > Out
Sept 2021,119,154,667,74048871,1655770269,1729819140,50,652,2,1581721398,In > Out
Sept 2021,119,159,36,1054197,48505496,49559693,30,36,2,47451299,In > Out
Sept 2021,119,16,1,359182,10869,370051,1,1,1,348313,Out > In
Sept 2021,119,161,1,4569,303998,308567,1,1,1,299429,In > Out
Sept 2021,119,162,2602,2066327405,156925669312,158991996717,355,2377,2,154859341907,In > Out
Sept 2021,119,163,1,134029,100552,234581,1,1,1,33477,Out > In
Sept 2021,119,168,41,37727208,10795046,48522254,10,4,41,26932162,Out > In
Sept 2021,119,18,74,322739751,9054265015,9377004766,4,73,3,8731525264,In > Out
Sept 2021,119,183,582,36424649,288414466,324839115,20,572,2,251989817,In > Out
Sept 2021,119,199,810,2752006380,1860973331,4612979711,257,792,3,891033049,Out > In
Sept 2021,119,204,789,238693222,2963988106,3202681328,136,768,2,2725294884,In > Out
Sept 2021,119,214,636,117394279,1060081504,1177475783,94,627,2,942687225,In > Out
Sept 2021,119,29,713,159006106,1447505993,1606512099,106,695,2,1288499887,In > Out
Sept 2021,119,32,1,1347,222402,223749,1,1,1,221055,In > Out
Sept 2021,119,38,50,8027023,137503914,145530937,14,50,2,129476891,In > Out
Sept 2021,119,41,974,218367309,1297628759,1515996068,46,938,2,1079261450,In > Out
Sept 2021,119,64,153,25031457,1392052954,1417084411,59,153,2,1367021497,In > Out
Sept 2021,119,73,244,173150233,824349883,997500116,103,237,4,651199650,In > Out
Sept 2021,119,77,1861,248749679,473795435,722545114,132,1776,2,225045756,In > Out
Sept 2021,119,81,300,24185320941,4659827403,28845148344,85,299,3,19525493538,Out > In
Sept 2021,119,85,517,134290879,1784895435,1919186314,41,515,2,1650604556,In > Out
Sept 2021,120,101,403,126895063,1079250740,1206145803,37,403,2,952355677,In > Out
Sept 2021,120,105,858,719632460,4368066567,5087699027,314,833,4,3648434107,In > Out
Sept 2021,120,126,4231,723942314,2572134584,3296076898,224,3735,3,1848192270,In > Out
Sept 2021,120,182,2843,541482557,2199768674,2741251231,288,2568,2,1658286117,In > Out
Sept 2021,120,193,548,27455575,582805278,610260853,222,535,3,555349703,In > Out
Sept 2021,120,204,1283,288227331,2359815417,2648042748,290,1225,3,2071588086,In > Out
Sept 2021,120,71,171,909451420,28954915314,29864366734,76,155,22,28045463894,In > Out
Sept 2021,122,103,892,439833139,774091343,1213924482,138,869,4,334258204,In > Out
Sept 2021,122,104,137,19091243,285500860,304592103,12,135,6,266409617,In > Out
Sept 2021,122,105,137,15143370,169963303,185106673,14,136,4,154819933,In > Out
Sept 2021,122,121,147,38308220,289733939,328042159,12,145,4,251425719,In > Out
Sept 2021,122,130,132,14674441,117594397,132268838,10,131,3,102919956,In > Out
Sept 2021,122,149,141,19234886,308936416,328171302,12,141,5,289701530,In > Out
Sept 2021,122,160,540,26875542,2087822999,2114698541,77,535,6,2060947457,In > Out
Sept 2021,122,173,217,72789535,9620694633,9693484168,36,215,2,9547905098,In > Out
Sept 2021,122,183,636,324087642,896433359,1220521001,167,627,2,572345717,In > Out
Sept 2021,122,202,149,17079107,61477166,78556273,11,149,3,44398059,In > Out
Sept 2021,122,209,140,15900558,176989086,192889644,13,136,6,161088528,In > Out
Sept 2021,122,214,32,126940730,41886696,168827426,10,1,32,85054034,Out > In
Sept 2021,122,217,20,10493187,209658980,220152167,1,20,1,199165793,In > Out
Sept 2021,122,237,143,21812317,1098911746,1120724063,15,141,5,1077099429,In > Out
Sept 2021,122,73,142,16365018,180303449,196668467,11,142,3,163938431,In > Out
Sept 2021,122,78,139,32132457,595933289,628065746,65,138,5,563800832,In > Out
Sept 2021,123,101,703,460723301,3526362093,3987085394,245,691,4,3065638792,In > Out
Sept 2021,123,103,1378,972860329,6726188680,7699049009,312,1365,8,5753328351,In > Out
Sept 2021,123,104,304,1115691282,2757671788,3873363070,146,304,4,1641980506,In > Out
Sept 2021,123,105,193,14031870,535502311,549534181,80,192,2,521470441,In > Out
Sept 2021,123,107,833,935050139,4483497505,5418547644,215,794,4,3548447366,In > Out
Sept 2021,123,11,579,1401713362,13087702674,14489416036,136,571,8,11685989312,In > Out
Sept 2021,123,110,590,270419157,7634766691,7905185848,219,579,6,7364347534,In > Out
Sept 2021,123,111,750,74994242,3264874993,3339869235,166,723,2,3189880751,In > Out
Sept 2021,123,112,456,138073036,5396667114,5534740150,160,449,5,5258594078,In > Out
Sept 2021,123,113,161,19604232,835949665,855553897,65,159,2,816345433,In > Out
Sept 2021,123,116,339,393258680,3277527248,3670785928,139,339,3,2884268568,In > Out
Sept 2021,123,117,165,38505568,1372801943,1411307511,84,165,3,1334296375,In > Out
Sept 2021,123,119,671,79638569,2887944093,2967582662,202,661,5,2808305524,In > Out
Sept 2021,123,124,1357,355077002,12216669581,12571746583,373,1322,7,11861592579,In > Out
Sept 2021,123,126,390,1125570502,3737758342,4863328844,160,384,16,2612187840,In > Out
Sept 2021,123,128,347,42283907,1002241470,1044525377,148,346,2,959957563,In > Out
Sept 2021,123,129,200,94095611,1078410661,1172506272,113,199,3,984315050,In > Out
Sept 2021,123,130,516,425552191,2928428242,3353980433,236,513,5,2502876051,In > Out
Sept 2021,123,131,316,223279211,1490782210,1714061421,113,303,4,1267502999,In > Out
Sept 2021,123,132,1416,342907734,6690468660,7033376394,261,1309,7,6347560926,In > Out
Sept 2021,123,133,1121,924114285,3825465060,4749579345,276,1042,9,2901350775,In > Out
Sept 2021,123,134,1555,311311016,12872044361,13183355377,424,1469,15,12560733345,In > Out
Sept 2021,123,135,838,920418254,4928790255,5849208509,221,829,3,4008372001,In > Out
Sept 2021,123,136,621,409555027,4943789930,5353344957,192,610,6,4534234903,In > Out
Sept 2021,123,137,919,2843715527,3105650446,5949365973,226,900,4,261934919,In > Out
Sept 2021,123,138,322,71955726,1492870782,1564826508,151,322,4,1420915056,In > Out
Sept 2021,123,139,1046,277381435,13590890075,13868271510,371,1042,2,13313508640,In > Out
Sept 2021,123,140,564,744518642,3321064264,4065582906,229,557,5,2576545622,In > Out
Sept 2021,123,141,1695,280952217,6408932054,6689884271,232,1670,6,6127979837,In > Out
Sept 2021,123,142,1470,214567500,13090370585,13304938085,194,1458,3,12875803085,In > Out
Sept 2021,123,143,1034,344959341,2161825040,2506784381,222,1028,3,1816865699,In > Out
Sept 2021,123,144,375,35177631,940647058,975824689,147,373,3,905469427,In > Out
Sept 2021,123,145,1098,383987388,10214843044,10598830432,349,1068,6,9830855656,In > Out
Sept 2021,123,146,246,318684884,922059363,1240744247,83,246,5,603374479,In > Out
Sept 2021,123,149,724,277602062,1428866970,1706469032,171,718,7,1151264908,In > Out
Sept 2021,123,150,1679,250978513,14108006490,14358985003,349,1614,3,13857027977,In > Out
Sept 2021,123,151,699,3431622089,1873888665,5305510754,246,688,5,1557733424,Out > In
Sept 2021,123,152,288,39789753,1259266564,1299056317,106,287,4,1219476811,In > Out
Sept 2021,123,153,386,210367235,6411786046,6622153281,175,383,5,6201418811,In > Out
Sept 2021,123,154,721,439883804,2709413462,3149297266,143,716,4,2269529658,In > Out
Sept 2021,123,155,1669,417316043,11663352237,12080668280,547,1608,12,11246036194,In > Out
Sept 2021,123,156,134,75632072,678863675,754495747,53,131,3,603231603,In > Out
Sept 2021,123,157,271,28296570,330487992,358784562,147,271,3,302191422,In > Out
Sept 2021,123,158,442,183455628,466193804,649649432,165,438,3,282738176,In > Out
Sept 2021,123,159,622,502716560,2229667666,2732384226,193,610,10,1726951106,In > Out
Sept 2021,123,16,372,210149902,2350768868,2560918770,155,362,4,2140618966,In > Out
Sept 2021,123,163,4366,443405575,6151149627,6594555202,401,3813,7,5707744052,In > Out
Sept 2021,123,164,684,233332044,4633758238,4867090282,188,669,12,4400426194,In > Out
Sept 2021,123,166,113,6135994,144398737,150534731,47,113,2,138262743,In > Out
Sept 2021,123,167,107,6038646,164571912,170610558,50,106,2,158533266,In > Out
Sept 2021,123,168,118,11810398,326472395,338282793,71,118,2,314661997,In > Out
Sept 2021,123,169,213,101609749,1185618746,1287228495,91,213,2,1084008997,In > Out
Sept 2021,123,17,378,2431560539,2640510580,5072071119,170,369,10,208950041,In > Out
Sept 2021,123,170,328,307864823,17540627171,17848491994,132,325,4,17232762348,In > Out
Sept 2021,123,171,686,595239512,4758183458,5353422970,257,666,7,4162943946,In > Out
Sept 2021,123,172,427,52802905,1580093125,1632896030,96,423,4,1527290220,In > Out
Sept 2021,123,173,115,21943850,786435826,808379676,57,115,3,764491976,In > Out
Sept 2021,123,174,934,187907957,5014339308,5202247265,312,924,11,4826431351,In > Out
Sept 2021,123,177,49019,1315131470,170955104148,172270235618,369,16240,4,169639972678,In > Out
Sept 2021,123,178,1115,455648757,8870895576,9326544333,282,1080,21,8415246819,In > Out
Sept 2021,123,179,612,97051157,632856729,729907886,195,612,4,535805572,In > Out
Sept 2021,123,180,536,70807855,2562279580,2633087435,200,529,5,2491471725,In > Out
Sept 2021,123,183,911,1329967455,3899984965,5229952420,265,886,6,2570017510,In > Out
Sept 2021,123,187,527,70553453,11041110588,11111664041,77,527,2,10970557135,In > Out
Sept 2021,123,189,2142,591242856,10640362799,11231605655,379,1943,10,10049119943,In > Out
Sept 2021,123,190,279,63939413,1095832245,1159771658,104,278,3,1031892832,In > Out
Sept 2021,123,191,1637,715276479,3052794098,3768070577,221,1611,5,2337517619,In > Out
Sept 2021,123,192,277,30884089,1210111863,1240995952,97,268,6,1179227774,In > Out
Sept 2021,123,197,1567,738526250,15151734029,15890260279,387,1515,6,14413207779,In > Out
Sept 2021,123,198,587,397960237,5479854870,5877815107,167,582,4,5081894633,In > Out
Sept 2021,123,199,542,339889633,1233793016,1573682649,201,540,7,893903383,In > Out
Sept 2021,123,20,320,251324653,5142591147,5393915800,127,318,7,4891266494,In > Out
Sept 2021,123,200,881,217109192,2359780488,2576889680,191,857,4,2142671296,In > Out
Sept 2021,123,201,1329,144210555,5177243181,5321453736,464,1308,7,5033032626,In > Out
Sept 2021,123,203,215,15860165,878211010,894071175,70,211,4,862350845,In > Out
Sept 2021,123,204,685,132640433,3480321610,3612962043,255,673,5,3347681177,In > Out
Sept 2021,123,206,436,174961618,1175057245,1350018863,121,428,7,1000095627,In > Out
Sept 2021,123,208,454,103846639,9670376726,9774223365,192,444,26,9566530087,In > Out
Sept 2021,123,21,199,11691145,189572467,201263612,84,199,4,177881322,In > Out
Sept 2021,123,211,1457,370580982,11267968465,11638549447,399,1427,7,10897387483,In > Out
Sept 2021,123,212,663,16732256579,2082292024,18814548603,207,656,6,14649964555,Out > In
Sept 2021,123,216,673,314537645,3058274977,3372812622,226,662,28,2743737332,In > Out
Sept 2021,123,217,129,365265669,489343122,854608791,51,129,7,124077453,In > Out
Sept 2021,123,219,1268,1909964270,7958045314,9868009584,272,1242,24,6048081044,In > Out
Sept 2021,123,22,356,31939274,568226026,600165300,133,352,4,536286752,In > Out
Sept 2021,123,221,839,175354767,4190590292,4365945059,363,822,8,4015235525,In > Out
Sept 2021,123,222,880,1362659209,5516575891,6879235100,264,864,12,4153916682,In > Out
Sept 2021,123,223,1153,1437691039,8754962052,10192653091,173,1116,6,7317271013,In > Out
Sept 2021,123,23,199,98570246,600300162,698870408,88,198,7,501729916,In > Out
Sept 2021,123,24,489,249143624,878990394,1128134018,114,479,5,629846770,In > Out
Sept 2021,123,25,554,263872468,16557665526,16821537994,166,550,4,16293793058,In > Out
Sept 2021,123,27,494,226411840,18762967319,18989379159,155,488,2,18536555479,In > Out
Sept 2021,123,28,392,103524509,2598180674,2701705183,184,388,5,2494656165,In > Out
Sept 2021,123,31,667,341016427,3448255908,3789272335,255,656,18,3107239481,In > Out
Sept 2021,123,33,984,486073657,4067486311,4553559968,277,966,5,3581412654,In > Out
Sept 2021,123,35,619,176417913,17034452209,17210870122,214,610,6,16858034296,In > Out
Sept 2021,123,36,1539,246069951,3676514102,3922584053,547,1491,5,3430444151,In > Out
Sept 2021,123,37,278,513201548,1509923188,2023124736,131,274,3,996721640,In > Out
Sept 2021,123,38,981,143731929,2037892784,2181624713,268,971,4,1894160855,In > Out
Sept 2021,123,39,1965,1437237090,15931056416,17368293506,476,1839,7,14493819326,In > Out
Sept 2021,123,4,468,494309769,8025095608,8519405377,240,459,5,7530785839,In > Out
Sept 2021,123,40,289,342443619,370810713,713254332,118,287,3,28367094,In > Out
Sept 2021,123,42,1893,1878555689,8993085309,10871640998,419,1802,6,7114529620,In > Out
Sept 2021,123,43,966,312894207,23066570291,23379464498,244,954,5,22753676084,In > Out
Sept 2021,123,45,430,74455499,1107367122,1181822621,165,427,6,1032911623,In > Out
Sept 2021,123,48,739,232618212,5551521912,5784140124,252,726,5,5318903700,In > Out
Sept 2021,123,5,344,164748001,1564441339,1729189340,149,342,7,1399693338,In > Out
Sept 2021,123,53,601,39102520,1827028962,1866131482,191,595,6,1787926442,In > Out
Sept 2021,123,54,519,128037669,4537860958,4665898627,158,518,2,4409823289,In > Out
Sept 2021,123,55,1097,261069611,7058140715,7319210326,390,1073,5,6797071104,In > Out
Sept 2021,123,56,389,42372497,809111958,851484455,182,380,8,766739461,In > Out
Sept 2021,123,57,745,198320290,1394260698,1592580988,206,733,7,1195940408,In > Out
Sept 2021,123,58,2906,503994273,41571999940,42075994213,718,2665,4,41068005667,In > Out
Sept 2021,123,59,404,212109698,640190215,852299913,111,401,5,428080517,In > Out
Sept 2021,123,60,673,208212010,3081257247,3289469257,212,661,2,2873045237,In > Out
Sept 2021,123,61,848,456985708,6777333345,7234319053,223,842,8,6320347637,In > Out
Sept 2021,123,62,325,31570327,852084074,883654401,122,320,3,820513747,In > Out
Sept 2021,123,63,675,186809692,2808311168,2995120860,227,664,7,2621501476,In > Out
Sept 2021,123,64,477,44657454,1203578847,1248236301,133,476,5,1158921393,In > Out
Sept 2021,123,65,98,664277954,885153487,1549431441,58,98,4,220875533,In > Out
Sept 2021,123,66,984,6296984135,13281703530,19578687665,286,958,8,6984719395,In > Out
Sept 2021,123,68,813,183883277,1469941907,1653825184,222,804,8,1286058630,In > Out
Sept 2021,123,70,909,1097841901,10051679123,11149521024,219,900,10,8953837222,In > Out
Sept 2021,123,72,254,4491515305,5456071748,9947587053,89,252,6,964556443,In > Out
Sept 2021,123,74,442,206145076,7682389679,7888534755,165,438,14,7476244603,In > Out
Sept 2021,123,75,576,196554691,1903063921,2099618612,187,574,2,1706509230,In > Out
Sept 2021,123,77,1050,782364922,4634827799,5417192721,284,1032,11,3852462877,In > Out
Sept 2021,123,79,1467,972671874,8862152985,9834824859,375,1383,25,7889481111,In > Out
Sept 2021,123,81,977,1657296181,131677334494,133334630675,222,906,8,130020038313,In > Out
Sept 2021,123,82,991,94280420,2201797222,2296077642,188,974,7,2107516802,In > Out
Sept 2021,123,86,707,1251416380,6810668752,8062085132,194,700,5,5559252372,In > Out
Sept 2021,123,87,621,153836039,8060590959,8214426998,221,609,4,7906754920,In > Out
Sept 2021,123,89,582,5178402184,1735946789,6914348973,205,576,6,3442455395,Out > In
Sept 2021,123,90,574,152090817,5664415367,5816506184,143,571,6,5512324550,In > Out
Sept 2021,123,92,1263,590897587,31334124914,31925022501,274,1249,5,30743227327,In > Out
Sept 2021,123,93,553,104247973,816161135,920409108,228,549,4,711913162,In > Out
Sept 2021,123,94,484,64123300,1428113673,1492236973,143,484,5,1363990373,In > Out
Sept 2021,123,96,293,150087649,1143728566,1293816215,72,290,3,993640917,In > Out
Sept 2021,123,97,799,1283433666,10601676256,11885109922,300,774,10,9318242590,In > Out
Sept 2021,123,98,952,569181974,7074187840,7643369814,319,916,45,6505005866,In > Out
Sept 2021,123,99,736,153871734,2803362486,2957234220,258,716,6,2649490752,In > Out
Sept 2021,124,10,551,74262194,1448374909,1522637103,263,539,3,1374112715,In > Out
Sept 2021,124,100,523,308519476,1691468746,1999988222,219,518,12,1382949270,In > Out
Sept 2021,124,101,210,26941937,969184787,996126724,84,207,3,942242850,In > Out
Sept 2021,124,104,526,163888503,2388982553,2552871056,271,517,7,2225094050,In > Out
Sept 2021,124,105,681,453224778,10893433509,11346658287,270,657,8,10440208731,In > Out
Sept 2021,124,106,213,89807419,1325490726,1415298145,101,210,4,1235683307,In > Out
Sept 2021,124,108,820,479663277,7036365081,7516028358,404,797,7,6556701804,In > Out
Sept 2021,124,109,878,157484509,4347623769,4505108278,330,859,10,4190139260,In > Out
Sept 2021,124,11,512,552685284,1296614104,1849299388,153,511,4,743928820,In > Out
Sept 2021,124,110,738,216100154,2637409862,2853510016,193,727,10,2421309708,In > Out
Sept 2021,124,112,838,186560981,5107629190,5294190171,166,825,5,4921068209,In > Out
Sept 2021,124,113,1379,338441808,5799288792,6137730600,559,1349,6,5460846984,In > Out
Sept 2021,124,116,950,602216801,28959423862,29561640663,147,947,4,28357207061,In > Out
Sept 2021,124,117,1587,143964288,5643324353,5787288641,216,1545,4,5499360065,In > Out
Sept 2021,124,118,622,196106929,3646213315,3842320244,174,605,6,3450106386,In > Out
Sept 2021,124,120,359,140632708,1337885160,1478517868,102,357,3,1197252452,In > Out
Sept 2021,124,121,437,30082839,987179730,1017262569,157,430,4,957096891,In > Out
Sept 2021,124,124,306,1053814429,1992294592,3046109021,102,303,4,938480163,In > Out
Sept 2021,124,125,108,3973104,95265845,99238949,56,108,3,91292741,In > Out
Sept 2021,124,126,754,699583903,2720621394,3420205297,287,747,7,2021037491,In > Out
Sept 2021,124,128,775,139185224,2860420306,2999605530,225,759,8,2721235082,In > Out
Sept 2021,124,129,315,114245534,5180545716,5294791250,136,312,6,5066300182,In > Out
Sept 2021,124,130,419,195687403,1897686228,2093373631,145,415,4,1701998825,In > Out
Sept 2021,124,131,633,281707255,3399774732,3681481987,292,623,4,3118067477,In > Out
Sept 2021,124,132,2549,1033123879,8290802388,9323926267,469,2359,26,7257678509,In > Out
Sept 2021,124,133,309,366179707,2877256918,3243436625,131,307,7,2511077211,In > Out
Sept 2021,124,134,469,44325053,848105043,892430096,110,465,3,803779990,In > Out
Sept 2021,124,135,945,193879200,5295052520,5488931720,245,925,3,5101173320,In > Out
Sept 2021,124,136,1275,701733032,2947990871,3649723903,276,1251,6,2246257839,In > Out
Sept 2021,124,137,1692,624668202,7794277302,8418945504,497,1601,14,7169609100,In > Out
Sept 2021,124,138,535,210083708,994611420,1204695128,159,526,4,784527712,In > Out
Sept 2021,124,139,1634,168062736,6840813512,7008876248,408,1541,8,6672750776,In > Out
Sept 2021,124,14,225,49346492,1567202681,1616549173,127,224,3,1517856189,In > Out
Sept 2021,124,140,1479,117747728,4137243460,4254991188,123,1429,7,4019495732,In > Out
Sept 2021,124,141,238,89380425,3385648739,3475029164,104,238,11,3296268314,In > Out
Sept 2021,124,142,871,211280126,13329946761,13541226887,255,839,5,13118666635,In > Out
Sept 2021,124,143,367,213092820,3246464741,3459557561,67,367,1,3033371921,In > Out
Sept 2021,124,144,693,72767781,3615412080,3688179861,252,678,7,3542644299,In > Out
Sept 2021,124,145,547,157099211,8396895925,8553995136,207,519,6,8239796714,In > Out
Sept 2021,124,146,280,27256563,796215583,823472146,95,278,2,768959020,In > Out
Sept 2021,124,147,1952,1249321205,11258919457,12508240662,374,1885,8,10009598252,In > Out
Sept 2021,124,148,296,95153710,740953010,836106720,108,294,5,645799300,In > Out
Sept 2021,124,149,1515,328488542,4322754107,4651242649,434,1488,10,3994265565,In > Out
Sept 2021,124,150,916,225117476,3669987188,3895104664,337,909,9,3444869712,In > Out
Sept 2021,124,151,1260,666913678,6088320085,6755233763,212,1192,7,5421406407,In > Out
Sept 2021,124,152,483,641510845,1106141668,1747652513,196,479,3,464630823,In > Out
Sept 2021,124,153,949,208872902,6429724438,6638597340,203,932,4,6220851536,In > Out
Sept 2021,124,154,425,271478898,1536742572,1808221470,167,421,7,1265263674,In > Out
Sept 2021,124,155,271,74269612,3186307364,3260576976,77,271,7,3112037752,In > Out
Sept 2021,124,156,244,71155942,876030908,947186850,120,241,3,804874966,In > Out
Sept 2021,124,157,766,102558816,1753371867,1855930683,230,740,3,1650813051,In > Out
Sept 2021,124,158,471,106129471,5717331413,5823460884,228,464,6,5611201942,In > Out
Sept 2021,124,159,855,274618228,16143537710,16418155938,233,846,7,15868919482,In > Out
Sept 2021,124,16,2190,756361558,4979998784,5736360342,251,2047,10,4223637226,In > Out
Sept 2021,124,160,1070,426036722,9233708073,9659744795,302,1060,4,8807671351,In > Out
Sept 2021,124,161,696,453146867,4803740165,5256887032,197,684,18,4350593298,In > Out
Sept 2021,124,162,675,404309758,1649922948,2054232706,191,663,7,1245613190,In > Out
Sept 2021,124,163,2978,835667704,9258099526,10093767230,479,2778,4,8422431822,In > Out
Sept 2021,124,164,468,362533206,871257658,1233790864,183,461,14,508724452,In > Out
Sept 2021,124,165,701,8033381775,8696378225,16729760000,184,695,3,662996450,In > Out
Sept 2021,124,166,613,153872693,4221489619,4375362312,312,606,7,4067616926,In > Out
Sept 2021,124,167,447,265403354,1488919253,1754322607,133,444,13,1223515899,In > Out
Sept 2021,124,168,667,18346069476,1965977018,20312046494,166,664,3,16380092458,Out > In
Sept 2021,124,169,710,382368876,4997311668,5379680544,190,706,7,4614942792,In > Out
Sept 2021,124,17,1609,376577316,4170863020,4547440336,195,1552,9,3794285704,In > Out
Sept 2021,124,171,911,165413953,2663122112,2828536065,264,905,5,2497708159,In > Out
Sept 2021,124,172,83495,37171429600,206422346202,243593775802,1397,14066,1105,169250916602,In > Out
Sept 2021,124,173,198,39969645,2726055717,2766025362,106,196,2,2686086072,In > Out
Sept 2021,124,174,2660,337873442,10674093790,11011967232,349,2545,5,10336220348,In > Out
Sept 2021,124,176,785,2073020335,8801641297,10874661632,363,775,6,6728620962,In > Out
Sept 2021,124,177,949,216765961,4883332405,5100098366,283,924,4,4666566444,In > Out
Sept 2021,124,178,1094,229025857,8321700261,8550726118,230,1063,7,8092674404,In > Out
Sept 2021,124,179,153,57386929,1287295539,1344682468,52,153,2,1229908610,In > Out
Sept 2021,124,18,944,167348354,6767702184,6935050538,200,941,5,6600353830,In > Out
Sept 2021,124,181,1005,376133157,10344552283,10720685440,215,977,7,9968419126,In > Out
Sept 2021,124,182,881,1047039612,9058670805,10105710417,276,850,16,8011631193,In > Out
Sept 2021,124,183,1018,306420719,6953914546,7260335265,272,977,6,6647493827,In > Out
Sept 2021,124,184,865,361102127,2037977699,2399079826,340,838,8,1676875572,In > Out
Sept 2021,124,185,409,109186597,1076657673,1185844270,130,402,5,967471076,In > Out
Sept 2021,124,186,82,16411178,434309027,450720205,38,82,4,417897849,In > Out
Sept 2021,124,187,233,381542083,1709988607,2091530690,57,233,6,1328446524,In > Out
Sept 2021,124,188,766,257799933,17626145124,17883945057,144,751,4,17368345191,In > Out
Sept 2021,124,189,375,138494495,2583448636,2721943131,160,375,4,2444954141,In > Out
Sept 2021,124,19,469,101662571,2645899084,2747561655,192,465,4,2544236513,In > Out
Sept 2021,124,190,446,116330722,3911217466,4027548188,120,445,6,3794886744,In > Out
Sept 2021,124,191,1516,578260048,4629731439,5207991487,259,1491,5,4051471391,In > Out
Sept 2021,124,192,830,450873803,3844217853,4295091656,166,824,4,3393344050,In > Out
Sept 2021,124,193,285,38184166,1243272415,1281456581,82,285,4,1205088249,In > Out
Sept 2021,124,195,346,30941153,1303478129,1334419282,164,345,3,1272536976,In > Out
Sept 2021,124,197,1048,134796939,3802838373,3937635312,244,1027,5,3668041434,In > Out
Sept 2021,124,199,1523,133902129,7700497812,7834399941,264,1466,5,7566595683,In > Out
Sept 2021,124,20,486,23094933,646570910,669665843,98,486,4,623475977,In > Out
Sept 2021,124,200,806,569094868,3155470443,3724565311,217,805,6,2586375575,In > Out
Sept 2021,124,201,278,60105892,825207050,885312942,100,275,5,765101158,In > Out
Sept 2021,124,202,424,278203934,2204997538,2483201472,126,413,6,1926793604,In > Out
Sept 2021,124,203,492,424076457,6014167997,6438244454,166,486,8,5590091540,In > Out
Sept 2021,124,204,125,33681507,234227309,267908816,72,125,2,200545802,In > Out
Sept 2021,124,205,385,105353950,2431612279,2536966229,125,384,5,2326258329,In > Out
Sept 2021,124,206,1276,442375774,13841045689,14283421463,264,1240,11,13398669915,In > Out
Sept 2021,124,207,681,573686911,2544595748,3118282659,240,672,6,1970908837,In > Out
Sept 2021,124,208,1211,9264647040,10723647203,19988294243,207,1174,10,1459000163,In > Out
Sept 2021,124,21,310,206841969,955218588,1162060557,114,309,6,748376619,In > Out
Sept 2021,124,211,942,270905790,2601398815,2872304605,315,908,10,2330493025,In > Out
Sept 2021,124,212,1017,520602593,4288031382,4808633975,178,1013,6,3767428789,In > Out
Sept 2021,124,213,373,47900613,2075679599,2123580212,133,364,6,2027778986,In > Out
Sept 2021,124,214,1390,223092646,6318249794,6541342440,193,1389,3,6095157148,In > Out
Sept 2021,124,215,895,115157368,2770470208,2885627576,320,885,9,2655312840,In > Out
Sept 2021,124,216,203,26790288,1234745129,1261535417,94,203,4,1207954841,In > Out
Sept 2021,124,219,674,60599825,3034650393,3095250218,111,656,5,2974050568,In > Out
Sept 2021,124,22,799,88408394,1311945529,1400353923,264,785,3,1223537135,In > Out
Sept 2021,124,223,495,63034094,2433250885,2496284979,161,486,5,2370216791,In > Out
Sept 2021,124,23,541,67140277,1918101797,1985242074,202,530,5,1850961520,In > Out
Sept 2021,124,24,800,342851950,3367388431,3710240381,194,779,6,3024536481,In > Out
Sept 2021,124,26,1564,2437933758,12421073341,14859007099,385,1526,21,9983139583,In > Out
Sept 2021,124,27,893,503465138,8276274122,8779739260,98,886,5,7772808984,In > Out
Sept 2021,124,29,2211,10403619936,213139790037,223543409973,312,2034,72,202736170101,In > Out
Sept 2021,124,32,374,1406738146,3463720602,4870458748,141,369,6,2056982456,In > Out
Sept 2021,124,33,1308,202652010,6345448615,6548100625,404,1258,5,6142796605,In > Out
Sept 2021,124,35,425,1713693069,2751259211,4464952280,198,422,5,1037566142,In > Out
Sept 2021,124,36,1025,175441668,3081713838,3257155506,213,1004,7,2906272170,In > Out
Sept 2021,124,37,417,79044174,1398533620,1477577794,213,416,9,1319489446,In > Out
Sept 2021,124,39,306,56111867,1203695085,1259806952,101,305,3,1147583218,In > Out
Sept 2021,124,41,546,880799075,37261223374,38142022449,289,537,11,36380424299,In > Out
Sept 2021,124,43,1031,304606422,3598787118,3903393540,257,992,15,3294180696,In > Out
Sept 2021,124,44,971,1197897607,5966854538,7164752145,278,945,6,4768956931,In > Out
Sept 2021,124,45,1588,234581554,10563188719,10797770273,282,1529,20,10328607165,In > Out
Sept 2021,124,46,1301,162950814,4095094833,4258045647,336,1263,10,3932144019,In > Out
Sept 2021,124,48,220,45462445,2476416376,2521878821,122,220,2,2430953931,In > Out
Sept 2021,124,5,1296,181998111,6360120626,6542118737,325,1247,5,6178122515,In > Out
Sept 2021,124,51,918,981990039,3897684673,4879674712,199,886,7,2915694634,In > Out
Sept 2021,124,52,313,58773696,947191541,1005965237,83,308,5,888417845,In > Out
Sept 2021,124,53,157,55276747,1360119752,1415396499,73,156,6,1304843005,In > Out
Sept 2021,124,54,1019,219123653,3132306413,3351430066,261,998,8,2913182760,In > Out
Sept 2021,124,55,666,133128230,1314123749,1447251979,170,661,4,1180995519,In > Out
Sept 2021,124,58,283,485233419,2064885431,2550118850,155,282,6,1579652012,In > Out
Sept 2021,124,59,1010,1062038876,2243558848,3305597724,252,1002,6,1181519972,In > Out
Sept 2021,124,60,3484,169211285,12151938163,12321149448,163,3143,3,11982726878,In > Out
Sept 2021,124,64,1859,1562754906,6660286636,8223041542,329,1754,29,5097531730,In > Out
Sept 2021,124,65,257,144993354,1687143850,1832137204,131,257,3,1542150496,In > Out
Sept 2021,124,67,166,25261682,506002695,531264377,77,165,2,480741013,In > Out
Sept 2021,124,68,403,62041613,1353713863,1415755476,177,402,4,1291672250,In > Out
Sept 2021,124,69,1891,620731990,5992904291,6613636281,427,1799,4,5372172301,In > Out
Sept 2021,124,70,294,36663440,1989299587,2025963027,122,293,3,1952636147,In > Out
Sept 2021,124,73,277,45338298,248986957,294325255,118,274,8,203648659,In > Out
Sept 2021,124,74,930,5688456677,4377028342,10065485019,350,902,12,1311428335,Out > In
Sept 2021,124,77,2164,3880360400,9110520816,12990881216,297,2078,10,5230160416,In > Out
Sept 2021,124,78,1975,696018621,8333998762,9030017383,337,1864,8,7637980141,In > Out
Sept 2021,124,79,155,299878415,652341783,952220198,69,153,5,352463368,In > Out
Sept 2021,124,8,1090,1481996126,9426738394,10908734520,318,1070,7,7944742268,In > Out
Sept 2021,124,81,272,38497278,1493382925,1531880203,131,270,6,1454885647,In > Out
Sept 2021,124,82,827,158030756,7937461174,8095491930,210,815,3,7779430418,In > Out
Sept 2021,124,83,1052,504786351,9271612253,9776398604,126,1025,5,8766825902,In > Out
Sept 2021,124,85,417,1295081514,3436067638,4731149152,182,416,2,2140986124,In > Out
Sept 2021,124,87,1009,341373127,9454777702,9796150829,234,977,6,9113404575,In > Out
Sept 2021,124,9,1513,2361228577,7925402648,10286631225,460,1459,7,5564174071,In > Out
Sept 2021,124,91,217,28766508,915806076,944572584,94,217,3,887039568,In > Out
Sept 2021,124,96,550,145416386,2760145530,2905561916,157,543,4,2614729144,In > Out
Sept 2021,124,97,294,33016770,1643904068,1676920838,97,292,3,1610887298,In > Out
Sept 2021,124,98,287,44052947,1151461178,1195514125,104,287,3,1107408231,In > Out
Sept 2021,125,153,1852,2308508064,7476495302,9785003366,375,1766,4,5167987238,In > Out
Sept 2021,125,157,1690,518943487,12576255452,13095198939,341,1554,7,12057311965,In > Out
Sept 2021,125,203,120,13391563,316932239,330323802,60,120,2,303540676,In > Out
Sept 2021,125,210,467,108795780,2587622888,2696418668,136,459,2,2478827108,In > Out
Sept 2021,125,222,3,52762,3079930,3132692,2,3,1,3027168,In > Out
Sept 2021,125,225,319,32152032,917286388,949438420,159,318,3,885134356,In > Out
Sept 2021,125,231,1837,513443048,3954371370,4467814418,427,1715,2,3440928322,In > Out
Sept 2021,125,43,104,3108695,200712947,203821642,46,104,2,197604252,In > Out
Sept 2021,125,47,4,16090,767513,783603,3,4,1,751423,In > Out
Sept 2021,125,51,1991,939686964,4041332201,4981019165,595,1874,5,3101645237,In > Out
Sept 2021,125,53,2901,1152462052,8629379749,9781841801,490,2666,6,7476917697,In > Out
Sept 2021,125,66,534,142712200,1883855193,2026567393,140,522,2,1741142993,In > Out
Sept 2021,127,10,557,622755836,3170143061,3792898897,178,555,5,2547387225,In > Out
Sept 2021,127,100,1150,470194227,5162704086,5632898313,240,1127,11,4692509859,In > Out
Sept 2021,127,103,487,60079911,2504978349,2565058260,217,484,4,2444898438,In > Out
Sept 2021,127,105,685,171446764,2112911016,2284357780,186,679,6,1941464252,In > Out
Sept 2021,127,106,1032,335939778,4510934808,4846874586,260,1003,3,4174995030,In > Out
Sept 2021,127,109,545,89946557,3770307560,3860254117,121,542,4,3680361003,In > Out
Sept 2021,127,11,147,886091430,810579875,1696671305,75,145,4,75511555,Out > In
Sept 2021,127,111,467,156569891,3906250519,4062820410,161,458,4,3749680628,In > Out
Sept 2021,127,114,90,7122447,76922455,84044902,47,90,4,69800008,In > Out
Sept 2021,127,117,845,263988099,1867191036,2131179135,226,830,6,1603202937,In > Out
Sept 2021,127,119,432,1691191862,1242779795,2933971657,165,426,3,448412067,Out > In
Sept 2021,127,121,613,422151513,5628410649,6050562162,206,605,6,5206259136,In > Out
Sept 2021,127,122,756,241541050,3702012065,3943553115,304,749,2,3460471015,In > Out
Sept 2021,127,123,334,107050167,1338849888,1445900055,182,332,3,1231799721,In > Out
Sept 2021,127,124,2591,846727810,19274967570,20121695380,434,2420,4,18428239760,In > Out
Sept 2021,127,126,679,181822218,6869455295,7051277513,224,666,9,6687633077,In > Out
Sept 2021,127,128,614,415985129,3566302306,3982287435,190,605,6,3150317177,In > Out
Sept 2021,127,129,492,875551440,1860554847,2736106287,197,486,3,985003407,In > Out
Sept 2021,127,13,2591,1290666213,9531417401,10822083614,538,2469,25,8240751188,In > Out
Sept 2021,127,130,104,22251274,831785545,854036819,52,103,3,809534271,In > Out
Sept 2021,127,131,598,162749116,2072950183,2235699299,196,594,5,1910201067,In > Out
Sept 2021,127,132,1487,352260616,9069340613,9421601229,428,1438,8,8717079997,In > Out
Sept 2021,127,133,682,2388834717,2151874897,4540709614,231,678,6,236959820,Out > In
Sept 2021,127,134,345,482983643,2518052486,3001036129,141,342,5,2035068843,In > Out
Sept 2021,127,135,170,43210023,433977500,477187523,88,169,2,390767477,In > Out
Sept 2021,127,136,725,379001403,2784240050,3163241453,222,713,8,2405238647,In > Out
Sept 2021,127,137,1356,97618819,3512600264,3610219083,265,1323,7,3414981445,In > Out
Sept 2021,127,139,1465,515328485,10512464896,11027793381,329,1358,21,9997136411,In > Out
Sept 2021,127,14,399,129109085,3319429014,3448538099,59,395,4,3190319929,In > Out
Sept 2021,127,140,579,671385545,1927580031,2598965576,202,573,10,1256194486,In > Out
Sept 2021,127,141,726,232037912,13370354464,13602392376,257,721,7,13138316552,In > Out
Sept 2021,127,142,196,17844365,675362656,693207021,67,187,1,657518291,In > Out
Sept 2021,127,143,62,19026707,27564940,46591647,41,62,1,8538233,In > Out
Sept 2021,127,145,334,116364314,719837489,836201803,100,331,7,603473175,In > Out
Sept 2021,127,146,982,130181145,3993083348,4123264493,254,965,6,3862902203,In > Out
Sept 2021,127,147,1254,155545270,6989989028,7145534298,381,1216,4,6834443758,In > Out
Sept 2021,127,148,462,140091521,3295782220,3435873741,162,457,6,3155690699,In > Out
Sept 2021,127,149,539,4931610033,7266791897,12198401930,215,532,10,2335181864,In > Out
Sept 2021,127,150,358,353044454,3512730473,3865774927,99,354,3,3159686019,In > Out
Sept 2021,127,151,920,337113964,2525037514,2862151478,216,916,4,2187923550,In > Out
Sept 2021,127,152,440,191165742,1543291303,1734457045,135,440,7,1352125561,In > Out
Sept 2021,127,154,148,25907415,797844662,823752077,61,147,3,771937247,In > Out
Sept 2021,127,155,369,532363190,947717509,1480080699,187,363,5,415354319,In > Out
Sept 2021,127,156,254,23438605,639694917,663133522,95,254,12,616256312,In > Out
Sept 2021,127,157,804,396023226,5820480877,6216504103,194,795,5,5424457651,In > Out
Sept 2021,127,158,321,41420847,1696644953,1738065800,132,319,3,1655224106,In > Out
Sept 2021,127,159,452,122807538,15832985285,15955792823,145,447,4,15710177747,In > Out
Sept 2021,127,160,858,307426643,16761476303,17068902946,165,855,4,16454049660,In > Out
Sept 2021,127,161,61,4287193,44639488,48926681,27,61,2,40352295,In > Out
Sept 2021,127,162,135,2263973027,2459559458,4723532485,77,133,5,195586431,In > Out
Sept 2021,127,163,422,348343955,1890386384,2238730339,167,418,8,1542042429,In > Out
Sept 2021,127,164,1249,580682178,2060965497,2641647675,224,1220,5,1480283319,In > Out
Sept 2021,127,165,1200,771270347,3769787504,4541057851,319,1163,5,2998517157,In > Out
Sept 2021,127,166,2808,572034875,7837966385,8410001260,388,2651,6,7265931510,In > Out
Sept 2021,127,167,307,59082072,1095058584,1154140656,156,307,3,1035976512,In > Out
Sept 2021,127,168,3312,268449707,10101192946,10369642653,407,3038,16,9832743239,In > Out
Sept 2021,127,169,380,79614207,1103918748,1183532955,137,372,4,1024304541,In > Out
Sept 2021,127,17,731,709250470,7300205102,8009455572,244,715,10,6590954632,In > Out
Sept 2021,127,170,148,64745679,1196315856,1261061535,62,148,2,1131570177,In > Out
Sept 2021,127,172,103,10049230,228865343,238914573,37,103,4,218816113,In > Out
Sept 2021,127,173,918,1246717984,8278215179,9524933163,341,904,10,7031497195,In > Out
Sept 2021,127,174,88,19555443,531709872,551265315,55,88,3,512154429,In > Out
Sept 2021,127,175,412,58970929,935514604,994485533,122,410,3,876543675,In > Out
Sept 2021,127,176,721,705095467,948333513,1653428980,143,718,9,243238046,In > Out
Sept 2021,127,177,242,235441722,1197513782,1432955504,104,235,5,962072060,In > Out
Sept 2021,127,178,501,152210626,993289229,1145499855,144,484,4,841078603,In > Out
Sept 2021,127,179,374,47856258,1431695938,1479552196,171,371,2,1383839680,In > Out
Sept 2021,127,180,373,36747887,779755760,816503647,131,365,3,743007873,In > Out
Sept 2021,127,181,1648,981415057,10296140848,11277555905,373,1562,13,9314725791,In > Out
Sept 2021,127,182,519,667218046,2753121564,3420339610,134,516,7,2085903518,In > Out
Sept 2021,127,183,164,55590479,614547165,670137644,85,164,3,558956686,In > Out
Sept 2021,127,184,737,96708236,2386961163,2483669399,292,729,5,2290252927,In > Out
Sept 2021,127,185,227,51037493,829062877,880100370,96,226,5,778025384,In > Out
Sept 2021,127,186,394,52348208,1247916611,1300264819,118,390,10,1195568403,In > Out
Sept 2021,127,187,497,107758554,2003966534,2111725088,249,491,25,1896207980,In > Out
Sept 2021,127,188,109,6495689,93283730,99779419,71,109,3,86788041,In > Out
Sept 2021,127,189,1912,485472428,8709554732,9195027160,490,1839,10,8224082304,In > Out
Sept 2021,127,190,254,69355163,1112542019,1181897182,64,250,4,1043186856,In > Out
Sept 2021,127,191,411,182786950,1168949684,1351736634,217,408,21,986162734,In > Out
Sept 2021,127,192,1339,930813711,14552488770,15483302481,240,1292,16,13621675059,In > Out
Sept 2021,127,193,578,300436926,3905769167,4206206093,173,576,4,3605332241,In > Out
Sept 2021,127,194,267,182874043,1289727782,1472601825,126,265,7,1106853739,In > Out
Sept 2021,127,195,222,10123403,497984034,508107437,122,222,2,487860631,In > Out
Sept 2021,127,196,100,10781554,262336779,273118333,67,98,2,251555225,In > Out
Sept 2021,127,197,440,52669814,1334061763,1386731577,185,435,5,1281391949,In > Out
Sept 2021,127,198,227,84776736,1769549428,1854326164,98,227,4,1684772692,In > Out
Sept 2021,127,199,1067,1812137142,4513165568,6325302710,230,1049,6,2701028426,In > Out
Sept 2021,127,200,599,532127543,2262599379,2794726922,180,593,15,1730471836,In > Out
Sept 2021,127,201,375,49413823,1128034902,1177448725,138,374,2,1078621079,In > Out
Sept 2021,127,202,924,183542649,5562228402,5745771051,311,894,4,5378685753,In > Out
Sept 2021,127,203,719,214534594,4491772304,4706306898,286,709,5,4277237710,In > Out
Sept 2021,127,204,754,428087451,4792925304,5221012755,201,744,4,4364837853,In > Out
Sept 2021,127,205,870,1296520363,2974074198,4270594561,273,833,5,1677553835,In > Out
Sept 2021,127,206,573,113434133,1942670862,2056104995,226,568,8,1829236729,In > Out
Sept 2021,127,207,495,4296825319,794810962,5091636281,126,483,8,3502014357,Out > In
Sept 2021,127,208,262,33287091,721411575,754698666,119,262,3,688124484,In > Out
Sept 2021,127,209,1301,187901870,13114347162,13302249032,300,1263,6,12926445292,In > Out
Sept 2021,127,21,371,85884426,1540323366,1626207792,124,371,4,1454438940,In > Out
Sept 2021,127,210,292,1691851193,1140944667,2832795860,122,281,3,550906526,Out > In
Sept 2021,127,211,367,135187492,1108468750,1243656242,153,365,3,973281258,In > Out
Sept 2021,127,212,449,34276948,1359738468,1394015416,159,449,3,1325461520,In > Out
Sept 2021,127,213,183,18481169,220824660,239305829,77,182,2,202343491,In > Out
Sept 2021,127,214,594,307481523,16095663150,16403144673,163,594,2,15788181627,In > Out
Sept 2021,127,215,398,342601572,2206829380,2549430952,158,395,3,1864227808,In > Out
Sept 2021,127,216,41,3577988,41390060,44968048,16,41,1,37812072,In > Out
Sept 2021,127,217,1639,215208734,7979490995,8194699729,430,1581,6,7764282261,In > Out
Sept 2021,127,218,537,60135449,1607050855,1667186304,217,536,6,1546915406,In > Out
Sept 2021,127,219,125,177250751,188152416,365403167,58,123,5,10901665,In > Out
Sept 2021,127,220,847,164171356,9720807844,9884979200,299,832,10,9556636488,In > Out
Sept 2021,127,221,1833,199829218,6663987086,6863816304,417,1766,6,6464157868,In > Out
Sept 2021,127,222,584,110054511,2781360234,2891414745,255,581,4,2671305723,In > Out
Sept 2021,127,223,1162,761177842,8153162146,8914339988,296,1142,6,7391984304,In > Out
Sept 2021,127,23,423,388073505,2772001868,3160075373,114,420,6,2383928363,In > Out
Sept 2021,127,24,383,124913572,2477738057,2602651629,105,375,5,2352824485,In > Out
Sept 2021,127,26,424,97284794,1434451015,1531735809,166,415,4,1337166221,In > Out
Sept 2021,127,27,697,103374164,2997091385,3100465549,241,668,6,2893717221,In > Out
Sept 2021,127,28,642,89512267,2101054411,2190566678,239,637,8,2011542144,In > Out
Sept 2021,127,29,441,250750071,1561990360,1812740431,180,432,3,1311240289,In > Out
Sept 2021,127,31,576,81487979,4497567540,4579055519,149,575,3,4416079561,In > Out
Sept 2021,127,32,223,28578521,159476117,188054638,25,223,2,130897596,In > Out
Sept 2021,127,35,1113,332089156,6003529934,6335619090,367,1072,9,5671440778,In > Out
Sept 2021,127,36,1184,391070623,22280671226,22671741849,400,1120,5,21889600603,In > Out
Sept 2021,127,37,945,199668072,3918827815,4118495887,255,927,37,3719159743,In > Out
Sept 2021,127,39,686,231048940,13824924929,14055973869,229,659,3,13593875989,In > Out
Sept 2021,127,40,325,177663362,1997821046,2175484408,138,314,7,1820157684,In > Out
Sept 2021,127,41,165,1487520426,3833960781,5321481207,106,165,6,2346440355,In > Out
Sept 2021,127,44,513,117282232,8736223132,8853505364,208,505,4,8618940900,In > Out
Sept 2021,127,45,576,57932616,1693012629,1750945245,206,571,4,1635080013,In > Out
Sept 2021,127,48,442,604693422,629880437,1234573859,133,438,3,25187015,In > Out
Sept 2021,127,5,389,192377864,1133190700,1325568564,155,386,6,940812836,In > Out
Sept 2021,127,50,1273,58446195,2019198399,2077644594,221,1260,4,1960752204,In > Out
Sept 2021,127,52,811,418773976,2494557817,2913331793,284,793,23,2075783841,In > Out
Sept 2021,127,54,1083,1896098249,7723600941,9619699190,261,1063,11,5827502692,In > Out
Sept 2021,127,55,572,543947591,2713067168,3257014759,313,564,8,2169119577,In > Out
Sept 2021,127,56,420,3514836845,1581594100,5096430945,128,416,5,1933242745,Out > In
Sept 2021,127,59,814,100052826,1447778073,1547830899,324,786,4,1347725247,In > Out
Sept 2021,127,62,1364,181822189,9512936933,9694759122,283,1313,9,9331114744,In > Out
Sept 2021,127,63,606,388720778,9505095125,9893815903,233,601,6,9116374347,In > Out
Sept 2021,127,64,65,3329886,62537534,65867420,27,65,4,59207648,In > Out
Sept 2021,127,65,721,91703623,1814033835,1905737458,196,714,6,1722330212,In > Out
Sept 2021,127,66,1246,2338880295,7397154503,9736034798,334,1213,6,5058274208,In > Out
Sept 2021,127,67,1610,1664704822,5040362123,6705066945,261,1549,8,3375657301,In > Out
Sept 2021,127,7,971,659571577,3749200465,4408772042,296,919,12,3089628888,In > Out
Sept 2021,127,71,535,258452057,1195076478,1453528535,184,535,3,936624421,In > Out
Sept 2021,127,73,1562,456964103,6384107231,6841071334,409,1505,10,5927143128,In > Out
Sept 2021,127,74,1080,271565427,10821447771,11093013198,332,1059,4,10549882344,In > Out
Sept 2021,127,76,84,3751074,33210279,36961353,46,84,1,29459205,In > Out
Sept 2021,127,77,4578,288704703,11940004235,12228708938,582,3980,8,11651299532,In > Out
Sept 2021,127,8,385,63817137,5805488388,5869305525,142,384,5,5741671251,In > Out
Sept 2021,127,80,665,1287938065,4020494472,5308432537,221,658,7,2732556407,In > Out
Sept 2021,127,81,681,886145556,7305732563,8191878119,249,669,9,6419587007,In > Out
Sept 2021,127,82,1278,356833350,14620162826,14976996176,328,1258,6,14263329476,In > Out
Sept 2021,127,83,329,223381512,1371990482,1595371994,145,327,4,1148608970,In > Out
Sept 2021,127,84,754,126313654,2935885654,3062199308,227,728,6,2809572000,In > Out
Sept 2021,127,88,915,144924979,4948167806,5093092785,292,890,6,4803242827,In > Out
Sept 2021,127,89,1352,208927731,2199467491,2408395222,389,1296,27,1990539760,In > Out
Sept 2021,127,90,808,88971312,5019583672,5108554984,216,771,3,4930612360,In > Out
Sept 2021,127,92,660,211550284,2672797482,2884347766,219,657,3,2461247198,In > Out
Sept 2021,127,93,651,354875668,3196736946,3551612614,233,641,11,2841861278,In > Out
Sept 2021,127,94,1221,250892612,3380055067,3630947679,208,1173,7,3129162455,In > Out
Sept 2021,127,95,157,14288470,549011838,563300308,81,156,2,534723368,In > Out
Sept 2021,127,98,300,45143600,1506809275,1551952875,112,297,9,1461665675,In > Out
Sept 2021,127,99,475,63560425,6578048771,6641609196,123,474,5,6514488346,In > Out
Sept 2021,128,101,934,335526518,4103325689,4438852207,235,922,7,3767799171,In > Out
Sept 2021,128,102,1406,392784596,6182422869,6575207465,220,1356,11,5789638273,In > Out
Sept 2021,128,103,1367,2024290605,9971129590,11995420195,448,1309,8,7946838985,In > Out
Sept 2021,128,105,1339,9101304690,14349964757,23451269447,290,1313,7,5248660067,In > Out
Sept 2021,128,107,747,75105464,1719509824,1794615288,202,741,7,1644404360,In > Out
Sept 2021,128,110,1763,1535708255,15112461826,16648170081,353,1721,7,13576753571,In > Out
Sept 2021,128,111,1509,898133681,8987487308,9885620989,438,1417,94,8089353627,In > Out
Sept 2021,128,112,858,111553728,3400083597,3511637325,264,839,4,3288529869,In > Out
Sept 2021,128,116,557,966105903,4858112691,5824218594,240,548,13,3892006788,In > Out
Sept 2021,128,118,558,166890480,1237637404,1404527884,194,542,4,1070746924,In > Out
Sept 2021,128,120,800,89911384,1730566362,1820477746,191,790,3,1640654978,In > Out
Sept 2021,128,124,386,1940520043,2337635166,4278155209,125,377,8,397115123,In > Out
Sept 2021,128,125,551,136976113,1047885245,1184861358,192,546,9,910909132,In > Out
Sept 2021,128,126,2966,508135676,12541018134,13049153810,641,2804,16,12032882458,In > Out
Sept 2021,128,127,1334,408599009,10495600980,10904199989,428,1292,5,10087001971,In > Out
Sept 2021,128,129,355,221491713,1296163013,1517654726,130,352,4,1074671300,In > Out
Sept 2021,128,13,1402,2797138615,9307676871,12104815486,239,1361,9,6510538256,In > Out
Sept 2021,128,130,3432,1409464509,24501530972,25910995481,595,3094,136,23092066463,In > Out
Sept 2021,128,135,374,42831918,559794946,602626864,148,372,6,516963028,In > Out
Sept 2021,128,139,1169,297402686,5112186472,5409589158,333,1144,10,4814783786,In > Out
Sept 2021,128,14,1560,1414836104,5211695578,6626531682,371,1504,7,3796859474,In > Out
Sept 2021,128,141,1857,2537917801,12359419622,14897337423,393,1780,6,9821501821,In > Out
Sept 2021,128,142,2497,1136710137,18459704466,19596414603,587,2370,9,17322994329,In > Out
Sept 2021,128,146,895,2143867421,11465692900,13609560321,292,877,7,9321825479,In > Out
Sept 2021,128,147,4482,851568572,12081910171,12933478743,349,4395,70,11230341599,In > Out
Sept 2021,128,149,1446,1358024084,5761517943,7119542027,310,1399,8,4403493859,In > Out
Sept 2021,128,151,1014,579728516,4968814070,5548542586,278,994,7,4389085554,In > Out
Sept 2021,128,152,1314,360035674,6019924032,6379959706,432,1272,6,5659888358,In > Out
Sept 2021,128,153,651,311974638,6693861182,7005835820,220,634,12,6381886544,In > Out
Sept 2021,128,154,227,32784330,779193421,811977751,72,227,1,746409091,In > Out
Sept 2021,128,155,1826,3565320527,7920953666,11486274193,383,1777,7,4355633139,In > Out
Sept 2021,128,156,814,217711756,18501953761,18719665517,292,794,6,18284242005,In > Out
Sept 2021,128,157,259,18082151,769589201,787671352,128,257,5,751507050,In > Out
Sept 2021,128,159,499,410453389,2346488732,2756942121,159,491,3,1936035343,In > Out
Sept 2021,128,16,1271,708898148,3218410329,3927308477,390,1228,11,2509512181,In > Out
Sept 2021,128,162,1106,143639614,3720248457,3863888071,323,1065,6,3576608843,In > Out
Sept 2021,128,163,267,195627637,964385420,1160013057,127,265,5,768757783,In > Out
Sept 2021,128,165,1309,811251297,3698842820,4510094117,349,1238,13,2887591523,In > Out
Sept 2021,128,171,405,141366999,3914895851,4056262850,200,402,8,3773528852,In > Out
Sept 2021,128,177,1149,1980961189,8471478022,10452439211,445,1114,11,6490516833,In > Out
Sept 2021,128,178,1101,279586641,1907274877,2186861518,230,1079,4,1627688236,In > Out
Sept 2021,128,18,504,98814170,5022282461,5121096631,202,492,5,4923468291,In > Out
Sept 2021,128,181,1639,339611864,5738287898,6077899762,388,1587,6,5398676034,In > Out
Sept 2021,128,186,1046,337056975,5313347241,5650404216,298,1010,7,4976290266,In > Out
Sept 2021,128,187,1737,179162566,5468969231,5648131797,377,1688,5,5289806665,In > Out
Sept 2021,128,189,1484,1039572520,7460304741,8499877261,443,1428,12,6420732221,In > Out
Sept 2021,128,19,536,54491574,1902316514,1956808088,175,530,8,1847824940,In > Out
Sept 2021,128,191,1048,456704274,4062086017,4518790291,354,1012,7,3605381743,In > Out
Sept 2021,128,192,468,227417112,839668339,1067085451,174,462,6,612251227,In > Out
Sept 2021,128,193,679,135452786,4808760934,4944213720,166,676,5,4673308148,In > Out
Sept 2021,128,194,496,53349167,1518594745,1571943912,124,493,3,1465245578,In > Out
Sept 2021,128,195,1236,724348085,5188499058,5912847143,448,1210,14,4464150973,In > Out
Sept 2021,128,197,1187,539718512,7350518435,7890236947,458,1163,6,6810799923,In > Out
Sept 2021,128,198,1076,3122910616,8579006124,11701916740,292,1065,10,5456095508,In > Out
Sept 2021,128,199,3135,757353417,25188953255,25946306672,525,2831,6,24431599838,In > Out
Sept 2021,128,200,1179,256024754,3194511219,3450535973,358,1116,133,2938486465,In > Out
Sept 2021,128,202,471,890199176,1560262504,2450461680,197,466,7,670063328,In > Out
Sept 2021,128,204,1012,597740664,9779803699,10377544363,259,988,3,9182063035,In > Out
Sept 2021,128,206,837,72384817,4256479408,4328864225,237,831,5,4184094591,In > Out
Sept 2021,128,21,1022,336006089,3860996323,4197002412,237,1003,8,3524990234,In > Out
Sept 2021,128,210,1241,419465304,7970410717,8389876021,338,1203,5,7550945413,In > Out
Sept 2021,128,211,1673,183450215,5805946107,5989396322,300,1619,7,5622495892,In > Out
Sept 2021,128,212,1080,713496494,4038149285,4751645779,377,1066,6,3324652791,In > Out
Sept 2021,128,214,1256,338020609,9308813256,9646833865,449,1222,6,8970792647,In > Out
Sept 2021,128,215,973,313205725,2437270086,2750475811,231,930,11,2124064361,In > Out
Sept 2021,128,216,1317,3834279293,14531060479,18365339772,271,1250,11,10696781186,In > Out
Sept 2021,128,219,1321,342623383,11727101831,12069725214,318,1285,4,11384478448,In > Out
Sept 2021,128,22,2136,344918414,9092717777,9437636191,410,1996,10,8747799363,In > Out
Sept 2021,128,220,609,83132530,1510844137,1593976667,190,603,5,1427711607,In > Out
Sept 2021,128,223,464,122534608,2848261376,2970795984,164,461,7,2725726768,In > Out
Sept 2021,128,23,866,1347331556,6801753977,8149085533,319,851,11,5454422421,In > Out
Sept 2021,128,25,1113,188028527,4073665786,4261694313,192,1098,6,3885637259,In > Out
Sept 2021,128,27,421,137431984,1927097371,2064529355,181,417,4,1789665387,In > Out
Sept 2021,128,29,301,521376186,1762881352,2284257538,118,299,4,1241505166,In > Out
Sept 2021,128,31,948,226828125,1621852789,1848680914,170,921,7,1395024664,In > Out
Sept 2021,128,36,1800,480332768,28574985134,29055317902,429,1735,6,28094652366,In > Out
Sept 2021,128,37,923,1087608156,3043118758,4130726914,326,906,9,1955510602,In > Out
Sept 2021,128,38,1211,248452133,4038080215,4286532348,331,1151,5,3789628082,In > Out
Sept 2021,128,4,1459,1390548966,6912006072,8302555038,279,1399,7,5521457106,In > Out
Sept 2021,128,44,954,335691058,6866378669,7202069727,217,907,6,6530687611,In > Out
Sept 2021,128,45,973,533431925,3327693088,3861125013,303,954,9,2794261163,In > Out
Sept 2021,128,46,1247,370222857,8761064993,9131287850,385,1220,11,8390842136,In > Out
Sept 2021,128,48,456,39456657,849718389,889175046,150,443,1,810261732,In > Out
Sept 2021,128,50,757,229749859,1064767776,1294517635,241,746,5,835017917,In > Out
Sept 2021,128,51,765,1623609183,4374672995,5998282178,235,740,10,2751063812,In > Out
Sept 2021,128,54,1385,217594326,4405158949,4622753275,324,1329,18,4187564623,In > Out
Sept 2021,128,57,940,230780739,3491059465,3721840204,213,925,7,3260278726,In > Out
Sept 2021,128,60,940,545326404,8314905804,8860232208,226,910,7,7769579400,In > Out
Sept 2021,128,62,648,236256616,3636360047,3872616663,252,647,10,3400103431,In > Out
Sept 2021,128,65,1035,2660027613,5790684207,8450711820,288,1025,5,3130656594,In > Out
Sept 2021,128,68,710,149198737,4609841917,4759040654,252,695,5,4460643180,In > Out
Sept 2021,128,69,762,336178311,4051726823,4387905134,239,754,8,3715548512,In > Out
Sept 2021,128,70,1834,1321712828,8451564730,9773277558,526,1758,7,7129851902,In > Out
Sept 2021,128,71,300,55235851,623113286,678349137,108,300,3,567877435,In > Out
Sept 2021,128,72,591,1973407648,4750219757,6723627405,250,584,7,2776812109,In > Out
Sept 2021,128,76,735,615007659,2536828068,3151835727,207,727,7,1921820409,In > Out
Sept 2021,128,77,1395,197064943,2951576008,3148640951,281,1304,7,2754511065,In > Out
Sept 2021,128,79,648,596765415,3455660759,4052426174,244,636,7,2858895344,In > Out
Sept 2021,128,8,1624,758530198,17516875117,18275405315,468,1553,15,16758344919,In > Out
Sept 2021,128,80,1057,253287388,2591592422,2844879810,323,1017,86,2338305034,In > Out
Sept 2021,128,84,233,30560928,1003166871,1033727799,104,231,3,972605943,In > Out
Sept 2021,128,87,603,153342678,3698591595,3851934273,163,595,13,3545248917,In > Out
Sept 2021,128,89,1019,358658774,5160498156,5519156930,323,1002,4,4801839382,In > Out
Sept 2021,128,94,252,110562998,350522512,461085510,108,250,2,239959514,In > Out
Sept 2021,128,96,446,106827843,754649684,861477527,155,438,4,647821841,In > Out
Sept 2021,128,99,1929,1297075382,25567119099,26864194481,549,1845,21,24270043717,In > Out
Sept 2021,129,119,66,32127617,344992618,377120235,17,66,2,312865001,In > Out
Sept 2021,129,130,275,22464820,510929917,533394737,74,272,2,488465097,In > Out
Sept 2021,129,134,28,4999627,201612855,206612482,15,28,2,196613228,In > Out
Sept 2021,129,135,1047,106242876,3421153295,3527396171,183,1016,2,3314910419,In > Out
Sept 2021,129,138,109,19899864,503933262,523833126,40,108,2,484033398,In > Out
Sept 2021,129,140,828,76676201,1654540219,1731216420,326,811,2,1577864018,In > Out
Sept 2021,129,141,3623,800538080,2162041001,2962579081,201,3245,3,1361502921,In > Out
Sept 2021,129,153,590,52443899,2590023616,2642467515,46,579,2,2537579717,In > Out
Sept 2021,129,154,13,278874,4063657,4342531,9,13,2,3784783,In > Out
Sept 2021,129,155,7,3551327,121557,3672884,1,7,1,3429770,Out > In
Sept 2021,129,156,2074,116136874,942388960,1058525834,48,2020,2,826252086,In > Out
Sept 2021,129,157,6,581605,702640,1284245,2,6,2,121035,In > Out
Sept 2021,129,158,1,5652,195664,201316,1,1,1,190012,In > Out
Sept 2021,129,168,7,188435,5594533,5782968,5,7,1,5406098,In > Out
Sept 2021,129,169,44,5891556,157181864,163073420,27,44,2,151290308,In > Out
Sept 2021,129,174,263,80240755,482842330,563083085,73,261,2,402601575,In > Out
Sept 2021,129,175,176,30456982,1546776981,1577233963,75,175,2,1516319999,In > Out
Sept 2021,129,176,144,38926105,1459716960,1498643065,46,144,2,1420790855,In > Out
Sept 2021,129,186,377,111840936,3893038879,4004879815,70,376,2,3781197943,In > Out
Sept 2021,129,189,2,11349,525213,536562,2,2,1,513864,In > Out
Sept 2021,129,191,714,15423020,113899843,129322863,2,714,2,98476823,In > Out
Sept 2021,129,196,711,748142505,7379187538,8127330043,88,703,4,6631045033,In > Out
Sept 2021,129,202,440,188506428,1971426146,2159932574,118,437,2,1782919718,In > Out
Sept 2021,129,21,121,18457390601,1763346327,20220736928,1,121,1,16694044274,Out > In
Sept 2021,129,225,56,5237561,68899041,74136602,19,56,2,63661480,In > Out
Sept 2021,129,230,16,2523164,229374349,231897513,6,16,2,226851185,In > Out
Sept 2021,129,236,13,84004,6009910,6093914,2,13,1,5925906,In > Out
Sept 2021,129,242,8,34247,1219895,1254142,3,8,1,1185648,In > Out
Sept 2021,129,243,1310,131013394,4099174579,4230187973,267,1306,2,3968161185,In > Out
Sept 2021,129,249,39,13258328,927441444,940699772,18,39,2,914183116,In > Out
Sept 2021,129,25,2,159375,17460972,17620347,1,2,1,17301597,In > Out
Sept 2021,129,29,1572,171763163,4916873753,5088636916,418,1499,2,4745110590,In > Out
Sept 2021,129,30,12,587906,13894197,14482103,10,12,2,13306291,In > Out
Sept 2021,129,31,3722,370110063,12047720966,12417831029,208,3322,2,11677610903,In > Out
Sept 2021,129,33,2803,458622679,20121221101,20579843780,594,2576,2,19662598422,In > Out
Sept 2021,129,36,4,244311,32242677,32486988,3,4,1,31998366,In > Out
Sept 2021,129,44,205,97817885,3955708205,4053526090,59,204,2,3857890320,In > Out
Sept 2021,129,46,531,127830869,1294581874,1422412743,184,520,3,1166751005,In > Out
Sept 2021,129,56,209,20537092,234467716,255004808,59,208,4,213930624,In > Out
Sept 2021,129,68,569,81976380,385198743,467175123,182,562,2,303222363,In > Out
Sept 2021,129,80,437,171816184,1970266873,2142083057,27,431,2,1798450689,In > Out
Sept 2021,129,97,1900,154626116,1942476826,2097102942,251,1744,5,1787850710,In > Out
Sept 2021,13,17,13,3416037,303331,3719368,2,13,1,3112706,Out > In
Sept 2021,130,101,1506,228487990,610139335,838627325,164,1422,2,381651345,In > Out
Sept 2021,130,103,1341,221627673,2611144666,2832772339,142,1284,3,2389516993,In > Out
Sept 2021,130,104,907,141986370,540472259,682458629,46,907,2,398485889,In > Out
Sept 2021,130,105,790,111859879,1768386176,1880246055,122,775,2,1656526297,In > Out
Sept 2021,130,106,1245,51338701,2483725189,2535063890,81,1226,2,2432386488,In > Out
Sept 2021,130,107,444,442726725,1159187180,1601913905,187,439,5,716460455,In > Out
Sept 2021,130,109,77,7787849,31020900,38808749,12,77,1,23233051,In > Out
Sept 2021,130,116,585,69858280,644326604,714184884,162,574,3,574468324,In > Out
Sept 2021,130,119,14,31440616,1457686085,1489126701,4,14,1,1426245469,In > Out
Sept 2021,130,121,99,9040444,39666098,48706542,13,99,1,30625654,In > Out
Sept 2021,130,123,2483,363390151,4235011030,4598401181,81,2257,2,3871620879,In > Out
Sept 2021,130,135,263,261433994,1243396579,1504830573,116,261,3,981962585,In > Out
Sept 2021,130,138,373,51414181,1475822358,1527236539,74,368,2,1424408177,In > Out
Sept 2021,130,174,2577,702047054,3403948057,4105995111,308,2388,4,2701901003,In > Out
Sept 2021,130,190,29,1453370,26179142,27632512,13,29,2,24725772,In > Out
Sept 2021,130,3,21,1882485,27733563,29616048,11,21,2,25851078,In > Out
Sept 2021,130,51,1071,124143202,402203227,526346429,112,1044,2,278060025,In > Out
Sept 2021,130,52,57,7546855,48530468,56077323,23,57,2,40983613,In > Out
Sept 2021,130,53,297,92919872,746116317,839036189,72,296,2,653196445,In > Out
Sept 2021,130,54,1557,913801677,2715753082,3629554759,250,1489,2,1801951405,In > Out
Sept 2021,130,55,13,2483730,9031281,11515011,8,13,2,6547551,In > Out
Sept 2021,130,56,1054,209334480,2574751169,2784085649,307,1017,3,2365416689,In > Out
Sept 2021,130,57,10,51960,1946487,1998447,2,10,1,1894527,In > Out
Sept 2021,130,58,816,197008276,570342778,767351054,65,794,3,373334502,In > Out
Sept 2021,130,59,37,257527,35283407,35540934,8,37,1,35025880,In > Out
Sept 2021,130,60,1562,487788059,7081380008,7569168067,362,1492,3,6593591949,In > Out
Sept 2021,130,61,2628,540734546,3179788851,3720523397,576,2431,5,2639054305,In > Out
Sept 2021,130,62,728,51203557,354551295,405754852,263,719,2,303347738,In > Out
Sept 2021,130,64,379,630323333,2870066067,3500389400,127,379,5,2239742734,In > Out
Sept 2021,130,67,1321,615287300,2613992580,3229279880,205,1278,3,1998705280,In > Out
Sept 2021,130,68,317,977121841,1742945632,2720067473,96,317,3,765823791,In > Out
Sept 2021,130,71,703,49586184,741914541,791500725,62,690,2,692328357,In > Out
Sept 2021,130,72,20,56326427,52548855,108875282,18,20,2,3777572,Out > In
Sept 2021,130,74,485,427346763,1425839136,1853185899,84,483,2,998492373,In > Out
Sept 2021,130,75,228,729312158,290963927,1020276085,36,227,2,438348231,Out > In
Sept 2021,130,76,626,94860885,5285840664,5380701549,83,605,2,5190979779,In > Out
Sept 2021,130,77,147,697855036,778968365,1476823401,68,147,3,81113329,In > Out
Sept 2021,130,78,157,46291508,2242637478,2288928986,35,157,2,2196345970,In > Out
Sept 2021,130,79,85,92495882,563799500,656295382,45,85,3,471303618,In > Out
Sept 2021,130,86,446,104636455,566643498,671279953,165,401,3,462007043,In > Out
Sept 2021,130,87,141,37027281,1020807788,1057835069,64,141,2,983780507,In > Out
Sept 2021,130,88,389,21506011,532433063,553939074,39,387,2,510927052,In > Out
Sept 2021,130,89,14,102037,6001988,6104025,4,14,1,5899951,In > Out
Sept 2021,130,90,3,490893,7907295,8398188,3,3,2,7416402,In > Out
Sept 2021,130,92,38,2500573,32068837,34569410,16,38,2,29568264,In > Out
Sept 2021,130,93,141,13640152,231835546,245475698,28,141,2,218195394,In > Out
Sept 2021,130,95,463,268364097,1262254244,1530618341,142,452,2,993890147,In > Out
Sept 2021,130,96,126,19294976,77195115,96490091,13,126,2,57900139,In > Out
Sept 2021,131,100,323,369334778,987905656,1357240434,122,319,4,618570878,In > Out
Sept 2021,131,102,433,142315077,1542540020,1684855097,145,431,5,1400224943,In > Out
Sept 2021,131,104,1105,454293181,4507325595,4961618776,251,1063,7,4053032414,In > Out
Sept 2021,131,105,1050,128520002,3689999201,3818519203,304,1021,10,3561479199,In > Out
Sept 2021,131,108,437,199073016,1816510939,2015583955,196,432,12,1617437923,In > Out
Sept 2021,131,110,434,120548724,1542494084,1663042808,154,431,3,1421945360,In > Out
Sept 2021,131,111,1011,288304966,3459311445,3747616411,285,1002,5,3171006479,In > Out
Sept 2021,131,112,967,140739100,2296199668,2436938768,223,954,6,2155460568,In > Out
Sept 2021,131,113,1570,1166532742,26904414424,28070947166,468,1481,5,25737881682,In > Out
Sept 2021,131,114,1052,197481393,4250578816,4448060209,284,1014,4,4053097423,In > Out
Sept 2021,131,115,223,67394185,1499328397,1566722582,82,222,5,1431934212,In > Out
Sept 2021,131,118,921,1326716362,27984673966,29311390328,391,909,14,26657957604,In > Out
Sept 2021,131,12,1363,533796462,11303296123,11837092585,319,1271,12,10769499661,In > Out
Sept 2021,131,121,1376,152691656,2961034156,3113725812,388,1340,14,2808342500,In > Out
Sept 2021,131,122,175,355682954,2436482839,2792165793,73,149,5,2080799885,In > Out
Sept 2021,131,123,542,1480253522,10500683632,11980937154,194,537,4,9020430110,In > Out
Sept 2021,131,124,867,706641193,4290749524,4997390717,332,829,4,3584108331,In > Out
Sept 2021,131,125,536,673430787,1475341291,2148772078,208,531,6,801910504,In > Out
Sept 2021,131,127,1273,2965200141,6015630635,8980830776,260,1221,15,3050430494,In > Out
Sept 2021,131,128,187,52267953,513061503,565329456,87,186,5,460793550,In > Out
Sept 2021,131,129,655,44633696,1075614018,1120247714,165,652,2,1030980322,In > Out
Sept 2021,131,130,368,62780799,701941853,764722652,138,363,8,639161054,In > Out
Sept 2021,131,131,1849,2133476882,7579823343,9713300225,475,1787,16,5446346461,In > Out
Sept 2021,131,132,433,48550380,3102516763,3151067143,197,432,5,3053966383,In > Out
Sept 2021,131,133,1101,117154629,5433808438,5550963067,281,1073,4,5316653809,In > Out
Sept 2021,131,134,542,2172171077,8019392838,10191563915,179,535,9,5847221761,In > Out
Sept 2021,131,136,269,101273014,785209291,886482305,104,266,5,683936277,In > Out
Sept 2021,131,137,3075,1091106974,22232880808,23323987782,617,2888,7,21141773834,In > Out
Sept 2021,131,138,497,84741432,1753258031,1837999463,174,494,4,1668516599,In > Out
Sept 2021,131,139,374,143400877,6026747324,6170148201,183,372,3,5883346447,In > Out
Sept 2021,131,14,822,266871715,11139289217,11406160932,299,821,8,10872417502,In > Out
Sept 2021,131,140,1293,737770169,6375329175,7113099344,275,1276,6,5637559006,In > Out
Sept 2021,131,141,1242,204239947,3659505050,3863744997,298,1198,20,3455265103,In > Out
Sept 2021,131,142,432,272084572,1365923590,1638008162,183,428,9,1093839018,In > Out
Sept 2021,131,143,579,426857367,1705839977,2132697344,174,579,4,1278982610,In > Out
Sept 2021,131,145,1628,2042493982,8123603629,10166097611,360,1588,26,6081109647,In > Out
Sept 2021,131,147,562,417504138,2897343879,3314848017,229,554,5,2479839741,In > Out
Sept 2021,131,150,383,270613074,1590847264,1861460338,181,380,8,1320234190,In > Out
Sept 2021,131,151,383,107119653,984016198,1091135851,143,382,4,876896545,In > Out
Sept 2021,131,152,259,148940714,730164660,879105374,114,247,7,581223946,In > Out
Sept 2021,131,154,518,315071415,1214736371,1529807786,131,516,5,899664956,In > Out
Sept 2021,131,155,774,1666847784,6158734987,7825582771,205,762,5,4491887203,In > Out
Sept 2021,131,156,788,869825279,2367481831,3237307110,328,776,15,1497656552,In > Out
Sept 2021,131,159,1255,237952771,6096871019,6334823790,411,1213,4,5858918248,In > Out
Sept 2021,131,162,531,146635552,1198591597,1345227149,206,525,7,1051956045,In > Out
Sept 2021,131,163,571,92786216,3232876164,3325662380,194,559,5,3140089948,In > Out
Sept 2021,131,167,272,44650836,674385884,719036720,113,271,3,629735048,In > Out
Sept 2021,131,172,453,38685233,985255303,1023940536,153,447,8,946570070,In > Out
Sept 2021,131,175,610,275035403,4173365228,4448400631,229,593,4,3898329825,In > Out
Sept 2021,131,176,813,152282281,1376229478,1528511759,197,811,7,1223947197,In > Out
Sept 2021,131,177,871,95063475,2227120839,2322184314,265,847,6,2132057364,In > Out
Sept 2021,131,178,1101,199664599,4478290339,4677954938,249,1062,4,4278625740,In > Out
Sept 2021,131,179,360,4418206355,7069948762,11488155117,153,357,10,2651742407,In > Out
Sept 2021,131,18,280,584122104,1126375404,1710497508,123,274,7,542253300,In > Out
Sept 2021,131,180,752,80425338,1388576446,1469001784,321,736,5,1308151108,In > Out
Sept 2021,131,181,602,52693375,1971043109,2023736484,171,592,6,1918349734,In > Out
Sept 2021,131,183,1594,1189577952,15052750394,16242328346,352,1536,30,13863172442,In > Out
Sept 2021,131,185,668,57760990,791405410,849166400,180,661,4,733644420,In > Out
Sept 2021,131,186,2150,1789892682,10985673642,12775566324,555,1852,50,9195780960,In > Out
Sept 2021,131,188,684,1078247461,6288939825,7367187286,263,675,14,5210692364,In > Out
Sept 2021,131,189,466,371838348,39525042317,39896880665,165,465,5,39153203969,In > Out
Sept 2021,131,192,305,24215716,1229807561,1254023277,103,304,4,1205591845,In > Out
Sept 2021,131,193,202,975190813,1459991881,2435182694,102,201,4,484801068,In > Out
Sept 2021,131,194,1334,223806970,6203575607,6427382577,361,1300,8,5979768637,In > Out
Sept 2021,131,196,832,106176976,2224278168,2330455144,304,820,9,2118101192,In > Out
Sept 2021,131,197,129,16140538,129526503,145667041,37,129,4,113385965,In > Out
Sept 2021,131,198,1496,581917691,28901838908,29483756599,331,1441,7,28319921217,In > Out
Sept 2021,131,199,1661,282899015,6387177801,6670076816,299,1483,7,6104278786,In > Out
Sept 2021,131,20,401,55234817,2271493605,2326728422,176,397,5,2216258788,In > Out
Sept 2021,131,201,283,953106511,2219977700,3173084211,105,281,5,1266871189,In > Out
Sept 2021,131,203,1638,482178514,10356715770,10838894284,513,1596,7,9874537256,In > Out
Sept 2021,131,205,1398,552605133,5453036062,6005641195,379,1348,8,4900430929,In > Out
Sept 2021,131,206,360,68397749,913228770,981626519,135,358,4,844831021,In > Out
Sept 2021,131,207,63,1220456749,1880031263,3100488012,46,61,6,659574514,In > Out
Sept 2021,131,208,496,103599499,2286403814,2390003313,200,488,9,2182804315,In > Out
Sept 2021,131,21,320,89875593,1315344932,1405220525,141,319,8,1225469339,In > Out
Sept 2021,131,210,1128,261014427,13476196943,13737211370,266,1102,5,13215182516,In > Out
Sept 2021,131,211,938,345747648,4320594064,4666341712,334,921,6,3974846416,In > Out
Sept 2021,131,212,602,1086743466,6703604658,7790348124,199,598,7,5616861192,In > Out
Sept 2021,131,214,1278,281358192,7891519770,8172877962,231,1220,10,7610161578,In > Out
Sept 2021,131,217,406,139118587,4834655731,4973774318,149,402,2,4695537144,In > Out
Sept 2021,131,218,776,1642577970,14173799843,15816377813,267,763,6,12531221873,In > Out
Sept 2021,131,219,1730,263256123,3046493153,3309749276,390,1687,5,2783237030,In > Out
Sept 2021,131,220,836,1012861754,2169614448,3182476202,318,758,97,1156752694,In > Out
Sept 2021,131,222,176,18987675,408963250,427950925,74,176,4,389975575,In > Out
Sept 2021,131,23,961,618357306,2755673708,3374031014,224,936,9,2137316402,In > Out
Sept 2021,131,24,631,578821328,2097448316,2676269644,223,627,7,1518626988,In > Out
Sept 2021,131,27,949,269540776,3584835539,3854376315,234,921,8,3315294763,In > Out
Sept 2021,131,28,705,810162643,1937534768,2747697411,284,700,2,1127372125,In > Out
Sept 2021,131,29,1294,157837665,5960361663,6118199328,305,1223,12,5802523998,In > Out
Sept 2021,131,30,971,231454884,7719086941,7950541825,203,946,4,7487632057,In > Out
Sept 2021,131,32,272,38115744,254845343,292961087,70,272,4,216729599,In > Out
Sept 2021,131,33,1556,605868728,11626581589,12232450317,464,1520,7,11020712861,In > Out
Sept 2021,131,34,1611,909893563,6128614365,7038507928,372,1543,7,5218720802,In > Out
Sept 2021,131,35,317,30845656,738398687,769244343,172,314,2,707553031,In > Out
Sept 2021,131,36,2144,1874196489,38821943909,40696140398,536,2042,6,36947747420,In > Out
Sept 2021,131,37,292,52501686,2956865827,3009367513,121,292,5,2904364141,In > Out
Sept 2021,131,39,730,98414256,3863601428,3962015684,216,720,4,3765187172,In > Out
Sept 2021,131,40,695,156422069,2506381718,2662803787,195,682,4,2349959649,In > Out
Sept 2021,131,41,273,25556200,337878850,363435050,95,270,5,312322650,In > Out
Sept 2021,131,42,603,116299428,3053914278,3170213706,256,600,4,2937614850,In > Out
Sept 2021,131,45,857,278210130,2653279089,2931489219,246,828,3,2375068959,In > Out
Sept 2021,131,46,506,551723611,4117954726,4669678337,198,502,5,3566231115,In > Out
Sept 2021,131,48,586,359173312,11780319277,12139492589,189,575,5,11421145965,In > Out
Sept 2021,131,49,825,186371673,2522012616,2708384289,259,809,4,2335640943,In > Out
Sept 2021,131,52,754,92325455,2067309977,2159635432,202,738,9,1974984522,In > Out
Sept 2021,131,53,326,329182776,1652995460,1982178236,139,326,4,1323812684,In > Out
Sept 2021,131,54,670,618914164,2141858509,2760772673,236,667,5,1522944345,In > Out
Sept 2021,131,55,371,86073642,922913111,1008986753,141,368,4,836839469,In > Out
Sept 2021,131,56,332,257559051,1091629268,1349188319,107,326,4,834070217,In > Out
Sept 2021,131,57,206,45359575,1012062471,1057422046,77,206,4,966702896,In > Out
Sept 2021,131,59,804,320418501,3063877785,3384296286,277,783,7,2743459284,In > Out
Sept 2021,131,61,2067,1467763315,5364501556,6832264871,324,1975,10,3896738241,In > Out
Sept 2021,131,62,1865,2794258033,8183287770,10977545803,323,1749,15,5389029737,In > Out
Sept 2021,131,64,627,107837292,3062763357,3170600649,262,624,5,2954926065,In > Out
Sept 2021,131,66,417,90936042,5700970932,5791906974,147,417,4,5610034890,In > Out
Sept 2021,131,67,445,107590191,1325802105,1433392296,117,439,7,1218211914,In > Out
Sept 2021,131,72,614,113900478,4249716216,4363616694,151,610,3,4135815738,In > Out
Sept 2021,131,73,807,173782798,4508628095,4682410893,188,793,7,4334845297,In > Out
Sept 2021,131,74,1062,193462434,4852812008,5046274442,283,1048,4,4659349574,In > Out
Sept 2021,131,75,916,2102037119,3798631387,5900668506,228,908,9,1696594268,In > Out
Sept 2021,131,76,1947,3610541669,3935932368,7546474037,326,1867,11,325390699,In > Out
Sept 2021,131,77,516,93656123,3091785674,3185441797,217,511,5,2998129551,In > Out
Sept 2021,131,78,993,6760115798,8842850766,15602966564,295,951,13,2082734968,In > Out
Sept 2021,131,79,2270,283617078,6379201368,6662818446,372,1970,5,6095584290,In > Out
Sept 2021,131,8,1014,282114710,11808884738,12090999448,284,986,6,11526770028,In > Out
Sept 2021,131,83,637,738162373,11183659107,11921821480,243,621,15,10445496734,In > Out
Sept 2021,131,85,639,1548867168,1279156327,2828023495,115,617,4,269710841,Out > In
Sept 2021,131,86,706,344398855,15468187334,15812586189,220,665,2,15123788479,In > Out
Sept 2021,131,87,778,540928421,2707184247,3248112668,217,767,7,2166255826,In > Out
Sept 2021,131,90,802,109178759,4048023014,4157201773,155,785,5,3938844255,In > Out
Sept 2021,131,91,301,119065379,4627836916,4746902295,132,298,2,4508771537,In > Out
Sept 2021,131,92,1522,540577887,21895534440,22436112327,401,1459,12,21354956553,In > Out
Sept 2021,131,94,495,1568922124,2489317240,4058239364,170,475,4,920395116,In > Out
Sept 2021,131,97,989,135083399,2418004353,2553087752,239,962,5,2282920954,In > Out
Sept 2021,131,98,723,190866642,2818099901,3008966543,273,716,11,2627233259,In > Out
Sept 2021,132,10,579,140058370,7904142545,8044200915,187,571,4,7764084175,In > Out
Sept 2021,132,100,1058,108243817,2599288202,2707532019,347,1030,6,2491044385,In > Out
Sept 2021,132,101,862,300221773,2766174247,3066396020,231,849,3,2465952474,In > Out
Sept 2021,132,102,607,168561155,1356131453,1524692608,213,587,5,1187570298,In > Out
Sept 2021,132,105,1235,419419080,11720560998,12139980078,372,1215,5,11301141918,In > Out
Sept 2021,132,106,1974,479807272,6600039488,7079846760,346,1920,7,6120232216,In > Out
Sept 2021,132,108,200,35450765,1446301436,1481752201,108,197,4,1410850671,In > Out
Sept 2021,132,11,870,357200703,2474338105,2831538808,246,860,10,2117137402,In > Out
Sept 2021,132,110,1122,397816821,6776657612,7174474433,311,1084,37,6378840791,In > Out
Sept 2021,132,112,333,33478465,2270103214,2303581679,145,327,12,2236624749,In > Out
Sept 2021,132,113,233,37655979,1049228260,1086884239,123,227,4,1011572281,In > Out
Sept 2021,132,116,1175,1640916719,77499778680,79140695399,204,1139,9,75858861961,In > Out
Sept 2021,132,117,189,72468205,262152035,334620240,69,189,4,189683830,In > Out
Sept 2021,132,118,1228,118701532,2978316298,3097017830,168,1037,3,2859614766,In > Out
Sept 2021,132,119,688,127477157,2535866652,2663343809,189,654,6,2408389495,In > Out
Sept 2021,132,12,760,48526172,1051390952,1099917124,297,753,7,1002864780,In > Out
Sept 2021,132,120,644,58838972,1634706352,1693545324,115,640,3,1575867380,In > Out
Sept 2021,132,121,455,153467186,1051404868,1204872054,211,452,6,897937682,In > Out
Sept 2021,132,122,514,863289439,5840152185,6703441624,231,507,11,4976862746,In > Out
Sept 2021,132,123,417,58554289,4050086964,4108641253,145,414,2,3991532675,In > Out
Sept 2021,132,124,2163,760432896,10211651625,10972084521,438,2025,16,9451218729,In > Out
Sept 2021,132,127,776,115690565,1839020311,1954710876,221,757,7,1723329746,In > Out
Sept 2021,132,128,1020,159654707,3856805857,4016460564,276,998,6,3697151150,In > Out
Sept 2021,132,129,626,204102267,2881693487,3085795754,202,615,16,2677591220,In > Out
Sept 2021,132,132,312,24462459,692775267,717237726,104,307,3,668312808,In > Out
Sept 2021,132,134,754,600948604,1585269273,2186217877,208,751,5,984320669,In > Out
Sept 2021,132,135,478,78697860,2668910286,2747608146,161,478,4,2590212426,In > Out
Sept 2021,132,137,1034,275858710,6749419922,7025278632,384,1006,10,6473561212,In > Out
Sept 2021,132,139,1086,163658138,13916499370,14080157508,306,1065,5,13752841232,In > Out
Sept 2021,132,14,1492,231795508,8701328317,8933123825,385,1455,5,8469532809,In > Out
Sept 2021,132,140,395,40711527,1104268012,1144979539,115,387,3,1063556485,In > Out
Sept 2021,132,141,596,265736590,37267148551,37532885141,200,584,2,37001411961,In > Out
Sept 2021,132,143,1678,1089270358,12275195810,13364466168,449,1594,14,11185925452,In > Out
Sept 2021,132,145,840,78547854,2449271996,2527819850,255,830,5,2370724142,In > Out
Sept 2021,132,147,3908,1104865973,75256928547,76361794520,581,3488,17,74152062574,In > Out
Sept 2021,132,148,975,415321748,2860568320,3275890068,252,953,7,2445246572,In > Out
Sept 2021,132,150,253,18911213,550076559,568987772,71,252,3,531165346,In > Out
Sept 2021,132,151,334,294910880,2281385212,2576296092,144,333,5,1986474332,In > Out
Sept 2021,132,152,1362,447547628,11732842305,12180389933,361,1310,4,11285294677,In > Out
Sept 2021,132,153,455,43895119,841887588,885782707,113,434,19,797992469,In > Out
Sept 2021,132,154,823,115411913,2748170075,2863581988,176,816,5,2632758162,In > Out
Sept 2021,132,155,555,60346201,2581274308,2641620509,234,546,4,2520928107,In > Out
Sept 2021,132,157,243,35168731,1404132574,1439301305,94,243,3,1368963843,In > Out
Sept 2021,132,158,1125,398871108,5665916709,6064787817,248,1104,12,5267045601,In > Out
Sept 2021,132,162,112,115411389,116912408,232323797,53,112,3,1501019,In > Out
Sept 2021,132,164,551,960591117,1991832071,2952423188,298,541,5,1031240954,In > Out
Sept 2021,132,165,811,182897695,5422452960,5605350655,224,802,4,5239555265,In > Out
Sept 2021,132,166,1263,1339150055,14157832565,15496982620,293,1232,9,12818682510,In > Out
Sept 2021,132,168,522,1076285563,1773473168,2849758731,154,510,10,697187605,In > Out
Sept 2021,132,169,651,51703153,998191644,1049894797,246,641,8,946488491,In > Out
Sept 2021,132,17,481,190454697,2291496261,2481950958,171,478,8,2101041564,In > Out
Sept 2021,132,170,596,201645356,2677355044,2879000400,173,587,7,2475709688,In > Out
Sept 2021,132,171,791,149063101,2782350801,2931413902,258,775,4,2633287700,In > Out
Sept 2021,132,172,2063,375529121,8790241289,9165770410,406,1963,9,8414712168,In > Out
Sept 2021,132,173,795,265468302,4283033240,4548501542,195,778,20,4017564938,In > Out
Sept 2021,132,174,1295,267135597,3644244792,3911380389,414,1260,8,3377109195,In > Out
Sept 2021,132,175,344,59119304,5425880759,5485000063,119,343,4,5366761455,In > Out
Sept 2021,132,176,1311,658286401,10280572371,10938858772,318,1271,10,9622285970,In > Out
Sept 2021,132,178,1357,271742541,7776909531,8048652072,428,1324,6,7505166990,In > Out
Sept 2021,132,179,661,505066107,12143568830,12648634937,253,641,16,11638502723,In > Out
Sept 2021,132,18,622,340071662,1473600169,1813671831,202,609,3,1133528507,In > Out
Sept 2021,132,181,1561,460620098,5178672997,5639293095,333,1511,20,4718052899,In > Out
Sept 2021,132,182,478,29336210,1093666324,1123002534,135,468,4,1064330114,In > Out
Sept 2021,132,183,230,23815079,396652094,420467173,69,229,4,372837015,In > Out
Sept 2021,132,184,3686,1087864798,75634388340,76722253138,165,3587,6,74546523542,In > Out
Sept 2021,132,185,329,17506545,1067284031,1084790576,117,329,2,1049777486,In > Out
Sept 2021,132,186,1749,2582536744,17109033260,19691570004,394,1668,29,14526496516,In > Out
Sept 2021,132,187,340,417910987,3145377389,3563288376,178,337,5,2727466402,In > Out
Sept 2021,132,19,1236,849063456,3032953802,3882017258,322,1204,4,2183890346,In > Out
Sept 2021,132,190,747,265955518,6058885547,6324841065,268,730,4,5792930029,In > Out
Sept 2021,132,191,2864,329047685,19553713227,19882760912,530,2721,7,19224665542,In > Out
Sept 2021,132,193,583,50804537,1553516697,1604321234,228,562,3,1502712160,In > Out
Sept 2021,132,194,864,146033525,5124830163,5270863688,176,843,4,4978796638,In > Out
Sept 2021,132,196,54,13337900,97045545,110383445,27,54,1,83707645,In > Out
Sept 2021,132,197,478,264121941,32037232140,32301354081,131,476,3,31773110199,In > Out
Sept 2021,132,20,327,34764095,1359031227,1393795322,119,323,2,1324267132,In > Out
Sept 2021,132,200,360,147574449,482924208,630498657,188,359,4,335349759,In > Out
Sept 2021,132,201,1117,214300113,1652296365,1866596478,278,1102,6,1437996252,In > Out
Sept 2021,132,202,1398,132103153,7266443992,7398547145,288,1354,6,7134340839,In > Out
Sept 2021,132,203,386,387315942,4625465210,5012781152,167,380,6,4238149268,In > Out
Sept 2021,132,204,931,79836454,4279368039,4359204493,131,922,2,4199531585,In > Out
Sept 2021,132,205,1032,4050089267,16468144324,20518233591,268,1007,7,12418055057,In > Out
Sept 2021,132,206,99,433563936,677633782,1111197718,52,97,4,244069846,In > Out
Sept 2021,132,214,1814,352489018,12209871030,12562360048,440,1733,6,11857382012,In > Out
Sept 2021,132,215,201,42661165,151147373,193808538,54,199,3,108486208,In > Out
Sept 2021,132,216,1967,2984090504,37203592749,40187683253,480,1828,32,34219502245,In > Out
Sept 2021,132,219,219,45229125,1424422770,1469651895,130,219,6,1379193645,In > Out
Sept 2021,132,22,898,49166569,1367378281,1416544850,194,892,4,1318211712,In > Out
Sept 2021,132,220,1008,72922935,4101274125,4174197060,261,975,4,4028351190,In > Out
Sept 2021,132,221,690,967827048,11751755826,12719582874,285,679,6,10783928778,In > Out
Sept 2021,132,222,1125,112374749,4328574951,4440949700,306,1098,4,4216200202,In > Out
Sept 2021,132,223,710,670979745,10951519416,11622499161,192,666,10,10280539671,In > Out
Sept 2021,132,23,909,189855251,4291192046,4481047297,254,907,4,4101336795,In > Out
Sept 2021,132,25,599,1209268365,13610454405,14819722770,192,599,8,12401186040,In > Out
Sept 2021,132,26,228,42636427,760459171,803095598,83,228,3,717822744,In > Out
Sept 2021,132,27,678,481069371,4534766053,5015835424,189,671,10,4053696682,In > Out
Sept 2021,132,28,1344,496695185,4244039750,4740734935,287,1320,8,3747344565,In > Out
Sept 2021,132,29,672,408273945,2845104302,3253378247,233,658,7,2436830357,In > Out
Sept 2021,132,30,1012,216677368,4727014741,4943692109,266,996,6,4510337373,In > Out
Sept 2021,132,31,503,115856641,4865569868,4981426509,172,480,12,4749713227,In > Out
Sept 2021,132,32,1708,2647646028,29401091318,32048737346,394,1634,7,26753445290,In > Out
Sept 2021,132,33,329,28942073,1073472054,1102414127,122,328,1,1044529981,In > Out
Sept 2021,132,34,179,59573275,2171248361,2230821636,73,179,2,2111675086,In > Out
Sept 2021,132,35,446,117386325,5821092250,5938478575,118,445,7,5703705925,In > Out
Sept 2021,132,36,374,108737618,2339669285,2448406903,209,374,2,2230931667,In > Out
Sept 2021,132,4,1339,276777109,7815246295,8092023404,306,1295,4,7538469186,In > Out
Sept 2021,132,40,296,85937862,2071943075,2157880937,91,294,3,1986005213,In > Out
Sept 2021,132,41,345,131090964,986694706,1117785670,110,343,8,855603742,In > Out
Sept 2021,132,42,1729,621990881,11223715743,11845706624,575,1630,4,10601724862,In > Out
Sept 2021,132,43,637,167973370,4646034386,4814007756,202,633,5,4478061016,In > Out
Sept 2021,132,44,629,3697833508,6490211306,10188044814,235,620,11,2792377798,In > Out
Sept 2021,132,46,1416,350305918,4908945629,5259251547,438,1386,93,4558639711,In > Out
Sept 2021,132,48,873,84405777,3048671130,3133076907,228,855,6,2964265353,In > Out
Sept 2021,132,49,1758,271873587,4924716881,5196590468,311,1740,7,4652843294,In > Out
Sept 2021,132,5,608,637641199,2902234128,3539875327,199,599,5,2264592929,In > Out
Sept 2021,132,50,282,78197337,1023861191,1102058528,106,279,4,945663854,In > Out
Sept 2021,132,51,977,466197630,55848763464,56314961094,219,941,5,55382565834,In > Out
Sept 2021,132,54,519,116644081,1447094482,1563738563,235,519,3,1330450401,In > Out
Sept 2021,132,55,440,65565714,1480453820,1546019534,186,438,4,1414888106,In > Out
Sept 2021,132,56,919,125667677,5108128960,5233796637,330,900,3,4982461283,In > Out
Sept 2021,132,57,530,49834255,1138724384,1188558639,225,511,3,1088890129,In > Out
Sept 2021,132,58,1911,265545703,4100687606,4366233309,308,1793,23,3835141903,In > Out
Sept 2021,132,59,1246,98014338,5489972567,5587986905,224,1209,5,5391958229,In > Out
Sept 2021,132,6,595,95746200,6531562318,6627308518,242,587,4,6435816118,In > Out
Sept 2021,132,60,146,43322667,467619407,510942074,68,146,10,424296740,In > Out
Sept 2021,132,61,959,157831886,4812473352,4970305238,237,934,6,4654641466,In > Out
Sept 2021,132,62,1570,281637128,51088154305,51369791433,299,1531,3,50806517177,In > Out
Sept 2021,132,63,990,870836170,2071982383,2942818553,274,962,8,1201146213,In > Out
Sept 2021,132,65,100,15435240,372504120,387939360,59,100,1,357068880,In > Out
Sept 2021,132,66,1936,285043470,9375623383,9660666853,478,1893,4,9090579913,In > Out
Sept 2021,132,67,1037,136143041,2176144311,2312287352,401,1020,4,2040001270,In > Out
Sept 2021,132,68,579,460743818,3357912851,3818656669,213,572,7,2897169033,In > Out
Sept 2021,132,7,336,154831341,574906501,729737842,137,335,4,420075160,In > Out
Sept 2021,132,70,134,16153375,1125388829,1141542204,60,134,3,1109235454,In > Out
Sept 2021,132,71,1121,258449872,4868061192,5126511064,305,1098,7,4609611320,In > Out
Sept 2021,132,72,389,29862620,3487957703,3517820323,107,388,2,3458095083,In > Out
Sept 2021,132,73,514,2109594606,2270994054,4380588660,139,509,4,161399448,In > Out
Sept 2021,132,74,1222,493471581,4111033468,4604505049,389,1191,7,3617561887,In > Out
Sept 2021,132,75,344,162203138,724488659,886691797,115,343,2,562285521,In > Out
Sept 2021,132,77,887,1059864440,4430145394,5490009834,242,850,9,3370280954,In > Out
Sept 2021,132,78,406,49985582,1889006412,1938991994,144,405,6,1839020830,In > Out
Sept 2021,132,79,1475,872545233,14496653099,15369198332,184,1443,5,13624107866,In > Out
Sept 2021,132,80,296,93406037,1798936789,1892342826,123,295,1,1705530752,In > Out
Sept 2021,132,82,93,7231656,89269579,96501235,64,92,3,82037923,In > Out
Sept 2021,132,83,1419,1143015083,33969628947,35112644030,376,1387,11,32826613864,In > Out
Sept 2021,132,85,781,182112344,5360469356,5542581700,272,774,6,5178357012,In > Out
Sept 2021,132,86,884,2300979374,6335618863,8636598237,307,864,9,4034639489,In > Out
Sept 2021,132,87,539,160456323,890852409,1051308732,199,531,11,730396086,In > Out
Sept 2021,132,88,505,10418854378,12969543730,23388398108,77,500,7,2550689352,In > Out
Sept 2021,132,89,434,34414281,1209702189,1244116470,159,429,8,1175287908,In > Out
Sept 2021,132,9,248,47263374,1635317316,1682580690,98,247,4,1588053942,In > Out
Sept 2021,132,93,338,63322392,1658419768,1721742160,126,338,3,1595097376,In > Out
Sept 2021,132,95,1395,99028153,2308839210,2407867363,438,1383,2,2209811057,In > Out
Sept 2021,132,96,602,68284918,3276661862,3344946780,229,590,7,3208376944,In > Out
Sept 2021,132,97,965,340055813,2870099368,3210155181,330,944,6,2530043555,In > Out
Sept 2021,132,99,945,2165185198,30814200402,32979385600,261,922,5,28649015204,In > Out
Sept 2021,133,100,470,45263731,2515931460,2561195191,216,468,4,2470667729,In > Out
Sept 2021,133,103,658,82085967,3020972584,3103058551,189,649,3,2938886617,In > Out
Sept 2021,133,104,441,454543590,606771433,1061315023,141,436,8,152227843,In > Out
Sept 2021,133,106,604,190984428,1766496599,1957481027,169,593,4,1575512171,In > Out
Sept 2021,133,107,645,235900968,2226078978,2461979946,207,640,10,1990178010,In > Out
Sept 2021,133,11,1209,2099552241,7711867588,9811419829,299,1166,8,5612315347,In > Out
Sept 2021,133,113,454,74987708,696881233,771868941,186,451,4,621893525,In > Out
Sept 2021,133,114,1279,244053179,4096529328,4340582507,204,1276,10,3852476149,In > Out
Sept 2021,133,116,1514,737695276,18569555801,19307251077,410,1465,6,17831860525,In > Out
Sept 2021,133,118,1057,123084675,6253133450,6376218125,305,1038,6,6130048775,In > Out
Sept 2021,133,119,2749,1876010034,41769725524,43645735558,540,2681,5,39893715490,In > Out
Sept 2021,133,121,785,68833691,2942142277,3010975968,264,776,5,2873308586,In > Out
Sept 2021,133,123,1618,629249149,4242009832,4871258981,349,1571,5,3612760683,In > Out
Sept 2021,133,125,912,429025715,2536197424,2965223139,228,896,10,2107171709,In > Out
Sept 2021,133,126,1027,1329968439,71740665234,73070633673,268,1020,9,70410696795,In > Out
Sept 2021,133,127,1118,104793200,3602417660,3707210860,258,1101,25,3497624460,In > Out
Sept 2021,133,128,943,49664071,3196416978,3246081049,151,933,5,3146752907,In > Out
Sept 2021,133,129,354,707572342,2437787608,3145359950,201,352,2,1730215266,In > Out
Sept 2021,133,130,1603,664968524,6186130279,6851098803,536,1551,18,5521161755,In > Out
Sept 2021,133,131,445,344435309,8731667140,9076102449,173,443,9,8387231831,In > Out
Sept 2021,133,132,1117,1211322072,7717460826,8928782898,409,1095,15,6506138754,In > Out
Sept 2021,133,135,1013,1369833627,5330093651,6699927278,221,980,6,3960260024,In > Out
Sept 2021,133,136,769,311618340,8679843338,8991461678,262,758,9,8368224998,In > Out
Sept 2021,133,137,1039,805877716,4444724210,5250601926,307,978,18,3638846494,In > Out
Sept 2021,133,138,137,211461916,1511746370,1723208286,75,136,6,1300284454,In > Out
Sept 2021,133,139,701,111438219,3442905111,3554343330,273,691,6,3331466892,In > Out
Sept 2021,133,14,166,26857547,2867523098,2894380645,85,166,3,2840665551,In > Out
Sept 2021,133,140,972,236995226,4027555960,4264551186,221,960,8,3790560734,In > Out
Sept 2021,133,142,424,815949689,2817438635,3633388324,124,415,5,2001488946,In > Out
Sept 2021,133,147,908,549673530,5545600272,6095273802,179,892,11,4995926742,In > Out
Sept 2021,133,149,840,267255275,2501472277,2768727552,225,824,5,2234217002,In > Out
Sept 2021,133,15,2053,1272673490,26975614977,28248288467,486,1940,23,25702941487,In > Out
Sept 2021,133,150,686,354424723,4212870683,4567295406,217,667,8,3858445960,In > Out
Sept 2021,133,152,1233,2284630700,6905235196,9189865896,333,1169,6,4620604496,In > Out
Sept 2021,133,153,788,1070762879,11323953182,12394716061,346,783,5,10253190303,In > Out
Sept 2021,133,155,353,36039720,421700142,457739862,84,353,5,385660422,In > Out
Sept 2021,133,156,1127,143064308,4588536009,4731600317,350,1095,5,4445471701,In > Out
Sept 2021,133,157,854,90160243,2730797649,2820957892,223,850,5,2640637406,In > Out
Sept 2021,133,159,431,508646232,728651740,1237297972,163,429,4,220005508,In > Out
Sept 2021,133,16,675,2461337561,2726766020,5188103581,163,667,8,265428459,In > Out
Sept 2021,133,160,868,185498545,2055790007,2241288552,329,867,3,1870291462,In > Out
Sept 2021,133,163,566,190546469,1758474549,1949021018,214,556,4,1567928080,In > Out
Sept 2021,133,164,1227,1015543961,3653787201,4669331162,294,1205,8,2638243240,In > Out
Sept 2021,133,165,2158,2088759937,8238769388,10327529325,538,2040,92,6150009451,In > Out
Sept 2021,133,168,156,18429940,273462739,291892679,63,156,4,255032799,In > Out
Sept 2021,133,169,477,225749700,14461946692,14687696392,157,469,2,14236196992,In > Out
Sept 2021,133,17,151,41277789,3058069076,3099346865,86,150,2,3016791287,In > Out
Sept 2021,133,171,1519,994316318,13395110190,14389426508,309,1496,5,12400793872,In > Out
Sept 2021,133,175,602,182846131,7400715305,7583561436,328,594,5,7217869174,In > Out
Sept 2021,133,176,2339,473200635,7120153333,7593353968,277,2232,8,6646952698,In > Out
Sept 2021,133,177,797,90550927,2094648962,2185199889,293,789,5,2004098035,In > Out
Sept 2021,133,178,1521,1310551409,11846544702,13157096111,504,1468,9,10535993293,In > Out
Sept 2021,133,179,955,3492501371,14628150844,18120652215,315,922,14,11135649473,In > Out
Sept 2021,133,18,643,48303175,2255767294,2304070469,250,632,3,2207464119,In > Out
Sept 2021,133,183,1136,110417993,2794595029,2905013022,324,1118,9,2684177036,In > Out
Sept 2021,133,186,1265,186241382,5484160704,5670402086,322,1232,6,5297919322,In > Out
Sept 2021,133,188,884,626511702,4455635080,5082146782,309,872,10,3829123378,In > Out
Sept 2021,133,189,1114,301333284,3758466627,4059799911,329,1063,6,3457133343,In > Out
Sept 2021,133,19,637,633650383,6791348894,7424999277,201,617,9,6157698511,In > Out
Sept 2021,133,192,944,680536066,21074233993,21754770059,206,915,7,20393697927,In > Out
Sept 2021,133,193,469,168436677,1727357503,1895794180,186,458,5,1558920826,In > Out
Sept 2021,133,195,3679,23153886801,15867967224,39021854025,788,3375,39,7285919577,Out > In
Sept 2021,133,198,954,125750853,1929289360,2055040213,202,925,3,1803538507,In > Out
Sept 2021,133,199,102,987473885,1318288706,2305762591,54,101,3,330814821,In > Out
Sept 2021,133,201,1181,224570542,3910444204,4135014746,390,1150,4,3685873662,In > Out
Sept 2021,133,203,1139,449847986,4170015717,4619863703,259,1123,5,3720167731,In > Out
Sept 2021,133,204,2243,644102097,9225182325,9869284422,433,2141,9,8581080228,In > Out
Sept 2021,133,206,264,39433292,1735299729,1774733021,120,261,1,1695866437,In > Out
Sept 2021,133,207,536,379577325,3524635742,3904213067,167,529,5,3145058417,In > Out
Sept 2021,133,208,804,72291230,3125932972,3198224202,269,784,10,3053641742,In > Out
Sept 2021,133,21,4861,2908869061,105998030802,108906899863,353,4261,19,103089161741,In > Out
Sept 2021,133,211,682,142938197,1233451887,1376390084,239,673,8,1090513690,In > Out
Sept 2021,133,213,664,306820163,3671277646,3978097809,204,664,8,3364457483,In > Out
Sept 2021,133,216,439,628912157,1398004314,2026916471,173,436,5,769092157,In > Out
Sept 2021,133,217,488,785594689,2375956356,3161551045,214,477,11,1590361667,In > Out
Sept 2021,133,218,2013,821679594,31938463855,32760143449,554,1922,5,31116784261,In > Out
Sept 2021,133,220,1020,533409518,9375193534,9908603052,400,1006,6,8841784016,In > Out
Sept 2021,133,221,746,132755643,3358870945,3491626588,288,727,3,3226115302,In > Out
Sept 2021,133,222,305,51811871,1278009118,1329820989,109,303,3,1226197247,In > Out
Sept 2021,133,223,404,2563590294,1938687926,4502278220,120,404,8,624902368,Out > In
Sept 2021,133,25,370,171463402,1050601259,1222064661,104,367,7,879137857,In > Out
Sept 2021,133,26,461,351951157,1423098169,1775049326,192,460,7,1071147012,In > Out
Sept 2021,133,27,933,320930169,9357412626,9678342795,232,915,3,9036482457,In > Out
Sept 2021,133,28,815,47478207,2522377757,2569855964,237,795,5,2474899550,In > Out
Sept 2021,133,30,791,144761884,3736216280,3880978164,292,772,9,3591454396,In > Out
Sept 2021,133,31,695,342249326,4471787535,4814036861,219,690,6,4129538209,In > Out
Sept 2021,133,32,1019,375494845,11125639995,11501134840,283,1012,5,10750145150,In > Out
Sept 2021,133,33,1555,2948724142,19340274361,22288998503,371,1494,11,16391550219,In > Out
Sept 2021,133,36,1794,336568044,7971928361,8308496405,353,1588,5,7635360317,In > Out
Sept 2021,133,37,2711,1083508998,5875607188,6959116186,1227,2534,800,4792098190,In > Out
Sept 2021,133,4,181,25025685,1386838218,1411863903,75,181,2,1361812533,In > Out
Sept 2021,133,40,458,142301569,6139313727,6281615296,146,456,8,5997012158,In > Out
Sept 2021,133,44,1441,1047752717,11229108880,12276861597,347,1409,9,10181356163,In > Out
Sept 2021,133,45,1224,1666708638,5196450131,6863158769,303,1178,7,3529741493,In > Out
Sept 2021,133,46,637,101923691,3488701883,3590625574,204,623,7,3386778192,In > Out
Sept 2021,133,47,377,79920117,586093715,666013832,194,373,5,506173598,In > Out
Sept 2021,133,48,702,371421113,5183865317,5555286430,191,687,5,4812444204,In > Out
Sept 2021,133,54,173,580539338,902426622,1482965960,89,168,5,321887284,In > Out
Sept 2021,133,55,590,70058468,3854304601,3924363069,203,585,6,3784246133,In > Out
Sept 2021,133,56,670,318703808,3212768928,3531472736,219,662,8,2894065120,In > Out
Sept 2021,133,57,781,470939116,7102844575,7573783691,156,775,3,6631905459,In > Out
Sept 2021,133,59,521,93983098,1272266992,1366250090,121,511,12,1178283894,In > Out
Sept 2021,133,60,621,205291006,2018477658,2223768664,236,612,3,1813186652,In > Out
Sept 2021,133,61,775,83368184,836633254,920001438,217,774,5,753265070,In > Out
Sept 2021,133,62,546,438979518,2314949626,2753929144,194,537,7,1875970108,In > Out
Sept 2021,133,63,518,229873302,4942249590,5172122892,169,518,5,4712376288,In > Out
Sept 2021,133,64,952,227783499,7630634932,7858418431,285,922,9,7402851433,In > Out
Sept 2021,133,69,551,94925749,1724659728,1819585477,200,543,3,1629733979,In > Out
Sept 2021,133,70,1497,595805203,19087813285,19683618488,460,1445,10,18492008082,In > Out
Sept 2021,133,74,242,69958198,1106807590,1176765788,100,242,10,1036849392,In > Out
Sept 2021,133,75,386,117238650,802088601,919327251,137,376,7,684849951,In > Out
Sept 2021,133,77,661,95332670,5156399377,5251732047,211,658,3,5061066707,In > Out
Sept 2021,133,81,730,182086070,3834640343,4016726413,256,724,4,3652554273,In > Out
Sept 2021,133,84,518,178679572,1812507659,1991187231,232,505,9,1633828087,In > Out
Sept 2021,133,86,252,80402919,1523864894,1604267813,128,252,3,1443461975,In > Out
Sept 2021,133,87,380,67369215,667719557,735088772,162,376,4,600350342,In > Out
Sept 2021,133,92,102,9844767,178116607,187961374,64,102,5,168271840,In > Out
Sept 2021,133,95,961,1749175311,2523614518,4272789829,194,901,9,774439207,In > Out
Sept 2021,133,98,926,353812994,4812670821,5166483815,222,907,10,4458857827,In > Out
Sept 2021,134,102,965,318866611,10631615221,10950481832,394,932,12,10312748610,In > Out
Sept 2021,134,103,418,33132183,831368550,864500733,103,417,7,798236367,In > Out
Sept 2021,134,105,459,83760138,2742043807,2825803945,194,449,8,2658283669,In > Out
Sept 2021,134,107,1435,231067069,5138781185,5369848254,325,1356,7,4907714116,In > Out
Sept 2021,134,109,211,6955384,199427134,206382518,34,211,1,192471750,In > Out
Sept 2021,134,11,289,667237498,4088621628,4755859126,121,288,3,3421384130,In > Out
Sept 2021,134,110,738,253819208,5641712450,5895531658,224,731,3,5387893242,In > Out
Sept 2021,134,113,374,78629222,3867330058,3945959280,116,371,5,3788700836,In > Out
Sept 2021,134,114,131,39115234,1867814548,1906929782,42,131,4,1828699314,In > Out
Sept 2021,134,115,471,44569888,1562211506,1606781394,162,462,4,1517641618,In > Out
Sept 2021,134,116,529,83697693,2521489273,2605186966,185,523,4,2437791580,In > Out
Sept 2021,134,117,573,74618823,1916650928,1991269751,153,565,4,1842032105,In > Out
Sept 2021,134,120,181,13706235,687344682,701050917,86,180,1,673638447,In > Out
Sept 2021,134,121,235,21887024,516229022,538116046,82,232,3,494341998,In > Out
Sept 2021,134,122,1095,2010646002,2532684253,4543330255,222,974,6,522038251,In > Out
Sept 2021,134,123,395,970934133,5263518668,6234452801,161,392,61,4292584535,In > Out
Sept 2021,134,124,477,108327845,3105274897,3213602742,196,469,6,2996947052,In > Out
Sept 2021,134,125,619,53546999,2726246580,2779793579,154,619,5,2672699581,In > Out
Sept 2021,134,126,1387,150025479,2875238207,3025263686,327,1367,9,2725212728,In > Out
Sept 2021,134,127,1436,133806100,5221397517,5355203617,133,1391,6,5087591417,In > Out
Sept 2021,134,128,600,235356632,9207636089,9442992721,204,580,4,8972279457,In > Out
Sept 2021,134,129,880,87564498,4363705630,4451270128,278,861,7,4276141132,In > Out
Sept 2021,134,13,288,105677977,760245163,865923140,106,287,4,654567186,In > Out
Sept 2021,134,130,897,867053731,8525889999,9392943730,335,876,9,7658836268,In > Out
Sept 2021,134,131,219,444024287,781483486,1225507773,100,219,3,337459199,In > Out
Sept 2021,134,132,673,140780928,2105427589,2246208517,205,660,6,1964646661,In > Out
Sept 2021,134,133,644,123928660,4803645850,4927574510,306,634,2,4679717190,In > Out
Sept 2021,134,134,1214,1647919418,5162220215,6810139633,307,1181,5,3514300797,In > Out
Sept 2021,134,135,103,7967518,144716768,152684286,67,103,3,136749250,In > Out
Sept 2021,134,136,1060,306009649,9196952058,9502961707,312,1036,6,8890942409,In > Out
Sept 2021,134,137,125,37849428,249090443,286939871,69,124,5,211241015,In > Out
Sept 2021,134,138,184,37392423,746580730,783973153,78,184,1,709188307,In > Out
Sept 2021,134,139,563,88576793,1316921342,1405498135,218,559,9,1228344549,In > Out
Sept 2021,134,141,783,16258507821,2561747464,18820255285,138,758,14,13696760357,Out > In
Sept 2021,134,142,354,234399188,5367781839,5602181027,108,353,3,5133382651,In > Out
Sept 2021,134,143,356,665526289,816786074,1482312363,127,350,6,151259785,In > Out
Sept 2021,134,144,336,41765033,2250801406,2292566439,160,329,1,2209036373,In > Out
Sept 2021,134,145,427,181456297,9503065105,9684521402,132,421,11,9321608808,In > Out
Sept 2021,134,146,950,711262028,1501475393,2212737421,214,941,6,790213365,In > Out
Sept 2021,134,147,303,743790017,2595587681,3339377698,124,301,6,1851797664,In > Out
Sept 2021,134,150,215,16614372,482960256,499574628,80,215,3,466345884,In > Out
Sept 2021,134,152,669,111848132,4582240290,4694088422,324,656,7,4470392158,In > Out
Sept 2021,134,153,754,830121816,3393867888,4223989704,146,693,7,2563746072,In > Out
Sept 2021,134,154,286,343940339,1510944388,1854884727,152,284,4,1167004049,In > Out
Sept 2021,134,155,1875,552348213,3264195059,3816543272,455,1763,77,2711846846,In > Out
Sept 2021,134,156,556,45244506,1583324453,1628568959,150,540,2,1538079947,In > Out
Sept 2021,134,157,748,86979141,2744623500,2831602641,239,739,6,2657644359,In > Out
Sept 2021,134,158,586,84701312,7532529771,7617231083,243,576,24,7447828459,In > Out
Sept 2021,134,159,230,83392700,519095417,602488117,119,228,6,435702717,In > Out
Sept 2021,134,162,255,78129317,831452183,909581500,143,255,4,753322866,In > Out
Sept 2021,134,163,1292,240592870,5113864677,5354457547,335,1238,6,4873271807,In > Out
Sept 2021,134,164,182,96137812,716643758,812781570,120,176,5,620505946,In > Out
Sept 2021,134,167,393,304754611,1565968631,1870723242,105,393,9,1261214020,In > Out
Sept 2021,134,168,1562,572553217,30594094635,31166647852,268,1536,8,30021541418,In > Out
Sept 2021,134,174,767,352608192,28559178528,28911786720,188,765,4,28206570336,In > Out
Sept 2021,134,175,519,140234538,1910769644,2051004182,196,515,4,1770535106,In > Out
Sept 2021,134,176,335,953073194,2198881029,3151954223,121,334,6,1245807835,In > Out
Sept 2021,134,178,761,282834855,7087261580,7370096435,256,752,3,6804426725,In > Out
Sept 2021,134,179,719,165804487,5206414791,5372219278,234,707,4,5040610304,In > Out
Sept 2021,134,180,645,117306050,3907456714,4024762764,171,638,5,3790150664,In > Out
Sept 2021,134,181,486,257387991,14046904836,14304292827,109,481,8,13789516845,In > Out
Sept 2021,134,182,1067,290873688,9686734979,9977608667,381,1042,12,9395861291,In > Out
Sept 2021,134,185,887,164389566,9168053907,9332443473,314,868,5,9003664341,In > Out
Sept 2021,134,187,1192,888246439,2059901157,2948147596,226,1166,3,1171654718,In > Out
Sept 2021,134,188,874,981824184,3916520491,4898344675,186,861,7,2934696307,In > Out
Sept 2021,134,19,1575,823184073,8832601236,9655785309,405,1503,17,8009417163,In > Out
Sept 2021,134,190,1586,408926017,4238885888,4647811905,436,1510,6,3829959871,In > Out
Sept 2021,134,192,697,506536556,11350437378,11856973934,225,694,4,10843900822,In > Out
Sept 2021,134,194,1191,381815064,7206653469,7588468533,249,1169,12,6824838405,In > Out
Sept 2021,134,196,153,18213566,314396683,332610249,69,152,2,296183117,In > Out
Sept 2021,134,198,869,101138113,2786809510,2887947623,227,862,3,2685671397,In > Out
Sept 2021,134,20,505,63313230,1695845658,1759158888,210,493,7,1632532428,In > Out
Sept 2021,134,201,222,428136278,869913562,1298049840,113,217,9,441777284,In > Out
Sept 2021,134,202,614,96015864,1922307451,2018323315,226,598,5,1826291587,In > Out
Sept 2021,134,204,744,189334814,12677665198,12867000012,157,715,3,12488330384,In > Out
Sept 2021,134,205,837,181392747,3699711734,3881104481,223,821,2,3518318987,In > Out
Sept 2021,134,206,108,18031137,558240839,576271976,61,108,2,540209702,In > Out
Sept 2021,134,209,1214,1055157346,11095128285,12150285631,251,1168,4,10039970939,In > Out
Sept 2021,134,212,672,84791195,2526614476,2611405671,208,664,5,2441823281,In > Out
Sept 2021,134,213,191,8528412,603452653,611981065,64,191,2,594924241,In > Out
Sept 2021,134,214,471,253693591,3917300732,4170994323,173,466,2,3663607141,In > Out
Sept 2021,134,215,938,752758272,30038083349,30790841621,192,934,2,29285325077,In > Out
Sept 2021,134,216,468,103354851,6979670621,7083025472,162,467,3,6876315770,In > Out
Sept 2021,134,217,605,121546766,2200895054,2322441820,192,601,4,2079348288,In > Out
Sept 2021,134,218,441,107182550,1386588619,1493771169,187,431,7,1279406069,In > Out
Sept 2021,134,220,424,188085230,1100743480,1288828710,199,418,7,912658250,In > Out
Sept 2021,134,222,401,713071865,2251683706,2964755571,116,395,12,1538611841,In > Out
Sept 2021,134,223,337,51909116,2784067707,2835976823,168,329,6,2732158591,In > Out
Sept 2021,134,23,412,59533435,1467815849,1527349284,114,411,6,1408282414,In > Out
Sept 2021,134,24,2010,263751549,8053694675,8317446224,267,1881,96,7789943126,In > Out
Sept 2021,134,28,176,60585975,2785529387,2846115362,96,176,4,2724943412,In > Out
Sept 2021,134,29,480,242138076,4387895006,4630033082,134,479,7,4145756930,In > Out
Sept 2021,134,30,735,93955359,855596189,949551548,160,726,3,761640830,In > Out
Sept 2021,134,32,512,60090190,2360503481,2420593671,148,511,3,2300413291,In > Out
Sept 2021,134,33,972,3176978831,6168302419,9345281250,244,933,6,2991323588,In > Out
Sept 2021,134,34,345,41502524,6385182336,6426684860,80,345,3,6343679812,In > Out
Sept 2021,134,38,364,115809861,2970046375,3085856236,101,363,3,2854236514,In > Out
Sept 2021,134,39,1137,151252326,4763796531,4915048857,270,1081,4,4612544205,In > Out
Sept 2021,134,4,280,30646350,1063288091,1093934441,145,278,3,1032641741,In > Out
Sept 2021,134,40,436,31919001,752412113,784331114,36,436,3,720493112,In > Out
Sept 2021,134,42,321,117108046,1144901407,1262009453,124,321,4,1027793361,In > Out
Sept 2021,134,43,924,434901552,2871757326,3306658878,275,906,7,2436855774,In > Out
Sept 2021,134,44,1921,297323910,5957580461,6254904371,256,1811,4,5660256551,In > Out
Sept 2021,134,45,202,95633956,3769383159,3865017115,95,202,6,3673749203,In > Out
Sept 2021,134,47,1473,2690363935,42076588655,44766952590,297,1428,7,39386224720,In > Out
Sept 2021,134,48,1543,387157422,3308300509,3695457931,450,1499,16,2921143087,In > Out
Sept 2021,134,5,133,4650369,169244005,173894374,56,133,2,164593636,In > Out
Sept 2021,134,50,588,74400660,2314078969,2388479629,201,583,3,2239678309,In > Out
Sept 2021,134,52,515,183089857,6909339003,7092428860,181,512,5,6726249146,In > Out
Sept 2021,134,53,665,115093797,3282769649,3397863446,153,661,5,3167675852,In > Out
Sept 2021,134,54,916,208865730,2716439797,2925305527,193,902,6,2507574067,In > Out
Sept 2021,134,55,30,2006150,27534874,29541024,22,30,2,25528724,In > Out
Sept 2021,134,56,633,117228436,8048381970,8165610406,176,622,4,7931153534,In > Out
Sept 2021,134,58,236,130309167,372315313,502624480,103,235,7,242006146,In > Out
Sept 2021,134,61,1337,1217097157,70259323766,71476420923,342,1292,7,69042226609,In > Out
Sept 2021,134,62,2299,427308190,5237535602,5664843792,332,2248,5,4810227412,In > Out
Sept 2021,134,63,699,224066681,2781561344,3005628025,221,669,5,2557494663,In > Out
Sept 2021,134,64,429,68225454,2622542641,2690768095,201,428,4,2554317187,In > Out
Sept 2021,134,66,684,93766900,2695922222,2789689122,182,671,4,2602155322,In > Out
Sept 2021,134,67,673,151362566,9087869083,9239231649,187,663,5,8936506517,In > Out
Sept 2021,134,69,1219,1822821821,4737665062,6560486883,356,1201,8,2914843241,In > Out
Sept 2021,134,7,194,26531238,757613269,784144507,37,194,2,731082031,In > Out
Sept 2021,134,71,94,12453760,356102747,368556507,40,94,2,343648987,In > Out
Sept 2021,134,72,190,65062953,678994760,744057713,72,188,3,613931807,In > Out
Sept 2021,134,73,589,61728017,962938492,1024666509,214,585,5,901210475,In > Out
Sept 2021,134,74,1050,1405670728,4752501432,6158172160,296,1006,13,3346830704,In > Out
Sept 2021,134,75,591,318301404,8142037665,8460339069,181,585,11,7823736261,In > Out
Sept 2021,134,76,1197,426803341,11473422508,11900225849,301,1185,4,11046619167,In > Out
Sept 2021,134,77,709,269612196,11025017720,11294629916,259,694,6,10755405524,In > Out
Sept 2021,134,78,826,1256109887,5918948272,7175058159,278,799,7,4662838385,In > Out
Sept 2021,134,80,845,603376443,6444643503,7048019946,260,832,8,5841267060,In > Out
Sept 2021,134,81,1492,2761175555,5811653752,8572829307,416,1446,15,3050478197,In > Out
Sept 2021,134,82,1584,285257126,11356976767,11642233893,366,1526,3,11071719641,In > Out
Sept 2021,134,84,545,220452347,1224027428,1444479775,101,537,1,1003575081,In > Out
Sept 2021,134,86,616,103401363,2565952151,2669353514,156,609,4,2462550788,In > Out
Sept 2021,134,88,782,202280369,3107499950,3309780319,184,779,5,2905219581,In > Out
Sept 2021,134,89,389,94114580,4903931580,4998046160,155,386,6,4809817000,In > Out
Sept 2021,134,90,1900,212450251,4761472701,4973922952,428,1816,8,4549022450,In > Out
Sept 2021,134,92,856,175979128,5396722410,5572701538,273,841,6,5220743282,In > Out
Sept 2021,134,94,461,32085163,774778226,806863389,173,456,4,742693063,In > Out
Sept 2021,134,95,681,90152252,2224482775,2314635027,239,665,6,2134330523,In > Out
Sept 2021,134,97,270,263197696,6975054259,7238251955,116,268,7,6711856563,In > Out
Sept 2021,134,98,452,83090198,1946855692,2029945890,101,451,3,1863765494,In > Out
Sept 2021,134,99,718,156283046,2486741558,2643024604,186,705,8,2330458512,In > Out
Sept 2021,138,133,1176,196194106,2958853898,3155048004,79,1138,2,2762659792,In > Out
Sept 2021,138,195,1155,180886690,7046479715,7227366405,54,1121,2,6865593025,In > Out
Sept 2021,138,196,847,132586971,6829529997,6962116968,62,742,2,6696943026,In > Out
Sept 2021,14,12,34,5724473,395724516,401448989,8,34,2,390000043,In > Out
Sept 2021,14,16,929,45687835,888048745,933736580,90,890,2,842360910,In > Out
Sept 2021,14,40,661,4076725,282550321,286627046,8,661,2,278473596,In > Out
Sept 2021,141,111,2250,750489673,3697954531,4448444204,351,2118,5,2947464858,In > Out
Sept 2021,141,113,713,769946172,3655547544,4425493716,209,698,9,2885601372,In > Out
Sept 2021,141,123,413,173739902,812366562,986106464,39,412,2,638626660,In > Out
Sept 2021,141,135,1,1828020,744996,2573016,1,1,1,1083024,Out > In
Sept 2021,141,139,489,81345686,1143767749,1225113435,54,483,2,1062422063,In > Out
Sept 2021,141,147,442,53739050,365102597,418841647,139,440,2,311363547,In > Out
Sept 2021,141,148,2784,411015799,781245360,1192261159,331,2633,2,370229561,In > Out
Sept 2021,141,154,10,158987,4485984,4644971,5,10,1,4326997,In > Out
Sept 2021,141,176,546,88868352,2327103718,2415972070,38,543,2,2238235366,In > Out
Sept 2021,141,18,11,407440,5555890,5963330,3,11,2,5148450,In > Out
Sept 2021,141,182,648,1033056591,3913693786,4946750377,184,626,3,2880637195,In > Out
Sept 2021,141,21,246,185547638,7193141163,7378688801,76,246,3,7007593525,In > Out
Sept 2021,141,212,38,841462,38004993,38846455,15,37,2,37163531,In > Out
Sept 2021,141,39,4407,49778106,1163397731,1213175837,8,3910,1,1113619625,In > Out
Sept 2021,141,40,670,302425244,1510980097,1813405341,246,662,3,1208554853,In > Out
Sept 2021,141,46,423,105339545,3756353907,3861693452,60,422,2,3651014362,In > Out
Sept 2021,141,81,432,243901258,10475126207,10719027465,104,431,2,10231224949,In > Out
Sept 2021,141,84,625,1348157484,26366130469,27714287953,170,615,3,25017972985,In > Out
Sept 2021,141,94,1459,206734162,2715975014,2922709176,277,1420,4,2509240852,In > Out
Sept 2021,141,98,567,326205210,477528734,803733944,213,530,5,151323524,In > Out
Sept 2021,142,4,17,5450025,311622195,317072220,2,17,1,306172170,In > Out
Sept 2021,142,5,14,3705838,123743849,127449687,2,14,1,120038011,In > Out
Sept 2021,142,72,6,508242,71705767,72214009,4,6,2,71197525,In > Out
Sept 2021,143,148,7126,2746194371,120199154500,122945348871,969,5665,25,117452960129,In > Out
Sept 2021,143,152,619,672033445,3701606125,4373639570,220,608,11,3029572680,In > Out
Sept 2021,143,157,2289,1049052918,23870757067,24919809985,520,2160,7,22821704149,In > Out
Sept 2021,143,205,2118,2984400117,49635875265,52620275382,483,1999,6,46651475148,In > Out
Sept 2021,143,219,377,127479548,2878943739,3006423287,216,377,2,2751464191,In > Out
Sept 2021,143,33,1038,133776226,818694615,952470841,241,999,2,684918389,In > Out
Sept 2021,145,118,333,133270625,1878216368,2011486993,33,324,2,1744945743,In > Out
Sept 2021,145,170,429,84741550,3508171842,3592913392,46,425,2,3423430292,In > Out
Sept 2021,145,29,28,1845737,14975185,16820922,8,28,2,13129448,In > Out
Sept 2021,145,9,258,126165407,1751176761,1877342168,22,257,2,1625011354,In > Out
Sept 2021,145,95,848,183862241,4105761270,4289623511,66,772,2,3921899029,In > Out
Sept 2021,146,106,1095,219582043,2077724774,2297306817,246,1061,2,1858142731,In > Out
Sept 2021,146,11,1544,217317951,1532540431,1749858382,294,1486,2,1315222480,In > Out
Sept 2021,146,128,197,13270256,211896016,225166272,85,196,2,198625760,In > Out
Sept 2021,146,132,2082,841614147,1294368250,2135982397,158,1949,2,452754103,In > Out
Sept 2021,146,137,324,31774185,1347116616,1378890801,43,320,2,1315342431,In > Out
Sept 2021,146,138,770,135468081,1468386415,1603854496,171,759,2,1332918334,In > Out
Sept 2021,146,139,493,94570118,365923940,460494058,169,485,3,271353822,In > Out
Sept 2021,146,140,25,8818943,450816316,459635259,12,25,2,441997373,In > Out
Sept 2021,146,141,1171,261436969,2688336644,2949773613,155,1140,2,2426899675,In > Out
Sept 2021,146,142,484,24008002,653572735,677580737,103,478,2,629564733,In > Out
Sept 2021,146,143,1834,171397756,2380249390,2551647146,249,1741,5,2208851634,In > Out
Sept 2021,146,152,1264,275561561,2150750495,2426312056,303,1224,2,1875188934,In > Out
Sept 2021,146,157,395,29616919,100120699,129737618,68,389,2,70503780,In > Out
Sept 2021,146,163,638,151129264,1631642626,1782771890,159,607,2,1480513362,In > Out
Sept 2021,146,165,1775,328170370,1499368919,1827539289,390,1689,2,1171198549,In > Out
Sept 2021,146,175,1,192473,48112,240585,1,1,1,144361,Out > In
Sept 2021,146,193,367,33411994,397354221,430766215,131,365,2,363942227,In > Out
Sept 2021,146,213,879,215329579,2160153037,2375482616,224,861,2,1944823458,In > Out
Sept 2021,146,220,2041,240076922,2507615493,2747692415,160,1919,2,2267538571,In > Out
Sept 2021,146,24,640,58896073,390796385,449692458,192,629,2,331900312,In > Out
Sept 2021,146,60,314,30286083,417870783,448156866,155,309,2,387584700,In > Out
Sept 2021,146,63,379,31815447,335768200,367583647,101,375,2,303952753,In > Out
Sept 2021,146,77,1434,218375363,131248104,349623467,65,1360,2,87127259,Out > In
Sept 2021,146,79,1755,264878739,4588729512,4853608251,339,1668,2,4323850773,In > Out
Sept 2021,146,8,340,7818769,276589070,284407839,119,339,2,268770301,In > Out
Sept 2021,149,100,1,5926,666910,672836,1,1,1,660984,In > Out
Sept 2021,149,102,1,1209,127867,129076,1,1,1,126658,In > Out
Sept 2021,149,103,1,4210,390479,394689,1,1,1,386269,In > Out
Sept 2021,149,104,2,107591,501276,608867,2,2,1,393685,In > Out
Sept 2021,149,105,126,25036101,777289633,802325734,36,124,2,752253532,In > Out
Sept 2021,149,106,19,578844,18196621,18775465,5,19,1,17617777,In > Out
Sept 2021,149,108,6,257395,1663533,1920928,4,6,1,1406138,In > Out
Sept 2021,149,109,3,126188,693389,819577,3,3,1,567201,In > Out
Sept 2021,149,11,2,538928,30781273,31320201,2,2,1,30242345,In > Out
Sept 2021,149,110,25,3499963,28321373,31821336,6,25,1,24821410,In > Out
Sept 2021,149,111,11,143464629,8191565057,8335029686,9,11,1,8048100428,In > Out
Sept 2021,149,112,11,592027,5985088,6577115,6,11,1,5393061,In > Out
Sept 2021,149,113,8,314432,3236534,3550966,4,8,1,2922102,In > Out
Sept 2021,149,114,16,2222495,18197925,20420420,8,15,1,15975430,In > Out
Sept 2021,149,115,2529,218205745,3754600820,3972806565,297,2330,2,3536395075,In > Out
Sept 2021,149,117,42,4389128,37371454,41760582,12,41,2,32982326,In > Out
Sept 2021,149,118,9,597512,6621089,7218601,4,9,1,6023577,In > Out
Sept 2021,149,119,19,2158349,15097593,17255942,6,19,1,12939244,In > Out
Sept 2021,149,12,19,155164,5605583,5760747,4,19,1,5450419,In > Out
Sept 2021,149,121,2313,290983925,2940734860,3231718785,559,2184,2,2649750935,In > Out
Sept 2021,149,123,30,4128481,36253014,40381495,7,30,1,32124533,In > Out
Sept 2021,149,125,49,5610563,48430141,54040704,10,48,1,42819578,In > Out
Sept 2021,149,126,4,58344,1822787,1881131,3,4,1,1764443,In > Out
Sept 2021,149,127,35,5209993,51873776,57083769,12,35,2,46663783,In > Out
Sept 2021,149,128,7,567974,4311266,4879240,4,7,1,3743292,In > Out
Sept 2021,149,129,15,1620247,13758018,15378265,6,15,1,12137771,In > Out
Sept 2021,149,13,16,680682,6244646,6925328,5,16,1,5563964,In > Out
Sept 2021,149,130,1,1686,194511,196197,1,1,1,192825,In > Out
Sept 2021,149,131,14,742174,4642466,5384640,5,14,1,3900292,In > Out
Sept 2021,149,136,2,33591,419196,452787,2,2,1,385605,In > Out
Sept 2021,149,138,4,142651,960004,1102655,4,4,1,817353,In > Out
Sept 2021,149,139,653,190162004,1249547541,1439709545,144,640,6,1059385537,In > Out
Sept 2021,149,14,26,6817369,173664709,180482078,16,26,2,166847340,In > Out
Sept 2021,149,141,6,346601,1701722,2048323,4,6,1,1355121,In > Out
Sept 2021,149,142,25,3115602,28271043,31386645,7,25,1,25155441,In > Out
Sept 2021,149,144,72,3831960,34691756,38523716,12,71,1,30859796,In > Out
Sept 2021,149,146,3,137544,1035473,1173017,2,3,1,897929,In > Out
Sept 2021,149,147,1045,116860830,3810247181,3927108011,398,1008,2,3693386351,In > Out
Sept 2021,149,149,2,133400,599346,732746,2,2,1,465946,In > Out
Sept 2021,149,150,2,4572,292071,296643,2,2,1,287499,In > Out
Sept 2021,149,151,1,2213,204521,206734,1,1,1,202308,In > Out
Sept 2021,149,153,6,759886,7509807,8269693,2,6,1,6749921,In > Out
Sept 2021,149,154,2,6065,281894,287959,2,2,1,275829,In > Out
Sept 2021,149,156,1,3225,325037,328262,1,1,1,321812,In > Out
Sept 2021,149,157,3219,420138098,10417411361,10837549459,721,2939,4,9997273263,In > Out
Sept 2021,149,158,17,413805,11738862,12152667,3,17,1,11325057,In > Out
Sept 2021,149,159,5,414445,1987820,2402265,5,5,1,1573375,In > Out
Sept 2021,149,16,434,91309534,683943170,775252704,216,429,5,592633636,In > Out
Sept 2021,149,160,20,8297033,4471291,12768324,12,8,11,3825742,Out > In
Sept 2021,149,161,2,4771,256958,261729,2,2,1,252187,In > Out
Sept 2021,149,162,1,1553,164992,166545,1,1,1,163439,In > Out
Sept 2021,149,163,1,4124,332675,336799,1,1,1,328551,In > Out
Sept 2021,149,164,5,147168,1684795,1831963,5,5,1,1537627,In > Out
Sept 2021,149,168,3,66662,2014663,2081325,3,3,1,1948001,In > Out
Sept 2021,149,169,20,2129327,17455647,19584974,9,20,1,15326320,In > Out
Sept 2021,149,17,15,1309834,2387770,3697604,5,15,1,1077936,In > Out
Sept 2021,149,171,8,448527,2531219,2979746,2,8,1,2082692,In > Out
Sept 2021,149,173,10,1196959,14130086,15327045,4,10,1,12933127,In > Out
Sept 2021,149,176,352,75984520,703029293,779013813,63,351,2,627044773,In > Out
Sept 2021,149,179,1251,341420731,10009919389,10351340120,341,1206,2,9668498658,In > Out
Sept 2021,149,18,18,1792746,18842317,20635063,8,18,1,17049571,In > Out
Sept 2021,149,181,229,71066379,3285067812,3356134191,83,225,2,3214001433,In > Out
Sept 2021,149,182,2,45757,1673047,1718804,2,2,1,1627290,In > Out
Sept 2021,149,183,14,1318914,12028212,13347126,8,14,1,10709298,In > Out
Sept 2021,149,185,2,13095,524945,538040,2,2,1,511850,In > Out
Sept 2021,149,186,1,1448,149957,151405,1,1,1,148509,In > Out
Sept 2021,149,189,1,2125,307439,309564,1,1,1,305314,In > Out
Sept 2021,149,19,2767,446560809,15475142972,15921703781,737,2547,2,15028582163,In > Out
Sept 2021,149,190,6,345561,2289319,2634880,4,6,1,1943758,In > Out
Sept 2021,149,193,11,955223,7370819,8326042,6,11,1,6415596,In > Out
Sept 2021,149,194,26,2843060,28482458,31325518,8,26,1,25639398,In > Out
Sept 2021,149,195,2,16258,876896,893154,2,2,1,860638,In > Out
Sept 2021,149,196,3,181847,724141,905988,3,3,1,542294,In > Out
Sept 2021,149,197,1,5289,501067,506356,1,1,1,495778,In > Out
Sept 2021,149,198,3,258584,688070,946654,3,3,1,429486,In > Out
Sept 2021,149,199,9,763807,9930581,10694388,4,9,1,9166774,In > Out
Sept 2021,149,20,4,132667,1060503,1193170,4,4,1,927836,In > Out
Sept 2021,149,201,2,20681,981991,1002672,2,2,1,961310,In > Out
Sept 2021,149,202,1576,143822922,449455406,593278328,92,1576,1,305632484,In > Out
Sept 2021,149,207,3,377162,689678,1066840,3,3,1,312516,In > Out
Sept 2021,149,208,3,5082,526195,531277,1,3,1,521113,In > Out
Sept 2021,149,21,17,2156158,15560607,17716765,7,17,1,13404449,In > Out
Sept 2021,149,210,14,1378259,11684739,13062998,7,14,1,10306480,In > Out
Sept 2021,149,211,1217,289938456,995677512,1285615968,167,1188,3,705739056,In > Out
Sept 2021,149,212,5,57208,2241026,2298234,5,5,1,2183818,In > Out
Sept 2021,149,213,29,3762835,30961325,34724160,9,29,1,27198490,In > Out
Sept 2021,149,214,17,1852471,15438673,17291144,7,17,1,13586202,In > Out
Sept 2021,149,215,12,892358,7267031,8159389,5,12,1,6374673,In > Out
Sept 2021,149,216,7,352744,6551173,6903917,4,7,1,6198429,In > Out
Sept 2021,149,217,14,1775105,40356684,42131789,8,14,1,38581579,In > Out
Sept 2021,149,218,1,1814,132448,134262,1,1,1,130634,In > Out
Sept 2021,149,220,8,1185830,12713409,13899239,4,8,1,11527579,In > Out
Sept 2021,149,221,2,11103,558279,569382,2,2,1,547176,In > Out
Sept 2021,149,225,5,135876,1786708,1922584,4,5,1,1650832,In > Out
Sept 2021,149,226,1,2218,204571,206789,1,1,1,202353,In > Out
Sept 2021,149,227,1,1548,176154,177702,1,1,1,174606,In > Out
Sept 2021,149,228,3,21213,537232,558445,3,3,1,516019,In > Out
Sept 2021,149,23,1,3349,418584,421933,1,1,1,415235,In > Out
Sept 2021,149,230,1,1383,106912,108295,1,1,1,105529,In > Out
Sept 2021,149,231,1,9843,574305,584148,1,1,1,564462,In > Out
Sept 2021,149,233,1,5366,628024,633390,1,1,1,622658,In > Out
Sept 2021,149,234,632,170368141,1810376041,1980744182,131,622,2,1640007900,In > Out
Sept 2021,149,235,5,198593,2093822,2292415,3,5,1,1895229,In > Out
Sept 2021,149,236,13,492560,32442454,32935014,6,13,2,31949894,In > Out
Sept 2021,149,237,94,14183843,392495147,406678990,39,94,2,378311304,In > Out
Sept 2021,149,239,10,618031,4555872,5173903,6,10,1,3937841,In > Out
Sept 2021,149,24,1,22083,183393,205476,1,1,1,161310,In > Out
Sept 2021,149,241,1,3600,309080,312680,1,1,1,305480,In > Out
Sept 2021,149,244,16,1374723,12908608,14283331,7,16,1,11533885,In > Out
Sept 2021,149,245,3,175001,594745,769746,3,3,1,419744,In > Out
Sept 2021,149,247,3,163122,739655,902777,3,3,1,576533,In > Out
Sept 2021,149,248,9,1064978,22220940,23285918,6,9,1,21155962,In > Out
Sept 2021,149,249,106,23445979,905494695,928940674,53,104,2,882048716,In > Out
Sept 2021,149,250,64,3530699,157776369,161307068,19,64,2,154245670,In > Out
Sept 2021,149,252,23,2775725,23304947,26080672,7,23,1,20529222,In > Out
Sept 2021,149,253,18,1847732,16390299,18238031,5,18,1,14542567,In > Out
Sept 2021,149,254,31,2009661,17797133,19806794,8,31,1,15787472,In > Out
Sept 2021,149,26,16,1564425,12838617,14403042,8,16,1,11274192,In > Out
Sept 2021,149,28,1,1349,232952,234301,1,1,1,231603,In > Out
Sept 2021,149,29,4,96482,3580530,3677012,4,4,1,3484048,In > Out
Sept 2021,149,35,31,3646637,31861340,35507977,10,30,1,28214703,In > Out
Sept 2021,149,36,1,2086,174288,176374,1,1,1,172202,In > Out
Sept 2021,149,37,15,1858678,14903418,16762096,6,15,1,13044740,In > Out
Sept 2021,149,40,2,13401,649132,662533,2,2,1,635731,In > Out
Sept 2021,149,42,4,143188,1565020,1708208,2,4,1,1421832,In > Out
Sept 2021,149,43,2,22012,382990,405002,2,2,1,360978,In > Out
Sept 2021,149,44,13,1719659,13341469,15061128,5,13,1,11621810,In > Out
Sept 2021,149,45,348,65658888,784590979,850249867,102,344,2,718932091,In > Out
Sept 2021,149,46,23,2657058,21799577,24456635,7,23,1,19142519,In > Out
Sept 2021,149,49,3,154182,764717,918899,3,3,1,610535,In > Out
Sept 2021,149,50,2,8340,784177,792517,2,2,1,775837,In > Out
Sept 2021,149,51,14,2994503,4898189,7892692,9,14,3,1903686,In > Out
Sept 2021,149,55,2,12719,605219,617938,2,2,1,592500,In > Out
Sept 2021,149,60,2,23116,318231,341347,2,2,1,295115,In > Out
Sept 2021,149,63,369,41920076,964340888,1006260964,127,361,7,922420812,In > Out
Sept 2021,149,64,2,6383,803381,809764,1,2,1,796998,In > Out
Sept 2021,149,65,492,88699142,649047201,737746343,167,484,2,560348059,In > Out
Sept 2021,149,66,14,703963,7525279,8229242,8,14,1,6821316,In > Out
Sept 2021,149,68,2,7312,228423,235735,2,2,1,221111,In > Out
Sept 2021,149,69,1,1110,162773,163883,1,1,1,161663,In > Out
Sept 2021,149,70,1,2494,369761,372255,1,1,1,367267,In > Out
Sept 2021,149,71,10,477347,5804303,6281650,6,10,1,5326956,In > Out
Sept 2021,149,72,19,2526866,26835369,29362235,6,19,1,24308503,In > Out
Sept 2021,149,74,1,1357,175039,176396,1,1,1,173682,In > Out
Sept 2021,149,75,24,2762613,28424534,31187147,12,22,1,25661921,In > Out
Sept 2021,149,77,2,97088,577223,674311,2,2,1,480135,In > Out
Sept 2021,149,79,2,13046,746866,759912,2,2,1,733820,In > Out
Sept 2021,149,8,3407,403630435,10939268999,11342899434,533,3076,3,10535638564,In > Out
Sept 2021,149,80,2,117788,667000,784788,2,2,1,549212,In > Out
Sept 2021,149,81,21,2337755,20448148,22785903,7,21,1,18110393,In > Out
Sept 2021,149,82,22,2601595,25370470,27972065,8,22,1,22768875,In > Out
Sept 2021,149,83,552,151419602,1467962336,1619381938,194,545,3,1316542734,In > Out
Sept 2021,149,85,3,109779,972816,1082595,3,3,1,863037,In > Out
Sept 2021,149,86,11,1228670,13077092,14305762,5,9,1,11848422,In > Out
Sept 2021,149,87,33,1612903,13690164,15303067,9,33,1,12077261,In > Out
Sept 2021,149,88,5,329379,1125896,1455275,3,5,1,796517,In > Out
Sept 2021,149,89,3,235912,18191611,18427523,2,3,2,17955699,In > Out
Sept 2021,149,9,17,2277449,21320379,23597828,6,17,1,19042930,In > Out
Sept 2021,149,90,7,366030,3107697,3473727,3,7,1,2741667,In > Out
Sept 2021,149,91,11,265513,22916717,23182230,6,11,2,22651204,In > Out
Sept 2021,149,92,4,155060,1983258,2138318,4,4,1,1828198,In > Out
Sept 2021,149,93,1,2230,128633,130863,1,1,1,126403,In > Out
Sept 2021,149,94,5,303397,1111071,1414468,5,5,1,807674,In > Out
Sept 2021,149,95,27,3014661,25101736,28116397,9,26,1,22087075,In > Out
Sept 2021,149,96,1,5810,439303,445113,1,1,1,433493,In > Out
Sept 2021,149,97,1,1713,161339,163052,1,1,1,159626,In > Out
Sept 2021,149,99,8,847363,4438401,5285764,4,8,1,3591038,In > Out
Sept 2021,150,124,1,5696,218948,224644,1,1,1,213252,In > Out
Sept 2021,150,15,124,4183512,169266413,173449925,7,124,2,165082901,In > Out
Sept 2021,150,171,3024,471355529,4405465927,4876821456,601,2764,3,3934110398,In > Out
Sept 2021,150,173,4317,2586005023,9993146097,12579151120,282,3905,3,7407141074,In > Out
Sept 2021,150,179,33,2384884,50424477,52809361,23,33,2,48039593,In > Out
Sept 2021,150,180,373,148525060,1908776150,2057301210,31,362,2,1760251090,In > Out
Sept 2021,150,184,484,170138216,1989526343,2159664559,49,453,2,1819388127,In > Out
Sept 2021,150,192,191,450738795,67785198,518523993,20,190,1,382953597,Out > In
Sept 2021,150,215,12,1074021,4788671,5862692,5,12,1,3714650,In > Out
Sept 2021,150,219,1065,254356491,692412632,946769123,73,1035,2,438056141,In > Out
Sept 2021,150,220,136,2841895,157664143,160506038,13,135,2,154822248,In > Out
Sept 2021,150,222,3,24337,924326,948663,3,3,1,899989,In > Out
Sept 2021,150,233,429,167277292,1564028890,1731306182,54,417,2,1396751598,In > Out
Sept 2021,150,235,407,350513405,971032052,1321545457,146,379,3,620518647,In > Out
Sept 2021,150,237,344,18532981,934351108,952884089,154,341,3,915818127,In > Out
Sept 2021,150,240,705,102059602,372325222,474384824,195,691,2,270265620,In > Out
Sept 2021,150,250,636,112868867,1767127342,1879996209,55,623,2,1654258475,In > Out
Sept 2021,150,31,380,44129691,1319364369,1363494060,44,340,2,1275234678,In > Out
Sept 2021,150,52,157,63523660,933249859,996773519,30,154,2,869726199,In > Out
Sept 2021,150,71,984,193005217,1260518671,1453523888,143,956,2,1067513454,In > Out
Sept 2021,151,23,813,130799736,98840803,229640539,11,802,2,31958933,Out > In
Sept 2021,153,133,582,189700490,2102444564,2292145054,71,579,2,1912744074,In > Out
Sept 2021,153,60,307,381041701,1722861320,2103903021,161,305,3,1341819619,In > Out
Sept 2021,154,105,457,166048069,2159890837,2325938906,46,436,2,1993842768,In > Out
Sept 2021,154,11,379,186559645,3049011737,3235571382,45,370,2,2862452092,In > Out
Sept 2021,154,143,548,74207527,857029755,931237282,176,539,2,782822228,In > Out
Sept 2021,154,155,501,172804240,2100706195,2273510435,76,496,3,1927901955,In > Out
Sept 2021,154,162,10323,15485115243,22637826503,38122941746,1485,7687,8,7152711260,In > Out
Sept 2021,154,164,1012,1454225600,4190312311,5644537911,330,985,3,2736086711,In > Out
Sept 2021,154,165,69,3247788,71429164,74676952,23,68,2,68181376,In > Out
Sept 2021,154,167,277,48617943,827181654,875799597,32,258,2,778563711,In > Out
Sept 2021,154,179,488,180272524,1771552566,1951825090,74,481,2,1591280042,In > Out
Sept 2021,154,18,778,68983767,431828381,500812148,140,775,2,362844614,In > Out
Sept 2021,154,185,1211,75502675,883032117,958534792,307,1178,2,807529442,In > Out
Sept 2021,154,20,506,159805349,1733880113,1893685462,76,492,2,1574074764,In > Out
Sept 2021,154,202,422,254143416,3697348651,3951492067,30,419,2,3443205235,In > Out
Sept 2021,154,222,850,118308680,1725081752,1843390432,264,824,3,1606773072,In > Out
Sept 2021,154,25,558,109661704,44793663865,44903325569,22,548,2,44684002161,In > Out
Sept 2021,154,30,359,40769057,2955438835,2996207892,61,357,2,2914669778,In > Out
Sept 2021,154,32,137,18800841,18977502,37778343,12,136,2,176661,In > Out
Sept 2021,154,38,380,164215693,2048077302,2212292995,45,377,2,1883861609,In > Out
Sept 2021,154,6,241,1541834499,3187899827,4729734326,113,238,5,1646065328,In > Out
Sept 2021,154,61,289,150307803,1718261921,1868569724,22,286,2,1567954118,In > Out
Sept 2021,154,67,1,106912,83520,190432,1,1,1,23392,Out > In
Sept 2021,154,72,427,193757699,1822579447,2016337146,41,421,2,1628821748,In > Out
Sept 2021,154,95,376,159401372,1779508788,1938910160,42,364,2,1620107416,In > Out
Sept 2021,155,135,9,22826867,434640,23261507,5,9,9,22392227,Out > In
Sept 2021,155,142,736,172484596,4341810,176826406,112,5,727,168142786,Out > In
Sept 2021,155,143,18,7190648,865681,8056329,12,6,14,6324967,Out > In
Sept 2021,155,145,669,12788075,1368560109,1381348184,10,664,5,1355772034,In > Out
Sept 2021,155,146,4,2035764,651894271,653930035,3,4,4,649858507,In > Out
Sept 2021,155,149,1913,579991224,14369390,594360614,310,14,1830,565621834,Out > In
Sept 2021,155,151,19,24486572,26857263,51343835,6,18,9,2370691,In > Out
Sept 2021,155,153,5,2125966,46406,2172372,4,5,1,2079560,Out > In
Sept 2021,155,167,922,4288885728,563593525,4852479253,230,172,675,3725292203,Out > In
Sept 2021,155,169,77,22762133,258787034,281549167,34,60,15,236024901,In > Out
Sept 2021,155,170,66,50980484,267530390,318510874,28,54,9,216549906,In > Out
Sept 2021,155,205,791,179256461,6476610,185733071,46,1,778,172779851,Out > In
Sept 2021,155,207,249,1875302,292857372,294732674,2,249,2,290982070,In > Out
Sept 2021,156,136,1965,451674294,3212384338,3664058632,241,1848,2,2760710044,In > Out
Sept 2021,156,140,384,49696138,713783487,763479625,135,380,2,664087349,In > Out
Sept 2021,156,142,1569,201756378,3159885812,3361642190,168,1506,2,2958129434,In > Out
Sept 2021,156,145,479,41974377,1469308675,1511283052,181,474,2,1427334298,In > Out
Sept 2021,156,155,287,20233208,2353158347,2373391555,57,271,3,2332925139,In > Out
Sept 2021,156,159,456,28967457,827457503,856424960,150,453,2,798490046,In > Out
Sept 2021,156,171,440,133563959,904534914,1038098873,139,436,3,770970955,In > Out
Sept 2021,156,174,247,36476112,871922885,908398997,22,245,3,835446773,In > Out
Sept 2021,156,179,1,57833,65628,123461,1,1,1,7795,In > Out
Sept 2021,156,187,2905,380778725,1064168316,1444947041,218,2673,2,683389591,In > Out
Sept 2021,156,188,90,7251760,74995539,82247299,14,89,1,67743779,In > Out
Sept 2021,156,197,31,729831,31506286,32236117,11,31,1,30776455,In > Out
Sept 2021,156,210,466,157138688,1260240241,1417378929,35,466,2,1103101553,In > Out
Sept 2021,156,213,1484,281636036,1345346354,1626982390,148,1424,2,1063710318,In > Out
Sept 2021,156,222,2,86311,178113,264424,2,2,1,91802,In > Out
Sept 2021,156,225,2128,198649911,1437649541,1636299452,287,2006,3,1238999630,In > Out
Sept 2021,156,233,88,22431351,605133371,627564722,44,88,2,582702020,In > Out
Sept 2021,156,238,78,7781439,32742695,40524134,13,78,1,24961256,In > Out
Sept 2021,156,239,9,1462768,14327461,15790229,5,9,2,12864693,In > Out
Sept 2021,156,240,203,22304917375,452108540,22757025915,41,203,2,21852808835,Out > In
Sept 2021,156,243,2598,426388161,1138929166,1565317327,256,2428,2,712541005,In > Out
Sept 2021,156,246,1,2140,110914,113054,1,1,1,108774,In > Out
Sept 2021,159,145,1475,447348074,1416435044,1863783118,210,1438,3,969086970,In > Out
Sept 2021,159,15,8,2305051,4837961,7143012,6,8,2,2532910,In > Out
Sept 2021,159,161,3,709761,347407,1057168,3,3,1,362354,Out > In
Sept 2021,159,201,381,80505739,850741204,931246943,41,370,2,770235465,In > Out
Sept 2021,159,217,2194,1739194325,5673017821,7412212146,381,2053,4,3933823496,In > Out
Sept 2021,159,239,537,69958031,795956058,865914089,169,531,2,725998027,In > Out
Sept 2021,159,248,145,10089698,394983025,405072723,33,145,2,384893327,In > Out
Sept 2021,159,34,78,5435558,35171941,40607499,12,78,1,29736383,In > Out
Sept 2021,16,10,39,802479,23147981,23950460,34,39,1,22345502,In > Out
Sept 2021,16,12,1843,99816679,6039993474,6139810153,205,1767,2,5940176795,In > Out
Sept 2021,16,14,15424,4171569544,119957343885,124128913429,1729,10706,16,115785774341,In > Out
Sept 2021,16,16,12645,1239439839,36260791392,37500231231,692,8672,4,35021351553,In > Out
Sept 2021,16,20,6274,48875582373,19002043278,67877625651,1033,5464,10,29873539095,Out > In
Sept 2021,16,240,912,103619101,4961395913,5065015014,175,897,3,4857776812,In > Out
Sept 2021,16,4,765,305382435,1024064284,1329446719,204,741,6,718681849,In > Out
Sept 2021,16,7,17896,2860351197,59582436073,62442787270,1663,12145,7,56722084876,In > Out
Sept 2021,160,10,221,29001194,246499670,275500864,103,215,4,217498476,In > Out
Sept 2021,160,105,2350,641440222,2929139401,3570579623,133,2171,4,2287699179,In > Out
Sept 2021,160,106,9324,3802020489,21026770475,24828790964,256,7154,4,17224749986,In > Out
Sept 2021,160,107,1412,367392655,1775800372,2143193027,117,1366,3,1408407717,In > Out
Sept 2021,160,108,4884,381666573,25773563648,26155230221,182,4400,2,25391897075,In > Out
Sept 2021,160,109,1998,163440276,3472252851,3635693127,175,1905,3,3308812575,In > Out
Sept 2021,160,11,615,69182979,777014177,846197156,136,598,2,707831198,In > Out
Sept 2021,160,110,4972,4496630185,6604019130,11100649315,330,4288,4,2107388945,In > Out
Sept 2021,160,111,1650,366501138,18022755751,18389256889,227,1560,17,17656254613,In > Out
Sept 2021,160,112,1702,502183055,22772101771,23274284826,135,1610,2,22269918716,In > Out
Sept 2021,160,12,288,25084370,325583523,350667893,55,280,3,300499153,In > Out
Sept 2021,160,121,411370,146218935804,884877643419,1031096579223,11602,22645,144,738658707615,In > Out
Sept 2021,160,122,391976,164713106470,713424989484,878138095954,10809,19494,928,548711883014,In > Out
Sept 2021,160,123,435584,174835824749,1131544858966,1306380683715,11134,20845,127,956709034217,In > Out
Sept 2021,160,124,416449,419204056600,1093708707782,1512912764382,11110,20481,459,674504651182,In > Out
Sept 2021,160,125,431210,149442318961,802917977794,952360296755,11132,18214,676,653475658833,In > Out
Sept 2021,160,126,399377,167155345830,975744394391,1142899740221,10223,19071,206,808589048561,In > Out
Sept 2021,160,127,577010,241713051359,956911342779,1198624394138,10738,20091,142,715198291420,In > Out
Sept 2021,160,128,98274,51829384255,240789837811,292619222066,5688,16562,64,188960453556,In > Out
Sept 2021,160,13,3683,666918759,3209475991,3876394750,373,3254,3,2542557232,In > Out
Sept 2021,160,130,3293,312393417,4543257388,4855650805,410,2979,7,4230863971,In > Out
Sept 2021,160,132,135955,34848280015,302252622410,337100902425,2788,17165,9,267404342395,In > Out
Sept 2021,160,14,1589,328821876,4262866087,4591687963,123,1286,2,3934044211,In > Out
Sept 2021,160,144,249,13612398,234545320,248157718,88,247,2,220932922,In > Out
Sept 2021,160,15,681,168336789,1319949202,1488285991,132,670,4,1151612413,In > Out
Sept 2021,160,152,651,1743156843,5952787629,7695944472,156,640,145,4209630786,In > Out
Sept 2021,160,153,617,1643551281,5724919095,7368470376,145,607,132,4081367814,In > Out
Sept 2021,160,154,619,1759219057,5952053581,7711272638,148,606,143,4192834524,In > Out
Sept 2021,160,155,616,2509122412,8081793304,10590915716,164,601,170,5572670892,In > Out
Sept 2021,160,156,657,2622638137,8544816289,11167454426,165,644,179,5922178152,In > Out
Sept 2021,160,157,620,2085815300,6900588483,8986403783,161,608,143,4814773183,In > Out
Sept 2021,160,16,300,94807780,214744535,309552315,81,295,4,119936755,In > Out
Sept 2021,160,200,110547,61159893286,320120941110,381280834396,7583,18050,191,258961047824,In > Out
Sept 2021,160,201,104001,72185957396,336979465456,409165422852,7606,17622,453,264793508060,In > Out
Sept 2021,160,202,108115,66253688393,306629152042,372882840435,7658,17021,299,240375463649,In > Out
Sept 2021,160,203,108818,54795177800,265045087035,319840264835,7779,17250,212,210249909235,In > Out
Sept 2021,160,216,110841,54335640365,28836891220,83172531585,29,49901,3,25498749145,Out > In
Sept 2021,160,235,3,134764,4689402,4824166,1,3,1,4554638,In > Out
Sept 2021,160,236,53,6894377,15940488,22834865,14,53,3,9046111,In > Out
Sept 2021,160,237,780,56416407,1632289047,1688705454,201,763,2,1575872640,In > Out
Sept 2021,160,238,11972,4780961560,17683668569,22464630129,683,8510,12,12902707009,In > Out
Sept 2021,160,239,212,35829093,136148174,171977267,105,212,4,100319081,In > Out
Sept 2021,160,240,326,115221221,1016405920,1131627141,170,318,7,901184699,In > Out
Sept 2021,160,241,657,1586529056,3344645142,4931174198,300,644,8,1758116086,In > Out
Sept 2021,160,242,175,559596089,370040291,929636380,81,175,9,189555798,Out > In
Sept 2021,160,243,270,17869762,258653616,276523378,114,269,4,240783854,In > Out
Sept 2021,160,244,753,997804310,3799582711,4797387021,259,743,10,2801778401,In > Out
Sept 2021,160,245,2254,2408129068,8355044474,10763173542,931,2178,6,5946915406,In > Out
Sept 2021,160,246,258,175095819,992797296,1167893115,103,258,5,817701477,In > Out
Sept 2021,160,247,816,556055664,2983912878,3539968542,328,796,5,2427857214,In > Out
Sept 2021,160,249,379,358408053,996691935,1355099988,127,376,4,638283882,In > Out
Sept 2021,160,33,4263,530418206,6038872963,6569291169,463,3836,9,5508454757,In > Out
Sept 2021,160,34,3769,5417709089,26684928901,32102637990,228,3411,7,21267219812,In > Out
Sept 2021,160,35,1783,951398245,3783654623,4735052868,180,1737,3,2832256378,In > Out
Sept 2021,160,36,2480,3839755098,4345908624,8185663722,196,2373,4,506153526,In > Out
Sept 2021,160,37,1514,672446300,35893508646,36565954946,147,1474,2,35221062346,In > Out
Sept 2021,160,38,2788,548515607,1497675903,2046191510,434,2579,2,949160296,In > Out
Sept 2021,160,39,1757,1028120737,1510517099,2538637836,188,1713,3,482396362,In > Out
Sept 2021,160,40,927,5970299047,614929190425,620899489472,82,917,94,608958891378,In > Out
Sept 2021,160,57,7706,1645300800,18286969158,19932269958,1021,6230,12,16641668358,In > Out
Sept 2021,160,58,9823,6394770994,48020128852,54414899846,1014,7363,12,41625357858,In > Out
Sept 2021,160,59,9255,2770646515,25739907671,28510554186,585,7516,6,22969261156,In > Out
Sept 2021,160,60,7865,1326981615,53223923740,54550905355,993,6628,9,51896942125,In > Out
Sept 2021,160,61,4381,1189758581,46298367628,47488126209,606,2621,12,45108609047,In > Out
Sept 2021,160,62,11947,2944695933,35776205250,38720901183,979,6783,10,32831509317,In > Out
Sept 2021,160,63,18064,76151791511,35453062345,111604853856,1260,11428,9,40698729166,Out > In
Sept 2021,160,65,39409,185559318926,261643206896,447202525822,2893,16223,109,76083887970,In > Out
Sept 2021,160,66,37677,13068921930,118726939294,131795861224,2679,18552,35,105658017364,In > Out
Sept 2021,160,67,36650,11814047396,103014720755,114828768151,2493,15924,64,91200673359,In > Out
Sept 2021,160,68,50767,56612711213,166450490625,223063201838,3485,16808,35,109837779412,In > Out
Sept 2021,160,69,46331,17741064920,127897765483,145638830403,3183,18234,20,110156700563,In > Out
Sept 2021,160,70,38367,10826190612,149288516906,160114707518,3325,15565,107,138462326294,In > Out
Sept 2021,160,71,51662,22742653444,113971514159,136714167603,3924,19351,19,91228860715,In > Out
Sept 2021,160,72,36412,15690687010,179218167651,194908854661,2632,15408,13,163527480641,In > Out
Sept 2021,160,73,9838,29551685875,200007040591,229558726466,718,7384,7,170455354716,In > Out
Sept 2021,160,74,6004,3222537240,20318751799,23541289039,455,5086,6,17096214559,In > Out
Sept 2021,160,75,6082,1993876026,17155991404,19149867430,487,4981,4,15162115378,In > Out
Sept 2021,160,76,9522,3209798892,22406048546,25615847438,794,7128,8,19196249654,In > Out
Sept 2021,160,77,11676,2312093762,34050329050,36362422812,762,8229,6,31738235288,In > Out
Sept 2021,160,78,8027,1691267431,21210878008,22902145439,694,6218,6,19519610577,In > Out
Sept 2021,160,79,127816,14504520938,300586750446,315091271384,5145,18786,32,286082229508,In > Out
Sept 2021,160,80,103810,13349521987,275593212673,288942734660,4386,18323,11,262243690686,In > Out
Sept 2021,160,81,4540,725131886,6760793023,7485924909,828,3887,8,6035661137,In > Out
Sept 2021,160,82,133,13172141,188696345,201868486,16,133,2,175524204,In > Out
Sept 2021,160,83,3544,852645863,4570490542,5423136405,669,3203,6,3717844679,In > Out
Sept 2021,160,84,84,7437805,366022267,373460072,19,84,2,358584462,In > Out
Sept 2021,160,86,955,202699625,1169382837,1372082462,183,919,5,966683212,In > Out
Sept 2021,160,87,1587,396486481,1557902604,1954389085,258,1527,5,1161416123,In > Out
Sept 2021,160,88,160,13893482,349299023,363192505,19,160,2,335405541,In > Out
Sept 2021,160,9,17007,666324030,5190058719,5856382749,177,11849,2,4523734689,In > Out
Sept 2021,161,10,487,300025284,2297491510,2597516794,207,479,10,1997466226,In > Out
Sept 2021,161,100,459,83338837,1672140059,1755478896,175,452,3,1588801222,In > Out
Sept 2021,161,102,601,2857611289,5834443808,8692055097,229,598,7,2976832519,In > Out
Sept 2021,161,103,1785,234389245,3242651821,3477041066,280,1705,5,3008262576,In > Out
Sept 2021,161,105,939,299917969,20232541321,20532459290,347,927,5,19932623352,In > Out
Sept 2021,161,107,391,23852464,578010984,601863448,106,388,3,554158520,In > Out
Sept 2021,161,109,133,52029769,2464778597,2516808366,60,133,2,2412748828,In > Out
Sept 2021,161,11,1143,365654730,23516244778,23881899508,393,1123,4,23150590048,In > Out
Sept 2021,161,110,410,71697650,720756316,792453966,119,408,4,649058666,In > Out
Sept 2021,161,111,21,14537375,34166866,48704241,14,21,2,19629491,In > Out
Sept 2021,161,112,409,72559552,2688223384,2760782936,118,401,2,2615663832,In > Out
Sept 2021,161,113,789,307751753,1653355299,1961107052,271,762,6,1345603546,In > Out
Sept 2021,161,115,455,95944372,3203563671,3299508043,170,450,4,3107619299,In > Out
Sept 2021,161,116,329,135838635,1293016110,1428854745,153,327,4,1157177475,In > Out
Sept 2021,161,117,476,603899935,1537624960,2141524895,140,472,7,933725025,In > Out
Sept 2021,161,118,173,5733236,69938910,75672146,22,172,2,64205674,In > Out
Sept 2021,161,119,597,270425730,1894485605,2164911335,193,578,4,1624059875,In > Out
Sept 2021,161,121,247,119666479,6200302933,6319969412,73,238,6,6080636454,In > Out
Sept 2021,161,124,1311,396114566,4406065274,4802179840,344,1280,5,4009950708,In > Out
Sept 2021,161,127,164,30852221,1268308144,1299160365,78,164,2,1237455923,In > Out
Sept 2021,161,129,889,236798807,3316700108,3553498915,175,875,4,3079901301,In > Out
Sept 2021,161,13,359,209093791,2495145845,2704239636,164,358,2,2286052054,In > Out
Sept 2021,161,130,1520,296370526,5405684142,5702054668,386,1475,7,5109313616,In > Out
Sept 2021,161,132,1217,529784318,5159897581,5689681899,306,1174,9,4630113263,In > Out
Sept 2021,161,133,2301,864419458,7184793984,8049213442,459,2237,7,6320374526,In > Out
Sept 2021,161,135,1054,247730786,2417437509,2665168295,316,1021,15,2169706723,In > Out
Sept 2021,161,138,282,69389431,5023145335,5092534766,130,277,10,4953755904,In > Out
Sept 2021,161,139,433,133641237,1165069615,1298710852,143,426,11,1031428378,In > Out
Sept 2021,161,14,557,239305973,3664956644,3904262617,247,549,6,3425650671,In > Out
Sept 2021,161,141,256,38003949,726484908,764488857,132,255,4,688480959,In > Out
Sept 2021,161,142,1401,380016842,5783222660,6163239502,235,1395,6,5403205818,In > Out
Sept 2021,161,144,1815,1255347328,3959519428,5214866756,276,1753,5,2704172100,In > Out
Sept 2021,161,145,955,74782297,4681584060,4756366357,323,940,4,4606801763,In > Out
Sept 2021,161,147,410,32227173,1081241514,1113468687,150,395,3,1049014341,In > Out
Sept 2021,161,148,422,59984726,831238575,891223301,202,415,5,771253849,In > Out
Sept 2021,161,151,783,215823949,6841000945,7056824894,199,769,4,6625176996,In > Out
Sept 2021,161,152,368,35910721,916626209,952536930,121,365,6,880715488,In > Out
Sept 2021,161,153,162,398372354,2670795360,3069167714,77,161,6,2272423006,In > Out
Sept 2021,161,157,538,68694843,1649651587,1718346430,234,516,4,1580956744,In > Out
Sept 2021,161,159,1035,592306675,4905958155,5498264830,292,1019,7,4313651480,In > Out
Sept 2021,161,16,390,259030955,2209452790,2468483745,109,386,5,1950421835,In > Out
Sept 2021,161,160,154,46548849,1492284101,1538832950,68,153,3,1445735252,In > Out
Sept 2021,161,161,387,48727394,844426943,893154337,146,384,5,795699549,In > Out
Sept 2021,161,162,566,83004234,3240088236,3323092470,180,551,6,3157084002,In > Out
Sept 2021,161,165,521,47760210,1215684718,1263444928,177,509,5,1167924508,In > Out
Sept 2021,161,166,1130,155039410,6793543370,6948582780,272,1118,6,6638503960,In > Out
Sept 2021,161,167,958,131185618,4103917407,4235103025,200,936,4,3972731789,In > Out
Sept 2021,161,168,412,60282986,958306997,1018589983,185,398,3,898024011,In > Out
Sept 2021,161,169,312,42419572,852683453,895103025,66,308,6,810263881,In > Out
Sept 2021,161,17,1090,99181898,3844733677,3943915575,311,1084,8,3745551779,In > Out
Sept 2021,161,171,830,631286513,15441548801,16072835314,215,818,4,14810262288,In > Out
Sept 2021,161,173,797,703340770,2130884231,2834225001,256,783,10,1427543461,In > Out
Sept 2021,161,174,1519,5255256662,21438797734,26694054396,445,1499,8,16183541072,In > Out
Sept 2021,161,176,627,2066956115,4650136046,6717092161,170,607,11,2583179931,In > Out
Sept 2021,161,177,207,263581041,752217858,1015798899,65,207,4,488636817,In > Out
Sept 2021,161,178,857,8799674721,20959180682,29758855403,111,836,8,12159505961,In > Out
Sept 2021,161,18,247,170346632,1715219877,1885566509,120,246,3,1544873245,In > Out
Sept 2021,161,180,207,61361710,337561335,398923045,89,207,2,276199625,In > Out
Sept 2021,161,181,844,151344997,2303134160,2454479157,328,828,4,2151789163,In > Out
Sept 2021,161,182,238,421119700,1347923932,1769043632,114,237,4,926804232,In > Out
Sept 2021,161,183,83,4050573,157778344,161828917,22,83,2,153727771,In > Out
Sept 2021,161,184,425,46977990,1544525775,1591503765,119,423,4,1497547785,In > Out
Sept 2021,161,186,105,12188215,424239660,436427875,44,105,2,412051445,In > Out
Sept 2021,161,187,342,239912992,13059361970,13299274962,123,339,4,12819448978,In > Out
Sept 2021,161,188,131,82696124,393796023,476492147,64,130,7,311099899,In > Out
Sept 2021,161,189,424,145999071,3062476530,3208475601,98,421,3,2916477459,In > Out
Sept 2021,161,190,156,11703678,179264020,190967698,39,156,4,167560342,In > Out
Sept 2021,161,192,164,49590609,1017851406,1067442015,62,164,3,968260797,In > Out
Sept 2021,161,193,649,82162587,4762441659,4844604246,191,646,4,4680279072,In > Out
Sept 2021,161,194,1186,10132234749,19329011386,29461246135,329,1140,11,9196776637,In > Out
Sept 2021,161,195,67,31652932,1531015682,1562668614,37,66,2,1499362750,In > Out
Sept 2021,161,196,617,69092850,1205401800,1274494650,169,606,4,1136308950,In > Out
Sept 2021,161,197,840,498157199,6305812097,6803969296,188,825,2,5807654898,In > Out
Sept 2021,161,198,478,56493890,766391822,822885712,222,434,9,709897932,In > Out
Sept 2021,161,20,2231,2804373820,12636742255,15441116075,506,2113,11,9832368435,In > Out
Sept 2021,161,200,480,169682397,5384209993,5553892390,124,475,4,5214527596,In > Out
Sept 2021,161,201,127,188149782,82956636,271106418,69,126,2,105193146,Out > In
Sept 2021,161,202,632,120876685,1966362982,2087239667,170,619,3,1845486297,In > Out
Sept 2021,161,203,90,16575619,404553813,421129432,47,90,3,387978194,In > Out
Sept 2021,161,204,503,93036994,1710597141,1803634135,197,502,5,1617560147,In > Out
Sept 2021,161,206,916,271770961,5053329881,5325100842,245,890,5,4781558920,In > Out
Sept 2021,161,208,444,48901397,2380452984,2429354381,144,442,3,2331551587,In > Out
Sept 2021,161,209,369,345452102,1807105478,2152557580,134,354,5,1461653376,In > Out
Sept 2021,161,21,1209,957003968,5899538435,6856542403,354,1186,14,4942534467,In > Out
Sept 2021,161,210,294,89087969,6025296030,6114383999,90,292,3,5936208061,In > Out
Sept 2021,161,211,466,178898388,21286962499,21465860887,193,464,4,21108064111,In > Out
Sept 2021,161,212,1212,286413741,6977216266,7263630007,117,1168,3,6690802525,In > Out
Sept 2021,161,213,953,1253170700,5425487218,6678657918,325,917,7,4172316518,In > Out
Sept 2021,161,215,492,258662768,2566483365,2825146133,139,486,3,2307820597,In > Out
Sept 2021,161,217,538,429800208,12188784196,12618584404,141,531,5,11758983988,In > Out
Sept 2021,161,220,653,610892295,1587975613,2198867908,117,649,8,977083318,In > Out
Sept 2021,161,221,279,129665038,261330528,390995566,109,273,5,131665490,In > Out
Sept 2021,161,24,601,84533307,1723542362,1808075669,224,588,6,1639009055,In > Out
Sept 2021,161,25,302,22106967,397238651,419345618,107,302,5,375131684,In > Out
Sept 2021,161,26,528,154161949,1428878747,1583040696,139,519,4,1274716798,In > Out
Sept 2021,161,27,474,69972626,1588438855,1658411481,175,472,5,1518466229,In > Out
Sept 2021,161,28,2783,1072326749,14996168327,16068495076,507,2690,6,13923841578,In > Out
Sept 2021,161,30,5470,769289159,42743552295,43512841454,830,4850,7,41974263136,In > Out
Sept 2021,161,31,969,521902339,7936210603,8458112942,261,949,5,7414308264,In > Out
Sept 2021,161,32,1128,117581374,7157683069,7275264443,342,1095,9,7040101695,In > Out
Sept 2021,161,33,509,96928185,6328922027,6425850212,119,508,3,6231993842,In > Out
Sept 2021,161,34,426,386404414,1341465741,1727870155,147,423,6,955061327,In > Out
Sept 2021,161,35,1472,1067430844,5617876364,6685307208,334,1438,9,4550445520,In > Out
Sept 2021,161,36,537,149501136,1653128178,1802629314,228,536,8,1503627042,In > Out
Sept 2021,161,37,318,30150155,1051301422,1081451577,167,314,4,1021151267,In > Out
Sept 2021,161,38,511,279586189,1070525940,1350112129,197,501,5,790939751,In > Out
Sept 2021,161,39,489,84493606,5194547823,5279041429,195,484,2,5110054217,In > Out
Sept 2021,161,4,835,115553598,2158884224,2274437822,181,820,3,2043330626,In > Out
Sept 2021,161,40,188,17737681,209440656,227178337,77,188,3,191702975,In > Out
Sept 2021,161,42,1785,1032351603,8089522171,9121873774,376,1695,24,7057170568,In > Out
Sept 2021,161,43,344,512293404,1000445685,1512739089,124,342,3,488152281,In > Out
Sept 2021,161,44,577,219870257,11708225291,11928095548,249,567,5,11488355034,In > Out
Sept 2021,161,46,142,20881767,284045994,304927761,57,139,3,263164227,In > Out
Sept 2021,161,47,796,336642467,13244574902,13581217369,300,784,6,12907932435,In > Out
Sept 2021,161,49,361,886070735,1849556059,2735626794,144,355,3,963485324,In > Out
Sept 2021,161,5,135,53963953,1315076222,1369040175,80,135,5,1261112269,In > Out
Sept 2021,161,50,166,77224270,548178332,625402602,55,165,4,470954062,In > Out
Sept 2021,161,51,265,3470291709,3983595356,7453887065,93,262,9,513303647,In > Out
Sept 2021,161,52,225,488761851,9065224709,9553986560,75,224,6,8576462858,In > Out
Sept 2021,161,53,431,233449953,902137261,1135587214,131,429,5,668687308,In > Out
Sept 2021,161,54,826,814410996,1358354498,2172765494,239,810,6,543943502,In > Out
Sept 2021,161,55,1408,3347395790,5129170949,8476566739,356,1387,9,1781775159,In > Out
Sept 2021,161,56,1906,160690167,7580155966,7740846133,254,1807,8,7419465799,In > Out
Sept 2021,161,57,577,1924291819,3431980485,5356272304,201,571,6,1507688666,In > Out
Sept 2021,161,58,269,40508885,893421049,933929934,86,269,3,852912164,In > Out
Sept 2021,161,6,846,735695629,3214839543,3950535172,339,836,6,2479143914,In > Out
Sept 2021,161,60,210,19190074,599676307,618866381,107,209,2,580486233,In > Out
Sept 2021,161,62,56,11206821,426559207,437766028,23,56,2,415352386,In > Out
Sept 2021,161,63,371,67274648,1330629272,1397903920,91,368,3,1263354624,In > Out
Sept 2021,161,64,1911,108112391,4151461471,4259573862,413,1794,2,4043349080,In > Out
Sept 2021,161,65,1329,1006970149,9217251399,10224221548,402,1289,7,8210281250,In > Out
Sept 2021,161,66,608,178497753,4665524532,4844022285,261,597,6,4487026779,In > Out
Sept 2021,161,67,830,74423169,1262019254,1336442423,198,824,2,1187596085,In > Out
Sept 2021,161,68,952,204445148,7739481337,7943926485,286,926,17,7535036189,In > Out
Sept 2021,161,69,366,59887835,1827661302,1887549137,146,363,4,1767773467,In > Out
Sept 2021,161,7,579,1698045672,1193981692,2892027364,194,564,6,504063980,Out > In
Sept 2021,161,70,1943,957833837,12472081818,13429915655,322,1812,14,11514247981,In > Out
Sept 2021,161,72,619,160572913,10736457079,10897029992,187,581,1,10575884166,In > Out
Sept 2021,161,75,725,373770338,3571158485,3944928823,273,715,5,3197388147,In > Out
Sept 2021,161,76,781,777476855,1949297267,2726774122,200,774,3,1171820412,In > Out
Sept 2021,161,77,371,53374511,2553107052,2606481563,93,370,4,2499732541,In > Out
Sept 2021,161,78,269,64354002,1281724695,1346078697,122,265,2,1217370693,In > Out
Sept 2021,161,8,473,143101105,968370275,1111471380,194,461,5,825269170,In > Out
Sept 2021,161,80,497,248395397,2348635544,2597030941,189,490,7,2100240147,In > Out
Sept 2021,161,82,62,20891983,883016904,903908887,31,62,3,862124921,In > Out
Sept 2021,161,83,1068,142140953,2882051137,3024192090,367,1045,7,2739910184,In > Out
Sept 2021,161,84,2109,2627389120,3920373612,6547762732,252,2049,19,1292984492,In > Out
Sept 2021,161,86,552,97654010,1701227845,1798881855,207,544,5,1603573835,In > Out
Sept 2021,161,87,2205,354962610,12307444653,12662407263,464,2104,5,11952482043,In > Out
Sept 2021,161,88,328,70020422,4122581846,4192602268,119,323,4,4052561424,In > Out
Sept 2021,161,90,258,28585874,631201049,659786923,157,254,4,602615175,In > Out
Sept 2021,161,91,1512,117469411,6106060750,6223530161,200,1476,8,5988591339,In > Out
Sept 2021,161,94,367,2574062230,722664442,3296726672,121,362,9,1851397788,Out > In
Sept 2021,161,95,956,255883662,5336014796,5591898458,231,905,5,5080131134,In > Out
Sept 2021,161,96,183,141069045,1083429048,1224498093,77,182,2,942360003,In > Out
Sept 2021,161,97,652,84782349,2611069733,2695852082,258,640,2,2526287384,In > Out
Sept 2021,161,99,1214,140856615,4972588528,5113445143,428,1171,10,4831731913,In > Out
Sept 2021,164,127,913,129758923,140197564,269956487,25,889,2,10438641,In > Out
Sept 2021,164,141,127,2065025,32770488,34835513,36,127,2,30705463,In > Out
Sept 2021,164,147,1,207599,13635866,13843465,1,1,1,13428267,In > Out
Sept 2021,164,153,120,8528616,244084306,252612922,70,119,2,235555690,In > Out
Sept 2021,164,158,929,30672079,974102075,1004774154,180,906,6,943429996,In > Out
Sept 2021,164,159,1446,242459848,3118852632,3361312480,374,1384,3,2876392784,In > Out
Sept 2021,164,166,455,162819546,2282962477,2445782023,81,442,2,2120142931,In > Out
Sept 2021,164,188,7,839059,27358853,28197912,6,7,1,26519794,In > Out
Sept 2021,164,77,26,332100,27426385,27758485,6,26,2,27094285,In > Out
Sept 2021,164,82,72,122958206,115846456,238804662,3,72,2,7111750,Out > In
Sept 2021,165,106,10,53602,1452552,1506154,5,10,2,1398950,In > Out
Sept 2021,165,108,3163,927855361,5117208226,6045063587,471,2853,9,4189352865,In > Out
Sept 2021,165,131,101,6874157,644106823,650980980,19,101,3,637232666,In > Out
Sept 2021,165,152,917,76129821,1606670434,1682800255,306,883,5,1530540613,In > Out
Sept 2021,165,165,8747,3376129001,49804494623,53180623624,1463,6759,5,46428365622,In > Out
Sept 2021,165,187,2384,326319283,822778814,1149098097,142,2216,2,496459531,In > Out
Sept 2021,165,189,474,22941230810,1503030071,24444260881,101,464,4,21438200739,Out > In
Sept 2021,165,193,1245,224556373,2702427896,2926984269,152,1207,2,2477871523,In > Out
Sept 2021,165,195,51,8370955,276130497,284501452,33,51,2,267759542,In > Out
Sept 2021,165,198,1984,449535747,2046189256,2495725003,150,1876,3,1596653509,In > Out
Sept 2021,165,199,1982,316471824,2987636519,3304108343,424,1848,6,2671164695,In > Out
Sept 2021,165,202,991,80086154,2133867597,2213953751,334,958,3,2053781443,In > Out
Sept 2021,165,231,194,19911447,485971681,505883128,40,192,2,466060234,In > Out
Sept 2021,165,234,285,202127177,1689512186,1891639363,144,281,4,1487385009,In > Out
Sept 2021,165,235,204,20032139,630577546,650609685,47,203,2,610545407,In > Out
Sept 2021,165,39,53,5869905,62651619,68521524,13,49,7,56781714,In > Out
Sept 2021,165,43,1641,505773194,10535769596,11041542790,524,1568,11,10029996402,In > Out
Sept 2021,165,50,1800,382878532,7883674903,8266553435,212,1716,2,7500796371,In > Out
Sept 2021,165,67,442,59511014,612888657,672399671,61,441,2,553377643,In > Out
Sept 2021,165,80,7,27689715,2051485199,2079174914,4,7,1,2023795484,In > Out
Sept 2021,165,92,2465,351507222,944465525,1295972747,157,2283,2,592958303,In > Out
Sept 2021,165,93,380,74632600,764052277,838684877,83,377,3,689419677,In > Out
Sept 2021,165,94,12,795955,2916848,3712803,6,12,2,2120893,In > Out
Sept 2021,166,138,1192,363370601,5103953480,5467324081,225,1191,5,4740582879,In > Out
Sept 2021,166,146,277,36703482,1508624068,1545327550,47,276,2,1471920586,In > Out
Sept 2021,166,165,51,3004676,79464511,82469187,17,51,2,76459835,In > Out
Sept 2021,166,167,1227,210545280,1597962106,1808507386,309,1192,2,1387416826,In > Out
Sept 2021,166,192,277,1493349717,185487304,1678837021,126,277,1,1307862413,Out > In
Sept 2021,166,193,64,3333158,34081327,37414485,13,64,1,30748169,In > Out
Sept 2021,167,117,761,108255074,2130130338,2238385412,153,738,2,2021875264,In > Out
Sept 2021,167,118,3246,362022384,1298766119,1660788503,278,2969,3,936743735,In > Out
Sept 2021,167,121,389,40830956,1842906104,1883737060,54,384,2,1802075148,In > Out
Sept 2021,167,127,660,97394961,1196221399,1293616360,192,649,2,1098826438,In > Out
Sept 2021,167,139,547,112413490,2096324287,2208737777,63,544,2,1983910797,In > Out
Sept 2021,167,156,118,6302451,193408927,199711378,10,117,2,187106476,In > Out
Sept 2021,167,174,2178,264495366,3170330586,3434825952,185,2076,2,2905835220,In > Out
Sept 2021,167,188,5,470082,32236270,32706352,5,5,2,31766188,In > Out
Sept 2021,167,189,120,4820000,57977999,62797999,12,120,2,53157999,In > Out
Sept 2021,167,19,604,194143173,1818829898,2012973071,74,599,2,1624686725,In > Out
Sept 2021,167,232,1909,172069984,3783261011,3955330995,294,1816,2,3611191027,In > Out
Sept 2021,167,26,725,32474063,1483214996,1515689059,279,711,2,1450740933,In > Out
Sept 2021,167,35,236,25887250,489728556,515615806,37,235,2,463841306,In > Out
Sept 2021,168,111,479,24927776,88457744,113385520,27,475,2,63529968,In > Out
Sept 2021,168,114,663,97752814,1911294798,2009047612,49,657,2,1813541984,In > Out
Sept 2021,168,116,159,26183940,1022465904,1048649844,70,159,2,996281964,In > Out
Sept 2021,168,123,892,90962669,837217948,928180617,251,868,3,746255279,In > Out
Sept 2021,168,132,811,442491178,2775468486,3217959664,154,789,4,2332977308,In > Out
Sept 2021,168,136,2245,1479212716,957998955,2437211671,174,2169,3,521213761,Out > In
Sept 2021,168,148,383,39286124,86966067,126252191,29,380,3,47679943,In > Out
Sept 2021,168,153,25,2419543,88203317,90622860,10,25,2,85783774,In > Out
Sept 2021,168,154,995,199503664,3438897629,3638401293,72,970,2,3239393965,In > Out
Sept 2021,168,155,3079,24443263940,2151256651,26594520591,578,1312,1459,22292007289,Out > In
Sept 2021,168,162,279,40054832,2328015255,2368070087,38,278,2,2287960423,In > Out
Sept 2021,168,17,108,2942192,104467612,107409804,5,108,2,101525420,In > Out
Sept 2021,168,173,93,8604924,312428997,321033921,10,93,2,303824073,In > Out
Sept 2021,168,176,20,4573432,34857338,39430770,11,20,2,30283906,In > Out
Sept 2021,168,186,7,954993,19123,974116,7,1,7,935870,Out > In
Sept 2021,168,193,413,53392687,3604749746,3658142433,55,413,2,3551357059,In > Out
Sept 2021,168,195,455,147189133,1223634369,1370823502,59,452,2,1076445236,In > Out
Sept 2021,168,201,57,6521605,242166881,248688486,27,57,2,235645276,In > Out
Sept 2021,168,205,659,99618792,1597295715,1696914507,58,647,2,1497676923,In > Out
Sept 2021,168,219,151,21237142,1107679410,1128916552,59,151,2,1086442268,In > Out
Sept 2021,168,22,369,124134925,987123097,1111258022,35,365,2,862988172,In > Out
Sept 2021,168,23,5,1774434,64436558,66210992,4,5,1,62662124,In > Out
Sept 2021,168,24,1,3144,171122,174266,1,1,1,167978,In > Out
Sept 2021,168,37,730,2158266987,3191835981,5350102968,267,722,7,1033568994,In > Out
Sept 2021,168,42,1895,171305843,3344591823,3515897666,299,1794,2,3173285980,In > Out
Sept 2021,168,48,24,394107,26846555,27240662,4,24,1,26452448,In > Out
Sept 2021,168,55,118,10066376,254809891,264876267,30,118,2,244743515,In > Out
Sept 2021,168,7,153,23279005,670531835,693810840,73,150,2,647252830,In > Out
Sept 2021,168,73,416,38483511,462377129,500860640,34,416,2,423893618,In > Out
Sept 2021,168,74,1,125533,4659674,4785207,1,1,1,4534141,In > Out
Sept 2021,168,97,1766,645793948,4710318093,5356112041,314,1669,2,4064524145,In > Out
Sept 2021,169,156,1,9731,1122036,1131767,1,1,1,1112305,In > Out
Sept 2021,169,157,143,14786146,286472390,301258536,37,140,2,271686244,In > Out
Sept 2021,169,163,36,1162895,27586482,28749377,8,36,1,26423587,In > Out
Sept 2021,169,164,1531,164834340,2059628901,2224463241,498,1453,2,1894794561,In > Out
Sept 2021,169,168,58,9815845,172374488,182190333,38,58,2,162558643,In > Out
Sept 2021,169,187,516,162084993,1456475812,1618560805,100,510,2,1294390819,In > Out
Sept 2021,169,193,41,1143104,27868909,29012013,11,41,1,26725805,In > Out
Sept 2021,169,194,80,748138190,79755541555,80503679745,16,80,1,79007403365,In > Out
Sept 2021,169,6,13892,34811339757,846211225,35657550982,1326,9625,4,33965128532,Out > In
Sept 2021,169,8,4,579700064,20967991890,21547691954,2,1,4,20388291826,In > Out
Sept 2021,170,13,383,53411956,5399227573,5452639529,81,379,2,5345815617,In > Out
Sept 2021,170,15,43,20032398,32031586,52063984,17,11,34,11999188,In > Out
Sept 2021,170,164,209,15659548,198254171,213913719,58,208,2,182594623,In > Out
Sept 2021,170,172,44,2698053,36076114,38774167,22,44,2,33378061,In > Out
Sept 2021,170,187,1313,616030412,2712037889,3328068301,324,1251,3,2096007477,In > Out
Sept 2021,170,190,1320,130349432,4975314067,5105663499,450,1273,4,4844964635,In > Out
Sept 2021,170,192,107,17672185,414848075,432520260,10,107,2,397175890,In > Out
Sept 2021,170,194,781,121106950,1523140131,1644247081,229,766,3,1402033181,In > Out
Sept 2021,170,197,2902,213456146,1452353038,1665809184,386,2702,2,1238896892,In > Out
Sept 2021,170,198,144,5504244,118527045,124031289,22,144,2,113022801,In > Out
Sept 2021,170,203,1136,142367504,720163038,862530542,348,1000,2,577795534,In > Out
Sept 2021,170,208,210,42316928,110056917,152373845,17,209,2,67739989,In > Out
Sept 2021,170,221,17,508041,47397277,47905318,9,17,2,46889236,In > Out
Sept 2021,170,227,7,289480,805234,1094714,4,7,1,515754,In > Out
Sept 2021,170,229,2237,378137177,4526501629,4904638806,359,2107,6,4148364452,In > Out
Sept 2021,170,232,516,31123753,1572049381,1603173134,207,516,2,1540925628,In > Out
Sept 2021,170,234,110,5502639,177601359,183103998,19,110,2,172098720,In > Out
Sept 2021,170,236,659,74643047,1853453073,1928096120,105,642,3,1778810026,In > Out
Sept 2021,170,240,424,25128782,536926693,562055475,87,419,2,511797911,In > Out
Sept 2021,170,244,834,109607988,516228551,625836539,34,834,2,406620563,In > Out
Sept 2021,170,28,61,14539516,617624412,632163928,21,61,2,603084896,In > Out
Sept 2021,170,34,81,3601746,47746052,51347798,10,80,2,44144306,In > Out
Sept 2021,170,37,171,5935208,83668495,89603703,51,171,2,77733287,In > Out
Sept 2021,170,42,280,22324942,1436686571,1459011513,27,279,3,1414361629,In > Out
Sept 2021,170,45,308,525523409,1295415891,1820939300,256,307,3,769892482,In > Out
Sept 2021,170,47,235,133595039,4506877495,4640472534,61,232,3,4373282456,In > Out
Sept 2021,170,51,75,23748163,1073034061,1096782224,25,75,2,1049285898,In > Out
Sept 2021,170,59,311,9647288,24638909,34286197,1,311,1,14991621,In > Out
Sept 2021,170,66,198,40569962,195195130,235765092,42,198,2,154625168,In > Out
Sept 2021,170,68,753,121220056,1309969117,1431189173,63,735,2,1188749061,In > Out
Sept 2021,170,73,1442,203810847,607238787,811049634,189,1395,2,403427940,In > Out
Sept 2021,171,10,365,69861195,3043043153,3112904348,143,361,5,2973181958,In > Out
Sept 2021,171,100,27,1051985,85247454,86299439,18,27,2,84195469,In > Out
Sept 2021,171,101,3092,1279826174,33842341573,35122167747,738,2867,7,32562515399,In > Out
Sept 2021,171,102,465,595784361,7174833182,7770617543,218,461,4,6579048821,In > Out
Sept 2021,171,103,367,33284137,1597856252,1631140389,111,363,3,1564572115,In > Out
Sept 2021,171,104,868,166468729,3788780481,3955249210,221,853,5,3622311752,In > Out
Sept 2021,171,105,418,150179963,1331706017,1481885980,170,413,3,1181526054,In > Out
Sept 2021,171,107,632,239633317,1912657083,2152290400,202,624,4,1673023766,In > Out
Sept 2021,171,108,230,25645095,897252801,922897896,116,229,3,871607706,In > Out
Sept 2021,171,109,907,265560662,3194664617,3460225279,288,897,5,2929103955,In > Out
Sept 2021,171,112,1557,140954834,3910405695,4051360529,377,1521,5,3769450861,In > Out
Sept 2021,171,114,506,133245270,4773051197,4906296467,158,499,2,4639805927,In > Out
Sept 2021,171,115,2527,162121437,7356770977,7518892414,393,2375,5,7194649540,In > Out
Sept 2021,171,116,198,372355583,400722710,773078293,106,197,3,28367127,In > Out
Sept 2021,171,118,222,43004191,205811292,248815483,96,221,4,162807101,In > Out
Sept 2021,171,119,1888,2748526053,12564915379,15313441432,317,1813,9,9816389326,In > Out
Sept 2021,171,120,1329,357754414,2423885958,2781640372,447,1292,8,2066131544,In > Out
Sept 2021,171,122,427,555903115,7441018265,7996921380,228,422,9,6885115150,In > Out
Sept 2021,171,123,1183,1600684007,14277161080,15877845087,439,1162,7,12676477073,In > Out
Sept 2021,171,125,770,103446474,5311429956,5414876430,196,759,6,5207983482,In > Out
Sept 2021,171,127,686,141175840,8283685525,8424861365,108,685,6,8142509685,In > Out
Sept 2021,171,128,735,204528528,2893625020,3098153548,184,722,5,2689096492,In > Out
Sept 2021,171,129,212,11370551,854897480,866268031,89,212,2,843526929,In > Out
Sept 2021,171,130,1708,200296270,5649339680,5849635950,289,1645,3,5449043410,In > Out
Sept 2021,171,131,1026,1593651221,17930763382,19524414603,292,1018,41,16337112161,In > Out
Sept 2021,171,132,970,140876978,1804144625,1945021603,262,940,6,1663267647,In > Out
Sept 2021,171,133,839,2011861293,3796299510,5808160803,296,807,8,1784438217,In > Out
Sept 2021,171,134,1033,2384500351,7347873057,9732373408,281,1018,10,4963372706,In > Out
Sept 2021,171,135,360,20433071,684513145,704946216,159,354,2,664080074,In > Out
Sept 2021,171,136,426,130080286,2944112154,3074192440,143,426,4,2814031868,In > Out
Sept 2021,171,137,687,142205741,4536057395,4678263136,245,677,2,4393851654,In > Out
Sept 2021,171,138,375,36108834,619880377,655989211,129,373,5,583771543,In > Out
Sept 2021,171,139,572,313675416,2779578682,3093254098,204,570,7,2465903266,In > Out
Sept 2021,171,140,334,360937546,415666543,776604089,113,329,3,54728997,In > Out
Sept 2021,171,141,1232,173373822,6585833387,6759207209,279,1198,5,6412459565,In > Out
Sept 2021,171,142,1479,606575855,30575266685,31181842540,280,1425,8,29968690830,In > Out
Sept 2021,171,143,1744,715401377,5869166391,6584567768,233,1671,8,5153765014,In > Out
Sept 2021,171,144,1360,751362580,2858699135,3610061715,414,1307,3,2107336555,In > Out
Sept 2021,171,145,175,29012977,475242520,504255497,105,175,2,446229543,In > Out
Sept 2021,171,146,872,374148751,4834291997,5208440748,194,857,3,4460143246,In > Out
Sept 2021,171,147,2254,978214588,4166586733,5144801321,388,2190,9,3188372145,In > Out
Sept 2021,171,148,535,10635355321,18563839693,29199195014,153,531,10,7928484372,In > Out
Sept 2021,171,149,448,42969273,2214698631,2257667904,216,441,4,2171729358,In > Out
Sept 2021,171,15,678,1168745800,4971910480,6140656280,245,653,17,3803164680,In > Out
Sept 2021,171,150,848,174436998,9831917866,10006354864,287,827,5,9657480868,In > Out
Sept 2021,171,151,526,123580665,821620628,945201293,127,523,6,698039963,In > Out
Sept 2021,171,152,200,2125524506,2708678827,4834203333,114,198,5,583154321,In > Out
Sept 2021,171,153,373,93138177,1394430736,1487568913,123,371,3,1301292559,In > Out
Sept 2021,171,154,799,448967396,6246642536,6695609932,223,790,8,5797675140,In > Out
Sept 2021,171,156,403,115112433,3683822089,3798934522,126,402,6,3568709656,In > Out
Sept 2021,171,157,174,18799732,538508180,557307912,81,174,3,519708448,In > Out
Sept 2021,171,158,876,126052986,1582030543,1708083529,311,852,4,1455977557,In > Out
Sept 2021,171,159,240,53135675,899158042,952293717,112,239,4,846022367,In > Out
Sept 2021,171,16,624,123115861,1048311155,1171427016,208,610,4,925195294,In > Out
Sept 2021,171,161,1691,434199520,9145876140,9580075660,272,1631,9,8711676620,In > Out
Sept 2021,171,163,1330,726963756,10119964341,10846928097,380,1297,8,9393000585,In > Out
Sept 2021,171,164,772,57792300,4212216954,4270009254,99,769,5,4154424654,In > Out
Sept 2021,171,165,1268,760393051,14632544132,15392937183,361,1209,14,13872151081,In > Out
Sept 2021,171,166,1545,244834342,7078613986,7323448328,404,1508,5,6833779644,In > Out
Sept 2021,171,167,857,150178776,3661290878,3811469654,196,829,3,3511112102,In > Out
Sept 2021,171,168,1232,244700358,7005607484,7250307842,402,1180,6,6760907126,In > Out
Sept 2021,171,17,2556,391465312,9796979864,10188445176,563,2404,7,9405514552,In > Out
Sept 2021,171,171,1000,174326477,5049925237,5224251714,265,999,4,4875598760,In > Out
Sept 2021,171,172,1012,122225873,2721728486,2843954359,315,930,91,2599502613,In > Out
Sept 2021,171,173,151,33334531,1355601150,1388935681,74,151,1,1322266619,In > Out
Sept 2021,171,174,750,327397501,2037054668,2364452169,302,709,26,1709657167,In > Out
Sept 2021,171,175,423,58953028,1502803769,1561756797,107,422,1,1443850741,In > Out
Sept 2021,171,177,708,51129136,1824231218,1875360354,175,701,5,1773102082,In > Out
Sept 2021,171,179,539,188722447,7324600677,7513323124,198,529,5,7135878230,In > Out
Sept 2021,171,181,538,301473733,1546201673,1847675406,207,538,7,1244727940,In > Out
Sept 2021,171,184,936,175176473,3856370441,4031546914,173,894,4,3681193968,In > Out
Sept 2021,171,185,684,165598399,11593739692,11759338091,224,665,7,11428141293,In > Out
Sept 2021,171,186,255,189677853,388993815,578671668,90,255,1,199315962,In > Out
Sept 2021,171,187,448,894349337,2600084288,3494433625,155,448,5,1705734951,In > Out
Sept 2021,171,188,418,158372588,2748427115,2906799703,175,414,3,2590054527,In > Out
Sept 2021,171,19,416,140556483,4526975645,4667532128,200,416,7,4386419162,In > Out
Sept 2021,171,190,1245,644982063,37573288391,38218270454,183,1202,5,36928306328,In > Out
Sept 2021,171,194,665,760893980,1276354702,2037248682,264,651,5,515460722,In > Out
Sept 2021,171,196,555,66478510,1693402821,1759881331,184,544,4,1626924311,In > Out
Sept 2021,171,202,302,562434666,7088053286,7650487952,99,302,5,6525618620,In > Out
Sept 2021,171,203,877,116269545,3179227439,3295496984,276,845,6,3062957894,In > Out
Sept 2021,171,204,1415,192362264,5668096157,5860458421,403,1349,6,5475733893,In > Out
Sept 2021,171,205,228,790656932,1544621316,2335278248,89,224,5,753964384,In > Out
Sept 2021,171,206,173,47259050,272329678,319588728,69,173,5,225070628,In > Out
Sept 2021,171,207,477,250099181,1521411494,1771510675,130,468,3,1271312313,In > Out
Sept 2021,171,208,423,8028184947,9990626001,18018810948,173,403,13,1962441054,In > Out
Sept 2021,171,209,742,305138657,26884580295,27189718952,251,721,8,26579441638,In > Out
Sept 2021,171,210,320,1706379051,2532065447,4238444498,155,316,5,825686396,In > Out
Sept 2021,171,211,4935,4649616634,25614108366,30263725000,484,4499,49,20964491732,In > Out
Sept 2021,171,212,422,39465212,1436917580,1476382792,133,417,4,1397452368,In > Out
Sept 2021,171,213,1149,130115380,8284335351,8414450731,376,1106,5,8154219971,In > Out
Sept 2021,171,215,776,63503334,1876051244,1939554578,126,775,3,1812547910,In > Out
Sept 2021,171,216,350,92428425,1288026313,1380454738,125,348,3,1195597888,In > Out
Sept 2021,171,22,354,431746840,718249863,1149996703,183,354,3,286503023,In > Out
Sept 2021,171,221,283,35451782,650670435,686122217,108,280,4,615218653,In > Out
Sept 2021,171,222,858,868354412,5446172424,6314526836,318,828,6,4577818012,In > Out
Sept 2021,171,223,401,75829395,1032369999,1108199394,125,401,4,956540604,In > Out
Sept 2021,171,23,702,196986653,2317612080,2514598733,212,696,16,2120625427,In > Out
Sept 2021,171,27,391,94439602,1959885148,2054324750,170,363,4,1865445546,In > Out
Sept 2021,171,30,371,41016368,850907000,891923368,135,369,3,809890632,In > Out
Sept 2021,171,31,887,1788051276,4996447812,6784499088,284,852,9,3208396536,In > Out
Sept 2021,171,33,275,852410958,3705645353,4558056311,113,267,10,2853234395,In > Out
Sept 2021,171,35,1228,2096812342,2691615973,4788428315,335,1199,9,594803631,In > Out
Sept 2021,171,36,1833,332477903,6193823994,6526301897,345,1788,9,5861346091,In > Out
Sept 2021,171,40,711,122748688,2261300161,2384048849,206,709,12,2138551473,In > Out
Sept 2021,171,41,408,190156866,4505435637,4695592503,137,405,6,4315278771,In > Out
Sept 2021,171,42,620,114723254,4309570603,4424293857,291,608,5,4194847349,In > Out
Sept 2021,171,44,333,92151765,770119173,862270938,144,331,3,677967408,In > Out
Sept 2021,171,45,360,41437166,741479264,782916430,146,360,4,700042098,In > Out
Sept 2021,171,46,580,62385526,2955394228,3017779754,203,575,3,2893008702,In > Out
Sept 2021,171,47,745,86872383,2138435325,2225307708,155,742,3,2051562942,In > Out
Sept 2021,171,48,116,21642801,1212671191,1234313992,61,116,3,1191028390,In > Out
Sept 2021,171,49,347,31538227,667826251,699364478,109,343,3,636288024,In > Out
Sept 2021,171,50,599,160265829,8958159151,9118424980,224,594,6,8797893322,In > Out
Sept 2021,171,54,896,68771255,3697538955,3766310210,184,883,6,3628767700,In > Out
Sept 2021,171,57,464,74390172,3399909159,3474299331,200,462,4,3325518987,In > Out
Sept 2021,171,58,625,110881444,3619121441,3730002885,150,616,12,3508239997,In > Out
Sept 2021,171,59,449,174917315,7774135798,7949053113,152,445,5,7599218483,In > Out
Sept 2021,171,6,369,33086298,704264482,737350780,143,368,4,671178184,In > Out
Sept 2021,171,60,1907,2822895096,45155792400,47978687496,488,1874,4,42332897304,In > Out
Sept 2021,171,63,487,363107329,1580185880,1943293209,143,487,2,1217078551,In > Out
Sept 2021,171,64,1741,587907624,4708286043,5296193667,270,1712,4,4120378419,In > Out
Sept 2021,171,65,254,17380421,395296202,412676623,76,253,6,377915781,In > Out
Sept 2021,171,66,1030,1132151499,4897639946,6029791445,254,1016,3,3765488447,In > Out
Sept 2021,171,67,104,7786724,114366913,122153637,61,104,3,106580189,In > Out
Sept 2021,171,71,235,33056180,976734529,1009790709,98,234,3,943678349,In > Out
Sept 2021,171,72,943,393273653,4688718044,5081991697,278,927,17,4295444391,In > Out
Sept 2021,171,74,343,227224038,2346406086,2573630124,136,341,5,2119182048,In > Out
Sept 2021,171,75,1238,182032379,3812233783,3994266162,130,1204,2,3630201404,In > Out
Sept 2021,171,76,1057,1459274520,2987868052,4447142572,305,1016,7,1528593532,In > Out
Sept 2021,171,77,276,35103025,564352915,599455940,99,276,2,529249890,In > Out
Sept 2021,171,78,622,1408417438,1945039162,3353456600,230,619,7,536621724,In > Out
Sept 2021,171,79,539,164542536,2941881525,3106424061,138,529,5,2777338989,In > Out
Sept 2021,171,81,914,434961089,5262064102,5697025191,250,887,14,4827103013,In > Out
Sept 2021,171,82,1133,379811088,12440263988,12820075076,281,1106,5,12060452900,In > Out
Sept 2021,171,84,674,187806676,4741415642,4929222318,220,667,5,4553608966,In > Out
Sept 2021,171,85,654,325060170,5914679927,6239740097,233,649,3,5589619757,In > Out
Sept 2021,171,86,1488,785598890,9454594190,10240193080,390,1434,6,8668995300,In > Out
Sept 2021,171,87,252,199120803,463303135,662423938,106,252,4,264182332,In > Out
Sept 2021,171,88,1860,649146320,23023135672,23672281992,616,1765,9,22373989352,In > Out
Sept 2021,171,91,492,116397843,3218054153,3334451996,159,481,9,3101656310,In > Out
Sept 2021,171,92,143,16389623,329628998,346018621,94,142,5,313239375,In > Out
Sept 2021,171,93,287,76505604,1718869851,1795375455,120,287,4,1642364247,In > Out
Sept 2021,171,95,393,30812703,952834023,983646726,178,390,4,922021320,In > Out
Sept 2021,171,96,603,83436013,2578159988,2661596001,178,590,4,2494723975,In > Out
Sept 2021,171,98,502,50034384,1095414647,1145449031,155,491,5,1045380263,In > Out
Sept 2021,172,36,121,22041848,261849225,283891073,12,120,2,239807377,In > Out
Sept 2021,172,44,468,84816260,1643393053,1728209313,28,460,2,1558576793,In > Out
Sept 2021,174,109,869,128554312,724552334,853106646,120,850,2,595998022,In > Out
Sept 2021,174,119,1,24648,571653,596301,1,1,1,547005,In > Out
Sept 2021,174,195,331,130011439,620711929,750723368,61,328,2,490700490,In > Out
Sept 2021,175,192,1076,336884038,2734791329,3071675367,85,1039,4,2397907291,In > Out
Sept 2021,176,134,40,16007596,435166274,451173870,22,40,3,419158678,In > Out
Sept 2021,176,168,1,61967,45921,107888,1,1,1,16046,Out > In
Sept 2021,176,176,19,1900141,217397935,219298076,3,19,2,215497794,In > Out
Sept 2021,176,204,196,226350942,442483133,668834075,86,196,3,216132191,In > Out
Sept 2021,178,121,935,206701782,3517426740,3724128522,99,919,2,3310724958,In > Out
Sept 2021,178,123,1184,115006074,1471916508,1586922582,178,1139,2,1356910434,In > Out
Sept 2021,178,147,3,42037,1795526,1837563,2,3,1,1753489,In > Out
Sept 2021,178,172,519,81292120,63262629,144554749,14,517,2,18029491,Out > In
Sept 2021,178,184,329,113691144,1564092163,1677783307,30,328,2,1450401019,In > Out
Sept 2021,178,185,947,84492743,1659430527,1743923270,273,918,2,1574937784,In > Out
Sept 2021,178,186,717,86671121,805905896,892577017,192,698,2,719234775,In > Out
Sept 2021,178,188,248,105700011,1582173358,1687873369,27,248,2,1476473347,In > Out
Sept 2021,178,189,19,954249,13323581,14277830,13,19,2,12369332,In > Out
Sept 2021,178,209,5,524655,538844,1063499,5,4,2,14189,In > Out
Sept 2021,178,29,1199,112070202,2596867431,2708937633,60,1112,2,2484797229,In > Out
Sept 2021,178,4,959,178225091,3650686296,3828911387,168,932,2,3472461205,In > Out
Sept 2021,178,61,349,19197455,854880194,874077649,35,348,2,835682739,In > Out
Sept 2021,178,78,911,129218175,749574760,878792935,242,881,3,620356585,In > Out
Sept 2021,179,130,314,122965122,1217136535,1340101657,43,312,2,1094171413,In > Out
Sept 2021,179,160,1655,18057490650,940330838,18997821488,380,6,1372,17117159812,Out > In
Sept 2021,179,199,249,24003235,240426047,264429282,20,249,2,216422812,In > Out
Sept 2021,179,218,162,15752521,357399359,373151880,68,162,2,341646838,In > Out
Sept 2021,179,222,363,100666489,544234067,644900556,182,352,6,443567578,In > Out
Sept 2021,179,90,722,317485849,385164039,702649888,79,709,3,67678190,In > Out
Sept 2021,180,113,509,145527085,1770382572,1915909657,56,488,2,1624855487,In > Out
Sept 2021,180,13,1,25680,105471,131151,1,1,1,79791,In > Out
Sept 2021,180,133,463,153622045,1680400551,1834022596,62,447,2,1526778506,In > Out
Sept 2021,180,138,452,163607118,833712565,997319683,150,443,3,670105447,In > Out
Sept 2021,180,140,906,227558676,2566556204,2794114880,217,894,2,2338997528,In > Out
Sept 2021,180,154,1260,451842617,1295592478,1747435095,302,1224,2,843749861,In > Out
Sept 2021,180,161,355,165050047,2176394390,2341444437,33,352,2,2011344343,In > Out
Sept 2021,180,169,1016,53390010,3103874899,3157264909,46,980,2,3050484889,In > Out
Sept 2021,180,172,600,109474484,621073699,730548183,141,593,2,511599215,In > Out
Sept 2021,180,175,73,4825541,61382768,66208309,15,73,1,56557227,In > Out
Sept 2021,180,188,69,5863293,104267787,110131080,14,69,2,98404494,In > Out
Sept 2021,180,189,132,22636364,327919093,350555457,58,132,2,305282729,In > Out
Sept 2021,180,193,1085,250156142,2950448796,3200604938,91,1072,6,2700292654,In > Out
Sept 2021,180,199,446,132422984,1478656310,1611079294,40,442,2,1346233326,In > Out
Sept 2021,180,203,295,44679690,330319689,374999379,89,293,2,285639999,In > Out
Sept 2021,180,204,62,4053496,98917125,102970621,12,61,2,94863629,In > Out
Sept 2021,180,59,423,162067770,1835246252,1997314022,45,413,2,1673178482,In > Out
Sept 2021,180,82,413,127953459,1088145837,1216099296,39,412,2,960192378,In > Out
Sept 2021,180,85,68,4889425,32671078,37560503,11,68,1,27781653,In > Out
Sept 2021,180,96,472,612188665,934307457,1546496122,165,464,4,322118792,In > Out
Sept 2021,181,109,757,238162162,2560137169,2798299331,108,747,2,2321975007,In > Out
Sept 2021,181,114,41,667788,23730449,24398237,27,41,2,23062661,In > Out
Sept 2021,181,115,86,10280846,371486036,381766882,54,86,2,361205190,In > Out
Sept 2021,181,117,1,5337,188268,193605,1,1,1,182931,In > Out
Sept 2021,181,122,3,53264,1627301,1680565,3,3,2,1574037,In > Out
Sept 2021,181,124,25,4000070,679009784,683009854,19,25,1,675009714,In > Out
Sept 2021,181,127,1531,197430005,587578058,785008063,146,1485,3,390148053,In > Out
Sept 2021,181,128,1229,184103953,2230690153,2414794106,313,1186,4,2046586200,In > Out
Sept 2021,181,13,1765,342770689,2551918002,2894688691,159,1735,3,2209147313,In > Out
Sept 2021,181,130,2099,254732268,2219052084,2473784352,412,1970,2,1964319816,In > Out
Sept 2021,181,131,45,4427941,239339737,243767678,24,45,2,234911796,In > Out
Sept 2021,181,133,480,17301535,1583650255,1600951790,68,477,2,1566348720,In > Out
Sept 2021,181,141,229,12400010,222915773,235315783,60,227,2,210515763,In > Out
Sept 2021,181,148,181,8128311,186519136,194647447,38,179,1,178390825,In > Out
Sept 2021,181,150,1839,241615682,1563963081,1805578763,354,1739,3,1322347399,In > Out
Sept 2021,181,151,8,135373,8927066,9062439,7,8,1,8791693,In > Out
Sept 2021,181,154,429,37955562,362307629,400263191,118,429,2,324352067,In > Out
Sept 2021,181,155,1879,130821200,1018492277,1149313477,374,1816,2,887671077,In > Out
Sept 2021,181,158,2513,324185466,1723387147,2047572613,178,2361,17,1399201681,In > Out
Sept 2021,181,160,1,9749,2083617,2093366,1,1,1,2073868,In > Out
Sept 2021,181,162,587,629059651,2351559581,2980619232,230,575,4,1722499930,In > Out
Sept 2021,181,164,1305,193373599,5539297627,5732671226,240,1277,2,5345924028,In > Out
Sept 2021,181,169,385,10485775,900841904,911327679,140,383,2,890356129,In > Out
Sept 2021,181,170,832,197718213,2798371675,2996089888,170,811,2,2600653462,In > Out
Sept 2021,181,171,1943,205541369,2138399972,2343941341,258,1842,2,1932858603,In > Out
Sept 2021,181,172,39,11379579,35488472,46868051,16,39,2,24108893,In > Out
Sept 2021,181,175,411,182018693,937368751,1119387444,155,403,5,755350058,In > Out
Sept 2021,181,177,5,2880049,558119983,561000032,3,5,2,555239934,In > Out
Sept 2021,181,184,7,71657,9509225,9580882,4,7,1,9437568,In > Out
Sept 2021,181,186,15,638357,7964133,8602490,5,15,2,7325776,In > Out
Sept 2021,181,196,2,54649,3378926,3433575,2,2,1,3324277,In > Out
Sept 2021,181,197,21,961591,12780058,13741649,10,21,2,11818467,In > Out
Sept 2021,181,198,1248,25606264,1659900072,1685506336,53,1232,2,1634293808,In > Out
Sept 2021,181,20,1264,143040070,648650702,791690772,175,1233,4,505610632,In > Out
Sept 2021,181,206,191,8171388,155599266,163770654,76,191,1,147427878,In > Out
Sept 2021,181,208,44,1043575,8102180,9145755,12,44,2,7058605,In > Out
Sept 2021,181,209,475,18548239,1060247364,1078795603,197,468,4,1041699125,In > Out
Sept 2021,181,215,92,3237138,85792509,89029647,25,92,2,82555371,In > Out
Sept 2021,181,216,1056,106549076,636281608,742830684,165,1012,3,529732532,In > Out
Sept 2021,181,220,780,69309254,816311162,885620416,214,766,2,747001908,In > Out
Sept 2021,181,226,2,83741,309692,393433,2,2,1,225951,In > Out
Sept 2021,181,229,17,594514,27375213,27969727,7,17,1,26780699,In > Out
Sept 2021,181,231,123,15809045,180868113,196677158,25,123,3,165059068,In > Out
Sept 2021,181,234,438,104686519,306895746,411582265,26,431,2,202209227,In > Out
Sept 2021,181,238,382,236548763,514024969,750573732,71,373,2,277476206,In > Out
Sept 2021,181,244,8,130858,1073848,1204706,6,8,2,942990,In > Out
Sept 2021,181,247,48,4652448,63991079,68643527,25,48,2,59338631,In > Out
Sept 2021,181,248,535,1048578595,3485580549,4534159144,101,529,4,2437001954,In > Out
Sept 2021,181,250,530,30755114,1357706908,1388462022,110,524,2,1326951794,In > Out
Sept 2021,181,251,430,88514729,4285620685,4374135414,148,430,3,4197105956,In > Out
Sept 2021,181,36,9,250649,7901000,8151649,5,9,2,7650351,In > Out
Sept 2021,181,37,112,1828010,691843135,693671145,10,112,1,690015125,In > Out
Sept 2021,181,38,35,663786,95282018,95945804,8,35,1,94618232,In > Out
Sept 2021,181,46,130,5363860,39846777,45210637,13,129,2,34482917,In > Out
Sept 2021,181,5,55,1681169,381608184,383289353,11,55,1,379927015,In > Out
Sept 2021,181,53,201,40634315,128650987,169285302,86,199,2,88016672,In > Out
Sept 2021,181,54,155,7657986,167922697,175580683,44,155,2,160264711,In > Out
Sept 2021,181,6,21,149987,17535866,17685853,9,21,1,17385879,In > Out
Sept 2021,181,61,1435,178358701,319130044,497488745,78,1372,2,140771343,In > Out
Sept 2021,181,64,24,5898536,18245827,24144363,9,24,1,12347291,In > Out
Sept 2021,181,65,5,3915,20087865,20091780,2,1,2,20083950,In > Out
Sept 2021,181,71,75,5852516,31930574,37783090,11,75,1,26078058,In > Out
Sept 2021,181,73,62,88673913,84529416,173203329,29,62,2,4144497,Out > In
Sept 2021,181,74,898,120819806,312688101,433507907,78,885,2,191868295,In > Out
Sept 2021,181,77,267,262473450,1846581058,2109054508,122,267,2,1584107608,In > Out
Sept 2021,181,78,1110,146573651,2642955411,2789529062,320,1074,9,2496381760,In > Out
Sept 2021,181,79,220,49121135,673186204,722307339,64,216,2,624065069,In > Out
Sept 2021,181,8,183,16633172,18256186,34889358,12,183,2,1623014,In > Out
Sept 2021,181,81,82,7136803,137385283,144522086,16,82,2,130248480,In > Out
Sept 2021,181,82,3005,477574617,976978581,1454553198,321,2727,2,499403964,In > Out
Sept 2021,181,9,5467,2047723383,4284298276,6332021659,197,4891,5,2236574893,In > Out
Sept 2021,181,90,18,2681848,441252956,443934804,11,18,2,438571108,In > Out
Sept 2021,181,91,88,904928,25409613,26314541,32,88,2,24504685,In > Out
Sept 2021,181,93,1287,568691070,1869179131,2437870201,477,1237,5,1300488061,In > Out
Sept 2021,181,95,8,78261,4178384,4256645,7,8,2,4100123,In > Out
Sept 2021,181,96,1,1335450,65326,1400776,1,1,1,1270124,Out > In
Sept 2021,181,99,273,127942380,2028700886,2156643266,30,272,2,1900758506,In > Out
Sept 2021,183,19,10,126808,4268327,4395135,6,10,2,4141519,In > Out
Sept 2021,183,91,1,52335,142194,194529,1,1,1,89859,In > Out
Sept 2021,184,134,11811,1146103165,67007644386,68153747551,790,8918,5,65861541221,In > Out
Sept 2021,184,136,8181,2743819991,12662574966,15406394957,1333,6455,13,9918754975,In > Out
Sept 2021,184,137,3459,12268538681,280121410,12548660091,142,2922,2376,11988417271,Out > In
Sept 2021,184,139,3591,813335819,16703532392,17516868211,709,3255,6,15890196573,In > Out
Sept 2021,184,140,4234,1904271292,11418609538,13322880830,784,3693,12,9514338246,In > Out
Sept 2021,184,141,2030,1093998644,7052908806,8146907450,524,1936,8,5958910162,In > Out
Sept 2021,184,182,336,27344718,735288943,762633661,118,334,3,707944225,In > Out
Sept 2021,184,188,4521,2189311017,9984970613,12174281630,718,4102,20,7795659596,In > Out
Sept 2021,184,216,39,133165264,524966592,658131856,1,3,3,391801328,In > Out
Sept 2021,184,218,48,5294051,18544846,23838897,13,48,2,13250795,In > Out
Sept 2021,184,219,2097,296945617,15196789404,15493735021,364,1950,312,14899843787,In > Out
Sept 2021,184,246,616,66031917,1717264253,1783296170,171,606,3,1651232336,In > Out
Sept 2021,19,122,12,32768,1927822,1960590,1,12,1,1895054,In > Out
Sept 2021,190,100,6,1290728,45755167,47045895,4,6,2,44464439,In > Out
Sept 2021,190,101,6,444296,51041755,51486051,4,6,2,50597459,In > Out
Sept 2021,190,119,57,1047771,101281997,102329768,10,57,2,100234226,In > Out
Sept 2021,190,123,14,232222,23670490,23902712,5,14,1,23438268,In > Out
Sept 2021,190,125,23,1030162,50749920,51780082,6,23,1,49719758,In > Out
Sept 2021,190,160,14,291194,32642124,32933318,5,14,1,32350930,In > Out
Sept 2021,190,165,22,362101,34865091,35227192,10,22,2,34502990,In > Out
Sept 2021,190,208,3,321092,63354594,63675686,3,3,2,63033502,In > Out
Sept 2021,190,209,142,629221,26037333,26666554,2,142,2,25408112,In > Out
Sept 2021,190,216,6,473188,76232767,76705955,5,6,2,75759579,In > Out
Sept 2021,190,217,90,919746,81483786,82403532,8,90,2,80564040,In > Out
Sept 2021,190,219,830,4683361,250434842,255118203,32,811,2,245751481,In > Out
Sept 2021,190,39,3,27271,5460976,5488247,3,3,1,5433705,In > Out
Sept 2021,190,40,41,779499,7241189,8020688,8,41,2,6461690,In > Out
Sept 2021,190,43,21,463874,57139353,57603227,9,21,2,56675479,In > Out
Sept 2021,190,44,78,1214041,76371481,77585522,6,77,2,75157440,In > Out
Sept 2021,190,48,152,12778028,266422666,279200694,3,3,150,253644638,In > Out
Sept 2021,190,53,10,360583,53979973,54340556,4,10,2,53619390,In > Out
Sept 2021,190,54,6,194274,27524776,27719050,4,6,2,27330502,In > Out
Sept 2021,190,78,6,461108,40950040,41411148,5,6,1,40488932,In > Out
Sept 2021,191,11,925,126730848,144281399,271012247,22,897,2,17550551,In > Out
Sept 2021,191,14,300,514019415,1288855819,1802875234,101,298,2,774836404,In > Out
Sept 2021,191,15,19,357202,47907753,48264955,8,19,2,47550551,In > Out
Sept 2021,191,39,42,2535567,234223404,236758971,11,42,2,231687837,In > Out
Sept 2021,191,44,52,3453835,479687702,483141537,14,52,2,476233867,In > Out
Sept 2021,191,51,1427,162301581,610094611,772396192,58,1366,2,447793030,In > Out
Sept 2021,191,62,3070,1378265689,68889745949,70268011638,496,2795,4,67511480260,In > Out
Sept 2021,192,39,25,865532,2356294,3221826,3,25,1,1490762,In > Out
Sept 2021,192,40,20,890385,3838750,4729135,6,20,2,2948365,In > Out
Sept 2021,192,45,35,2400659,445964267,448364926,9,35,2,443563608,In > Out
Sept 2021,195,10,370,90150751,798292643,888443394,135,365,4,708141892,In > Out
Sept 2021,195,100,238,27859149,719261939,747121088,85,237,2,691402790,In > Out
Sept 2021,195,104,1189,759849998,6063960064,6823810062,180,1175,12,5304110066,In > Out
Sept 2021,195,105,399,44736953,1301575414,1346312367,176,396,3,1256838461,In > Out
Sept 2021,195,106,397,128348927,2615915748,2744264675,140,393,5,2487566821,In > Out
Sept 2021,195,107,474,64706950,1331143960,1395850910,145,466,4,1266437010,In > Out
Sept 2021,195,109,1062,170438141,4162333593,4332771734,201,1043,6,3991895452,In > Out
Sept 2021,195,11,1179,1026845949,5546379300,6573225249,289,1140,14,4519533351,In > Out
Sept 2021,195,110,565,208744501,7314786171,7523530672,187,558,2,7106041670,In > Out
Sept 2021,195,113,163,35710234,971396842,1007107076,95,163,3,935686608,In > Out
Sept 2021,195,114,232,106344133,1406412825,1512756958,122,231,7,1300068692,In > Out
Sept 2021,195,115,1483,1012907238,11268447168,12281354406,311,1427,5,10255539930,In > Out
Sept 2021,195,116,722,278242264,6186298384,6464540648,200,707,5,5908056120,In > Out
Sept 2021,195,117,520,166788505,7094850326,7261638831,166,518,6,6928061821,In > Out
Sept 2021,195,118,189,28842019,573259386,602101405,105,188,2,544417367,In > Out
Sept 2021,195,12,271,283716350,2163539965,2447256315,104,268,12,1879823615,In > Out
Sept 2021,195,120,388,202800056,2699479678,2902279734,163,385,8,2496679622,In > Out
Sept 2021,195,123,14,1761680,109595843,111357523,11,14,3,107834163,In > Out
Sept 2021,195,125,1494,1641355732,8219550640,9860906372,367,1454,8,6578194908,In > Out
Sept 2021,195,128,157,8570177,516389341,524959518,27,157,2,507819164,In > Out
Sept 2021,195,129,683,461176350,1995700598,2456876948,217,675,6,1534524248,In > Out
Sept 2021,195,13,130,22653726,947111167,969764893,48,130,2,924457441,In > Out
Sept 2021,195,130,218,17466132,576307623,593773755,104,218,2,558841491,In > Out
Sept 2021,195,131,616,260792134,4661552304,4922344438,113,614,5,4400760170,In > Out
Sept 2021,195,132,283,21656828,604502069,626158897,160,282,5,582845241,In > Out
Sept 2021,195,133,114,5271125,106018289,111289414,53,114,2,100747164,In > Out
Sept 2021,195,134,458,349904769,3331067216,3680971985,125,455,12,2981162447,In > Out
Sept 2021,195,135,209,20929851,335300888,356230739,81,206,3,314371037,In > Out
Sept 2021,195,137,321,41517317,188257874,229775191,53,318,4,146740557,In > Out
Sept 2021,195,138,362,56039017,2015899874,2071938891,149,358,4,1959860857,In > Out
Sept 2021,195,139,866,2424537128,32353717917,34778255045,216,862,6,29929180789,In > Out
Sept 2021,195,14,520,164973376,2156628459,2321601835,220,494,9,1991655083,In > Out
Sept 2021,195,140,423,248862875,1998642227,2247505102,191,419,4,1749779352,In > Out
Sept 2021,195,141,331,134311234,1774355663,1908666897,152,327,3,1640044429,In > Out
Sept 2021,195,142,265,22827306,1392222750,1415050056,128,264,2,1369395444,In > Out
Sept 2021,195,143,148,38247867,683278323,721526190,59,148,4,645030456,In > Out
Sept 2021,195,144,172,93120284,6138669543,6231789827,69,171,2,6045549259,In > Out
Sept 2021,195,145,672,406408278,1869563638,2275971916,171,661,9,1463155360,In > Out
Sept 2021,195,146,498,147987840,2754175040,2902162880,204,496,7,2606187200,In > Out
Sept 2021,195,147,356,587200617,1432746476,2019947093,121,355,3,845545859,In > Out
Sept 2021,195,148,329,73739629,1877548154,1951287783,117,325,8,1803808525,In > Out
Sept 2021,195,149,156,266586792,936625236,1203212028,76,152,6,670038444,In > Out
Sept 2021,195,15,648,655943458,2472398972,3128342430,253,631,6,1816455514,In > Out
Sept 2021,195,150,588,119190257,3832953980,3952144237,147,579,8,3713763723,In > Out
Sept 2021,195,151,656,84295068,3159595280,3243890348,179,648,6,3075300212,In > Out
Sept 2021,195,152,259,3290400128,767386147,4057786275,121,259,4,2523013981,Out > In
Sept 2021,195,153,584,46720000,3352969518,3399689518,152,571,24,3306249518,In > Out
Sept 2021,195,154,461,91926201,649651475,741577676,231,457,6,557725274,In > Out
Sept 2021,195,155,1388,125467646,4100050658,4225518304,329,1358,4,3974583012,In > Out
Sept 2021,195,156,2280,290732869,8451877441,8742610310,366,2153,4,8161144572,In > Out
Sept 2021,195,157,150,17970539,1024076276,1042046815,94,141,5,1006105737,In > Out
Sept 2021,195,158,178,31115144,1455345853,1486460997,96,178,3,1424230709,In > Out
Sept 2021,195,159,402,37961221,296742280,334703501,160,402,1,258781059,In > Out
Sept 2021,195,16,97,14251887,78002702,92254589,55,97,2,63750815,In > Out
Sept 2021,195,160,650,1212761929,1941936677,3154698606,157,639,5,729174748,In > Out
Sept 2021,195,161,262,180379800,1378033186,1558412986,137,262,4,1197653386,In > Out
Sept 2021,195,163,1185,193417799,7334803873,7528221672,277,1136,6,7141386074,In > Out
Sept 2021,195,165,320,75588334,3827442670,3903031004,119,319,7,3751854336,In > Out
Sept 2021,195,166,1404,453387311,2524081755,2977469066,349,1360,4,2070694444,In > Out
Sept 2021,195,167,434,52570213,3043629183,3096199396,186,431,7,2991058970,In > Out
Sept 2021,195,168,256,10167639,376752266,386919905,58,256,3,366584627,In > Out
Sept 2021,195,169,51,3945950,242904364,246850314,24,51,1,238958414,In > Out
Sept 2021,195,17,205,148509815,964245957,1112755772,93,204,3,815736142,In > Out
Sept 2021,195,170,81,5473980,371109363,376583343,59,81,1,365635383,In > Out
Sept 2021,195,171,67,8034994,136002533,144037527,46,67,3,127967539,In > Out
Sept 2021,195,172,295,308559240,1010193044,1318752284,99,294,7,701633804,In > Out
Sept 2021,195,173,212,3984549872,1833795708,5818345580,97,211,3,2150754164,Out > In
Sept 2021,195,174,274,121823046,4974913555,5096736601,93,274,5,4853090509,In > Out
Sept 2021,195,175,132,385325816,543483864,928809680,60,130,7,158158048,In > Out
Sept 2021,195,177,770,349958789,2132155085,2482113874,265,770,5,1782196296,In > Out
Sept 2021,195,178,94,17842031,234709663,252551694,40,94,2,216867632,In > Out
Sept 2021,195,18,366,196237031,1088372551,1284609582,135,363,6,892135520,In > Out
Sept 2021,195,180,1082,573703066,6797434199,7371137265,323,1038,5,6223731133,In > Out
Sept 2021,195,181,918,64976130,2045224191,2110200321,212,898,6,1980248061,In > Out
Sept 2021,195,182,540,98936528,3119281554,3218218082,209,538,2,3020345026,In > Out
Sept 2021,195,183,208,100056852,632027770,732084622,99,208,5,531970918,In > Out
Sept 2021,195,184,347,78246555,2273821333,2352067888,116,346,3,2195574778,In > Out
Sept 2021,195,185,881,490569076,4378787191,4869356267,237,861,10,3888218115,In > Out
Sept 2021,195,186,612,179333388,2612954756,2792288144,224,604,17,2433621368,In > Out
Sept 2021,195,187,232,215296753,1620306224,1835602977,97,230,2,1405009471,In > Out
Sept 2021,195,188,358,202142073,1171218576,1373360649,113,356,4,969076503,In > Out
Sept 2021,195,189,165,106619725,735622693,842242418,76,164,5,629002968,In > Out
Sept 2021,195,19,428,716908622,1376709236,2093617858,120,421,6,659800614,In > Out
Sept 2021,195,190,60,7782586,422466348,430248934,30,60,3,414683762,In > Out
Sept 2021,195,191,452,385271969,3472387830,3857659799,176,413,2,3087115861,In > Out
Sept 2021,195,192,547,1314393367,1560491583,2874884950,166,536,3,246098216,In > Out
Sept 2021,195,193,129,36605528,240949474,277555002,46,128,5,204343946,In > Out
Sept 2021,195,194,171,14982893,133592696,148575589,79,171,4,118609803,In > Out
Sept 2021,195,195,606,51536091,3282044348,3333580439,173,406,5,3230508257,In > Out
Sept 2021,195,196,218,16691075,466803733,483494808,73,216,4,450112658,In > Out
Sept 2021,195,197,391,162343501,1795290456,1957633957,139,383,3,1632946955,In > Out
Sept 2021,195,198,197,41413230,325152237,366565467,82,182,3,283739007,In > Out
Sept 2021,195,199,740,417434465,5153771703,5571206168,144,736,5,4736337238,In > Out
Sept 2021,195,20,1335,631705514,8872851957,9504557471,167,1277,8,8241146443,In > Out
Sept 2021,195,200,171,920695442,1025728799,1946424241,75,170,6,105033357,In > Out
Sept 2021,195,201,32,3359349,26375894,29735243,21,32,2,23016545,In > Out
Sept 2021,195,202,45,2853398,43221097,46074495,28,45,3,40367699,In > Out
Sept 2021,195,203,2116,522608245,7106611916,7629220161,391,2032,9,6584003671,In > Out
Sept 2021,195,204,3282,188430552,6264442397,6452872949,123,1967,1,6076011845,In > Out
Sept 2021,195,205,385,41157336,886483022,927640358,188,382,5,845325686,In > Out
Sept 2021,195,206,1621,685388411,10515870343,11201258754,354,1591,12,9830481932,In > Out
Sept 2021,195,207,199,142883212,3252493316,3395376528,97,199,2,3109610104,In > Out
Sept 2021,195,208,171,177061421,5748206953,5925268374,82,171,3,5571145532,In > Out
Sept 2021,195,209,1061,1085225226,8078815606,9164040832,329,1024,16,6993590380,In > Out
Sept 2021,195,21,580,352799296,1364702056,1717501352,224,577,5,1011902760,In > Out
Sept 2021,195,210,199,65495544,1937380198,2002875742,81,199,4,1871884654,In > Out
Sept 2021,195,211,293,697681177,532531007,1230212184,131,290,5,165150170,Out > In
Sept 2021,195,212,213,79631876,6779899801,6859531677,67,213,3,6700267925,In > Out
Sept 2021,195,213,644,203514914,3714772066,3918286980,211,637,6,3511257152,In > Out
Sept 2021,195,214,218,55539067,4255857518,4311396585,142,216,6,4200318451,In > Out
Sept 2021,195,215,1088,135995291,4626588090,4762583381,296,1055,4,4490592799,In > Out
Sept 2021,195,216,42,18509759,283397855,301907614,20,42,2,264888096,In > Out
Sept 2021,195,217,434,61317070,2284658991,2345976061,141,431,3,2223341921,In > Out
Sept 2021,195,218,153,16066386,466524136,482590522,50,152,4,450457750,In > Out
Sept 2021,195,219,133,195709638,1996443807,2192153445,64,106,5,1800734169,In > Out
Sept 2021,195,22,116,62810027,1013607921,1076417948,60,116,3,950797894,In > Out
Sept 2021,195,220,416,220261858,2153098951,2373360809,245,411,4,1932837093,In > Out
Sept 2021,195,221,370,272166420,1396228661,1668395081,157,370,6,1124062241,In > Out
Sept 2021,195,222,220,10502664,307085894,317588558,40,217,1,296583230,In > Out
Sept 2021,195,223,509,11852248,599978048,611830296,71,502,3,588125800,In > Out
Sept 2021,195,23,510,121412356,1576593911,1698006267,174,505,3,1455181555,In > Out
Sept 2021,195,24,1028,126530126,2866560566,2993090692,364,1004,8,2740030440,In > Out
Sept 2021,195,25,71,13293124,612790728,626083852,14,71,2,599497604,In > Out
Sept 2021,195,26,94,15695320,248118665,263813985,45,94,3,232423345,In > Out
Sept 2021,195,27,851,2218762204,1825865756,4044627960,221,824,7,392896448,Out > In
Sept 2021,195,28,133,10592907,338581204,349174111,61,133,2,327988297,In > Out
Sept 2021,195,29,172,146988617,348797764,495786381,75,171,4,201809147,In > Out
Sept 2021,195,30,218,55949551,7485755620,7541705171,108,218,2,7429806069,In > Out
Sept 2021,195,31,1699,594651195,9641056695,10235707890,513,1651,12,9046405500,In > Out
Sept 2021,195,32,631,198253268,1973084691,2171337959,227,621,6,1774831423,In > Out
Sept 2021,195,33,80,6811404,126272310,133083714,44,80,2,119460906,In > Out
Sept 2021,195,34,481,27453543,422380798,449834341,65,474,4,394927255,In > Out
Sept 2021,195,35,550,64507169,4161761237,4226268406,190,545,7,4097254068,In > Out
Sept 2021,195,36,532,49563302,1093339377,1142902679,118,527,7,1043776075,In > Out
Sept 2021,195,37,268,36938272,1036130909,1073069181,94,268,3,999192637,In > Out
Sept 2021,195,38,1557,619905471,16714905033,17334810504,316,1543,4,16094999562,In > Out
Sept 2021,195,39,646,291657479,2045995877,2337653356,203,630,9,1754338398,In > Out
Sept 2021,195,4,57,6650545,82253167,88903712,27,57,3,75602622,In > Out
Sept 2021,195,40,605,79112342,1372685154,1451797496,197,572,4,1293572812,In > Out
Sept 2021,195,41,410,28324229,2807124088,2835448317,197,408,5,2778799859,In > Out
Sept 2021,195,42,630,93522990,783222754,876745744,136,580,3,689699764,In > Out
Sept 2021,195,43,431,60911822,1796136449,1857048271,156,431,8,1735224627,In > Out
Sept 2021,195,44,360,117080776,2714749444,2831830220,80,357,7,2597668668,In > Out
Sept 2021,195,45,286,73116285,2690894775,2764011060,145,283,3,2617778490,In > Out
Sept 2021,195,46,297,25419138,915139797,940558935,103,294,4,889720659,In > Out
Sept 2021,195,47,84,13728402,130695578,144423980,42,84,2,116967176,In > Out
Sept 2021,195,48,634,101985651,5369973735,5471959386,219,619,4,5267988084,In > Out
Sept 2021,195,49,1153,8725832239,14714168895,23440001134,266,1127,9,5988336656,In > Out
Sept 2021,195,5,79,19014333,704907347,723921680,52,78,4,685893014,In > Out
Sept 2021,195,50,472,319888152,1473405998,1793294150,175,472,6,1153517846,In > Out
Sept 2021,195,51,316,84178783,6120549567,6204728350,147,310,2,6036370784,In > Out
Sept 2021,195,52,413,68481648,1118424490,1186906138,183,411,4,1049942842,In > Out
Sept 2021,195,53,147,19234005,1197563215,1216797220,83,146,3,1178329210,In > Out
Sept 2021,195,54,542,99738931,2046885088,2146624019,192,540,3,1947146157,In > Out
Sept 2021,195,55,453,53530048,794110365,847640413,110,452,6,740580317,In > Out
Sept 2021,195,56,49,27541787,674789493,702331280,24,49,3,647247706,In > Out
Sept 2021,195,57,392,79516851,602517015,682033866,104,387,4,523000164,In > Out
Sept 2021,195,58,514,2188592483,9394964313,11583556796,120,483,8,7206371830,In > Out
Sept 2021,195,59,61,6470663,219148667,225619330,28,61,2,212678004,In > Out
Sept 2021,195,6,668,202439333,1878170685,2080610018,168,657,6,1675731352,In > Out
Sept 2021,195,60,1489,123197625,1956520109,2079717734,471,1437,7,1833322484,In > Out
Sept 2021,195,61,192,54056827,219406336,273463163,67,192,4,165349509,In > Out
Sept 2021,195,62,357,292883318,1155363942,1448247260,157,353,4,862480624,In > Out
Sept 2021,195,63,539,1249068982,2479124944,3728193926,166,538,6,1230055962,In > Out
Sept 2021,195,64,1436,4647871488,9147640754,13795512242,250,1376,8,4499769266,In > Out
Sept 2021,195,65,347,70470455,1697407571,1767878026,121,344,4,1626937116,In > Out
Sept 2021,195,66,130,59680692,3658281483,3717962175,39,130,3,3598600791,In > Out
Sept 2021,195,67,472,97533588,2696499427,2794033015,165,472,1,2598965839,In > Out
Sept 2021,195,68,128,19335545,635874374,655209919,85,127,2,616538829,In > Out
Sept 2021,195,69,61,5090389,146884590,151974979,43,61,2,141794201,In > Out
Sept 2021,195,7,1022,106090190,2494440198,2600530388,283,1003,5,2388350008,In > Out
Sept 2021,195,70,617,188489674,6765114586,6953604260,249,616,3,6576624912,In > Out
Sept 2021,195,71,685,254068445,1608517919,1862586364,186,674,5,1354449474,In > Out
Sept 2021,195,72,969,3704690190,8908916501,12613606691,294,944,18,5204226311,In > Out
Sept 2021,195,73,212,28142291,863872110,892014401,84,212,4,835729819,In > Out
Sept 2021,195,74,612,190630923,7869265660,8059896583,195,605,6,7678634737,In > Out
Sept 2021,195,75,376,560603091,10366013719,10926616810,124,374,4,9805410628,In > Out
Sept 2021,195,76,84,4112642,133549271,137661913,26,83,1,129436629,In > Out
Sept 2021,195,77,1211,4072002598,80273506977,84345509575,243,1183,9,76201504379,In > Out
Sept 2021,195,78,1754,124559258,4434326557,4558885815,310,1686,1,4309767299,In > Out
Sept 2021,195,79,309,145354522,4557484143,4702838665,126,304,7,4412129621,In > Out
Sept 2021,195,8,143,11248405,151795117,163043522,49,143,2,140546712,In > Out
Sept 2021,195,81,680,619747166,3524526095,4144273261,205,664,6,2904778929,In > Out
Sept 2021,195,82,818,87352091,5429892512,5517244603,232,805,4,5342540421,In > Out
Sept 2021,195,83,442,360415857,5823966877,6184382734,156,423,1,5463551020,In > Out
Sept 2021,195,84,239,58934337,500613431,559547768,82,236,8,441679094,In > Out
Sept 2021,195,85,327,23621228,437061234,460682462,94,327,2,413440006,In > Out
Sept 2021,195,87,345,52051684,2447596402,2499648086,104,344,4,2395544718,In > Out
Sept 2021,195,88,162,7015138,373483512,380498650,65,162,4,366468374,In > Out
Sept 2021,195,89,908,721113372,3235540588,3956653960,316,881,5,2514427216,In > Out
Sept 2021,195,9,291,737501718,1924602886,2662104604,93,290,4,1187101168,In > Out
Sept 2021,195,90,470,55405973,794622672,850028645,208,467,4,739216699,In > Out
Sept 2021,195,91,423,82768923,1504819999,1587588922,160,423,3,1422051076,In > Out
Sept 2021,195,92,103,61908094,2965185405,3027093499,65,101,4,2903277311,In > Out
Sept 2021,195,93,264,42677087,1519452740,1562129827,91,263,2,1476775653,In > Out
Sept 2021,195,94,392,76280040,2244641743,2320921783,103,390,3,2168361703,In > Out
Sept 2021,195,95,175,27730654,1606076906,1633807560,88,175,2,1578346252,In > Out
Sept 2021,195,96,866,336037849,2813800369,3149838218,271,847,4,2477762520,In > Out
Sept 2021,195,97,415,2359104125,4538088106,6897192231,118,409,5,2178983981,In > Out
Sept 2021,195,99,241,134278654,2805138443,2939417097,105,241,3,2670859789,In > Out
Sept 2021,196,119,1008,184751569,6306664835,6491416404,57,957,2,6121913266,In > Out
Sept 2021,196,154,963,155570593,6295146663,6450717256,61,904,2,6139576070,In > Out
Sept 2021,196,223,720,153089525,4682853191,4835942716,104,713,2,4529763666,In > Out
Sept 2021,196,7,606,186150985,5911542226,6097693211,98,601,2,5725391241,In > Out
Sept 2021,197,100,198,16617985,289104335,305722320,82,198,4,272486350,In > Out
Sept 2021,197,102,520,653279581,849311438,1502591019,135,514,6,196031857,In > Out
Sept 2021,197,103,544,752210157,1096379850,1848590007,160,539,6,344169693,In > Out
Sept 2021,197,104,513,391787994,1978060759,2369848753,122,509,5,1586272765,In > Out
Sept 2021,197,105,183,1303458016,1607879958,2911337974,80,182,2,304421942,In > Out
Sept 2021,197,107,517,5215326891,13989464175,19204791066,134,505,5,8774137284,In > Out
Sept 2021,197,108,486,583777851,1474034889,2057812740,140,479,7,890257038,In > Out
Sept 2021,197,11,113,8128515,96824203,104952718,68,113,4,88695688,In > Out
Sept 2021,197,115,224,382618881,317382079,700000960,112,222,4,65236802,Out > In
Sept 2021,197,118,397,130042751,1285114335,1415157086,117,394,7,1155071584,In > Out
Sept 2021,197,120,207,62975200,369760702,432735902,78,206,6,306785502,In > Out
Sept 2021,197,121,159,131135779,746686349,877822128,78,155,7,615550570,In > Out
Sept 2021,197,123,203,15472302,288610152,304082454,79,203,4,273137850,In > Out
Sept 2021,197,124,153,30974405,348351469,379325874,82,153,4,317377064,In > Out
Sept 2021,197,125,381,374178754,1064110011,1438288765,170,377,7,689931257,In > Out
Sept 2021,197,126,327,43558253,329374008,372932261,127,327,7,285815755,In > Out
Sept 2021,197,131,375,800256768,551917562,1352174330,107,369,5,248339206,Out > In
Sept 2021,197,133,72,10796130,149271284,160067414,28,72,2,138475154,In > Out
Sept 2021,197,136,353,208736319,807230327,1015966646,121,349,5,598494008,In > Out
Sept 2021,197,137,878,3492702280,8871404988,12364107268,177,872,8,5378702708,In > Out
Sept 2021,197,138,462,3452458515,3063111646,6515570161,160,455,4,389346869,Out > In
Sept 2021,197,14,228,29527216,241275062,270802278,125,227,6,211747846,In > Out
Sept 2021,197,140,405,149310568,8048279024,8197589592,151,402,11,7898968456,In > Out
Sept 2021,197,141,634,172705752,3145348845,3318054597,151,625,3,2972643093,In > Out
Sept 2021,197,142,227,16715622,654755600,671471222,111,227,3,638039978,In > Out
Sept 2021,197,143,409,44121301,1419626256,1463747557,143,402,8,1375504955,In > Out
Sept 2021,197,145,426,234938420,4253599719,4488538139,104,417,3,4018661299,In > Out
Sept 2021,197,146,280,62810401,3399551816,3462362217,86,277,15,3336741415,In > Out
Sept 2021,197,148,178,14711021,309475174,324186195,95,178,6,294764153,In > Out
Sept 2021,197,149,261,31898511,614296083,646194594,132,257,3,582397572,In > Out
Sept 2021,197,15,176,21155295,303074116,324229411,80,176,4,281918821,In > Out
Sept 2021,197,152,356,56925025,912986282,969911307,176,333,7,856061257,In > Out
Sept 2021,197,153,519,845125446,8307762880,9152888326,158,500,9,7462637434,In > Out
Sept 2021,197,154,245,1196674191,3242367869,4439042060,111,242,4,2045693678,In > Out
Sept 2021,197,155,278,129724818,1261268590,1390993408,126,273,8,1131543772,In > Out
Sept 2021,197,156,572,108565998,1694407650,1802973648,200,567,7,1585841652,In > Out
Sept 2021,197,158,377,88374747,920509355,1008884102,163,370,7,832134608,In > Out
Sept 2021,197,16,376,398511698,1530491193,1929002891,154,370,7,1131979495,In > Out
Sept 2021,197,160,414,50489946,750504951,800994897,115,406,6,700015005,In > Out
Sept 2021,197,161,524,10214629174,15992644930,26207274104,169,503,10,5778015756,In > Out
Sept 2021,197,163,213,248487571,4118747884,4367235455,105,210,14,3870260313,In > Out
Sept 2021,197,165,203,47736087,648162134,695898221,105,197,5,600426047,In > Out
Sept 2021,197,166,147,21792040,414513572,436305612,85,147,2,392721532,In > Out
Sept 2021,197,167,273,263227233,590122539,853349772,100,262,8,326895306,In > Out
Sept 2021,197,169,228,30801212,326150327,356951539,89,226,1,295349115,In > Out
Sept 2021,197,17,108,27255481,338880283,366135764,73,108,6,311624802,In > Out
Sept 2021,197,170,324,2262433445,11389931888,13652365333,101,231,9,9127498443,In > Out
Sept 2021,197,171,254,810470632,7543463771,8353934403,92,247,10,6732993139,In > Out
Sept 2021,197,174,409,219246933,2054106506,2273353439,169,400,7,1834859573,In > Out
Sept 2021,197,178,559,655861193,1980878389,2636739582,184,538,8,1325017196,In > Out
Sept 2021,197,179,866,411262061,3298354659,3709616720,199,850,5,2887092598,In > Out
Sept 2021,197,180,264,278671426,504245510,782916936,117,261,4,225574084,In > Out
Sept 2021,197,181,309,155549074,1166497577,1322046651,120,302,5,1010948503,In > Out
Sept 2021,197,183,319,33697525,434094548,467792073,113,316,2,400397023,In > Out
Sept 2021,197,186,344,199588171,2621327898,2820916069,103,341,5,2421739727,In > Out
Sept 2021,197,187,501,91959268,959252266,1051211534,121,498,10,867292998,In > Out
Sept 2021,197,188,431,202023823,11585089853,11787113676,124,421,8,11383066030,In > Out
Sept 2021,197,191,162,151616837,283912149,435528986,91,158,6,132295312,In > Out
Sept 2021,197,192,309,166851230,1887474269,2054325499,102,308,5,1720623039,In > Out
Sept 2021,197,193,172,138417472,222468306,360885778,91,172,6,84050834,In > Out
Sept 2021,197,194,678,269536684,3380637128,3650173812,158,663,7,3111100444,In > Out
Sept 2021,197,197,404,290071607,968028097,1258099704,173,402,9,677956490,In > Out
Sept 2021,197,198,438,115444970,1540222800,1655667770,114,432,4,1424777830,In > Out
Sept 2021,197,199,447,491545574,1477958987,1969504561,187,444,6,986413413,In > Out
Sept 2021,197,201,500,135232341,4234427332,4369659673,211,495,6,4099194991,In > Out
Sept 2021,197,204,238,39854115,659549097,699403212,111,238,5,619694982,In > Out
Sept 2021,197,205,389,82336689,1303855633,1386192322,126,383,7,1221518944,In > Out
Sept 2021,197,206,281,120616902,768883144,889500046,125,280,7,648266242,In > Out
Sept 2021,197,210,593,45759960,946505959,992265919,95,576,4,900745999,In > Out
Sept 2021,197,211,185,14126430,346163756,360290186,96,185,2,332037326,In > Out
Sept 2021,197,212,451,2005404284,3503228656,5508632940,133,425,6,1497824372,In > Out
Sept 2021,197,213,249,236950773,1332745769,1569696542,25,247,4,1095794996,In > Out
Sept 2021,197,214,209,30321712,904192570,934514282,80,206,5,873870858,In > Out
Sept 2021,197,215,390,67923365,1416273095,1484196460,73,386,6,1348349730,In > Out
Sept 2021,197,219,200,71638144,625931907,697570051,85,198,5,554293763,In > Out
Sept 2021,197,221,552,196793119,1305926428,1502719547,200,530,7,1109133309,In > Out
Sept 2021,197,223,522,223947110,5220528476,5444475586,158,512,11,4996581366,In > Out
Sept 2021,197,25,262,79470179,1308852466,1388322645,102,262,6,1229382287,In > Out
Sept 2021,197,26,221,20351149,408212021,428563170,105,219,3,387860872,In > Out
Sept 2021,197,30,633,821583437,7631598450,8453181887,126,628,3,6810015013,In > Out
Sept 2021,197,31,400,75950033,1380839772,1456789805,132,397,6,1304889739,In > Out
Sept 2021,197,35,408,295065427,2123435889,2418501316,124,405,5,1828370462,In > Out
Sept 2021,197,38,233,114319719,222792689,337112408,84,233,4,108472970,In > Out
Sept 2021,197,4,528,3110544823,8854928141,11965472964,142,519,13,5744383318,In > Out
Sept 2021,197,41,283,151012836,2974835504,3125848340,137,281,7,2823822668,In > Out
Sept 2021,197,42,781,1837474217,6387998585,8225472802,156,767,12,4550524368,In > Out
Sept 2021,197,43,438,72733900,1781488302,1854222202,176,434,6,1708754402,In > Out
Sept 2021,197,44,417,337598508,1497670499,1835269007,147,415,9,1160071991,In > Out
Sept 2021,197,48,465,342567975,2880973571,3223541546,151,460,4,2538405596,In > Out
Sept 2021,197,49,516,969247553,1888531939,2857779492,95,510,4,919284386,In > Out
Sept 2021,197,51,241,2392067778,1837620139,4229687917,72,240,3,554447639,Out > In
Sept 2021,197,53,454,797674126,1275643416,2073317542,126,444,6,477969290,In > Out
Sept 2021,197,54,278,409939698,2118273819,2528213517,130,277,7,1708334121,In > Out
Sept 2021,197,55,275,86693827,3143444478,3230138305,107,273,7,3056750651,In > Out
Sept 2021,197,57,286,62073606,1014304615,1076378221,123,285,4,952231009,In > Out
Sept 2021,197,58,129,275159119,3954323547,4229482666,76,128,2,3679164428,In > Out
Sept 2021,197,60,226,69040127,1325529961,1394570088,128,225,1,1256489834,In > Out
Sept 2021,197,63,250,118747524,904932390,1023679914,94,249,3,786184866,In > Out
Sept 2021,197,65,209,317039519,1289035679,1606075198,102,208,4,971996160,In > Out
Sept 2021,197,68,211,85968737,437009765,522978502,97,211,4,351041028,In > Out
Sept 2021,197,71,457,125474136,9862310464,9987784600,80,453,3,9736836328,In > Out
Sept 2021,197,73,278,33484365,1159579308,1193063673,115,276,3,1126094943,In > Out
Sept 2021,197,74,303,37739360,1018108479,1055847839,108,299,7,980369119,In > Out
Sept 2021,197,75,297,847071686,3329754516,4176826202,121,295,6,2482682830,In > Out
Sept 2021,197,77,210,1519525534,1023600281,2543125815,85,207,6,495925253,Out > In
Sept 2021,197,78,270,1512777162,2167386294,3680163456,105,258,12,654609132,In > Out
Sept 2021,197,79,216,52559861,2278291702,2330851563,73,214,7,2225731841,In > Out
Sept 2021,197,80,522,449451465,1937235595,2386687060,176,512,9,1487784130,In > Out
Sept 2021,197,81,526,108230407,4906952831,5015183238,187,522,7,4798722424,In > Out
Sept 2021,197,82,214,542211364,698960778,1241172142,92,214,5,156749414,In > Out
Sept 2021,197,85,334,102555336,1945795123,2048350459,149,332,9,1843239787,In > Out
Sept 2021,197,86,515,1098752381,3131891012,4230643393,161,495,5,2033138631,In > Out
Sept 2021,197,87,270,4502027066,5608962680,10110989746,118,265,9,1106935614,In > Out
Sept 2021,197,9,406,50940560,1656859609,1707800169,159,400,5,1605919049,In > Out
Sept 2021,197,90,412,2018386281,5724724798,7743111079,171,395,13,3706338517,In > Out
Sept 2021,197,92,281,24597497,576642963,601240460,119,276,6,552045466,In > Out
Sept 2021,197,93,320,482384065,1209594343,1691978408,99,317,5,727210278,In > Out
Sept 2021,197,94,593,440006619,1568843797,2008850416,157,577,11,1128837178,In > Out
Sept 2021,197,98,286,167825426,595949585,763775011,119,284,6,428124159,In > Out
Sept 2021,197,99,1009,494760760,795371052,1290131812,125,1000,6,300610292,In > Out
Sept 2021,198,22,33590,8492334733,124329618335,132821953068,3332,14456,16,115837283602,In > Out
Sept 2021,2,1,15,1214860,945516,2160376,7,1,9,269344,Out > In
Sept 2021,2,100,6,1132348,233517,1365865,5,6,2,898831,Out > In
Sept 2021,2,13,92,1306682,83318007,84624689,11,92,1,82011325,In > Out
Sept 2021,2,14,2,705659,144029551,144735210,2,2,1,143323892,In > Out
Sept 2021,2,15,3,411225,3952265,4363490,3,3,3,3541040,In > Out
Sept 2021,2,16,92,1276049,82958220,84234269,11,92,1,81682171,In > Out
Sept 2021,2,21,466,27454059,507531411,534985470,45,457,3,480077352,In > Out
Sept 2021,2,244,4,184189,32548403,32732592,1,4,1,32364214,In > Out
Sept 2021,2,32,1,131805,5589,137394,1,1,1,126216,Out > In
Sept 2021,2,39,1,128336,4734,133070,1,1,1,123602,Out > In
Sept 2021,2,4,1,196080,95912,291992,1,1,1,100168,Out > In
Sept 2021,2,66,2,1566,984438,986004,1,1,1,982872,In > Out
Sept 2021,2,83,7,39419,975235,1014654,5,7,1,935816,In > Out
Sept 2021,2,85,1,6235,166444,172679,1,1,1,160209,In > Out
Sept 2021,2,91,893,9128379551,1340415158017,1349543537568,19,871,9,1331286778466,In > Out
Sept 2021,200,206,248,31850864,65588421,97439285,25,248,2,33737557,In > Out
Sept 2021,200,211,2054,26331902,1033135638,1059467540,14,1990,2,1006803736,In > Out
Sept 2021,200,34,123,21588503,432909985,454498488,36,123,2,411321482,In > Out
Sept 2021,200,40,12,1091886,92455091,93546977,4,12,2,91363205,In > Out
Sept 2021,200,43,8,1819064,230360,2049424,7,8,2,1588704,Out > In
Sept 2021,200,44,6,1581424,86419,1667843,5,6,1,1495005,Out > In
Sept 2021,200,61,7,2552583,41905813,44458396,6,7,1,39353230,In > Out
Sept 2021,200,65,11,783970,11826698,12610668,4,11,2,11042728,In > Out
Sept 2021,200,66,8,2897288,229507,3126795,7,8,2,2667781,Out > In
Sept 2021,200,68,54,1907073,122750992,124658065,9,54,2,120843919,In > Out
Sept 2021,200,89,7,1919747,105151,2024898,6,7,1,1814596,Out > In
Sept 2021,200,96,6,1693341,95180,1788521,5,6,1,1598161,Out > In
Sept 2021,203,158,604,39673757,854319340,893993097,235,589,2,814645583,In > Out
Sept 2021,203,160,28,45568433,235552690,281121123,10,28,3,189984257,In > Out
Sept 2021,203,20,56,1592630,92183649,93776279,9,56,2,90591019,In > Out
Sept 2021,203,220,1767,274281684,450871035,725152719,118,1691,2,176589351,In > Out
Sept 2021,203,221,1003,140448027,990244271,1130692298,270,977,2,849796244,In > Out
Sept 2021,203,23,131,13761224,473403729,487164953,30,131,2,459642505,In > Out
Sept 2021,203,249,700,185254860,2207940644,2393195504,118,689,2,2022685784,In > Out
Sept 2021,203,65,1406,111938863,2210696777,2322635640,309,1360,2,2098757914,In > Out
Sept 2021,204,192,4369,4283238943,44312546167,48595785110,834,3809,89,40029307224,In > Out
Sept 2021,206,115,2913,390564604,1677291950,2067856554,406,2742,3,1286727346,In > Out
Sept 2021,206,131,62,3889128,280588367,284477495,18,62,2,276699239,In > Out
Sept 2021,206,132,76,3853274,112495445,116348719,28,76,1,108642171,In > Out
Sept 2021,206,133,120,5702385,141116513,146818898,50,120,2,135414128,In > Out
Sept 2021,206,134,118,4015408,122195760,126211168,31,118,1,118180352,In > Out
Sept 2021,206,135,54,3546930,257367170,260914100,16,54,2,253820240,In > Out
Sept 2021,206,136,730,88421181,925411621,1013832802,152,713,2,836990440,In > Out
Sept 2021,206,137,916,22055765,771260696,793316461,103,915,2,749204931,In > Out
Sept 2021,206,138,586,12429814,493633096,506062910,100,585,2,481203282,In > Out
Sept 2021,206,139,418,15777043,1350974821,1366751864,46,418,1,1335197778,In > Out
Sept 2021,206,140,31,1300911,67136669,68437580,8,31,1,65835758,In > Out
Sept 2021,206,141,300,21809675,497105830,518915505,86,300,2,475296155,In > Out
Sept 2021,206,142,61,2213857,47889629,50103486,20,61,1,45675772,In > Out
Sept 2021,206,143,55,1050568,32777925,33828493,13,55,1,31727357,In > Out
Sept 2021,206,144,47,1886480,20822809,22709289,14,47,1,18936329,In > Out
Sept 2021,206,145,43,3291358,217070111,220361469,13,43,2,213778753,In > Out
Sept 2021,206,146,58,2068067,34581735,36649802,19,58,1,32513668,In > Out
Sept 2021,206,147,333,18570756,769604897,788175653,109,333,3,751034141,In > Out
Sept 2021,206,148,757,125089039,1133514256,1258603295,176,757,3,1008425217,In > Out
Sept 2021,206,149,453,12942573,408615145,421557718,100,453,2,395672572,In > Out
Sept 2021,206,150,51,1989178,50206354,52195532,21,51,1,48217176,In > Out
Sept 2021,206,151,111,9931284,239935125,249866409,36,111,2,230003841,In > Out
Sept 2021,206,152,40,1629586,89314446,90944032,14,40,1,87684860,In > Out
Sept 2021,206,155,207,429320279,892989094,1322309373,71,206,3,463668815,In > Out
Sept 2021,206,156,606,22639630,1096443499,1119083129,39,603,2,1073803869,In > Out
Sept 2021,206,158,491,45061012,844820105,889881117,38,489,2,799759093,In > Out
Sept 2021,206,161,80,3733575,79639139,83372714,38,80,2,75905564,In > Out
Sept 2021,206,162,32,950364,49840658,50791022,11,32,1,48890294,In > Out
Sept 2021,206,163,100,12038481,321598766,333637247,39,100,1,309560285,In > Out
Sept 2021,206,164,92,3536931,103983547,107520478,38,92,1,100446616,In > Out
Sept 2021,206,165,75,2962492,56390673,59353165,24,75,1,53428181,In > Out
Sept 2021,206,166,93,4279155,156951547,161230702,33,93,2,152672392,In > Out
Sept 2021,206,167,73,3023924,85959856,88983780,27,73,1,82935932,In > Out
Sept 2021,206,168,79,3010548,34496312,37506860,39,79,1,31485764,In > Out
Sept 2021,206,169,86,3458877,97450426,100909303,47,86,2,93991549,In > Out
Sept 2021,206,170,203,11044394,126513499,137557893,97,203,2,115469105,In > Out
Sept 2021,206,171,82,4011071,113432452,117443523,33,82,2,109421381,In > Out
Sept 2021,206,172,48,1456387,81615944,83072331,14,48,1,80159557,In > Out
Sept 2021,206,200,1857,546119424,12477509847,13023629271,389,1798,3,11931390423,In > Out
Sept 2021,206,208,13,250524,9135816,9386340,8,13,2,8885292,In > Out
Sept 2021,206,209,219,284127087,6399692358,6683819445,61,219,2,6115565271,In > Out
Sept 2021,206,244,588,284959146,1407951090,1692910236,106,456,2,1122991944,In > Out
Sept 2021,206,7,239,54833244,848684291,903517535,30,239,2,793851047,In > Out
Sept 2021,207,10,427,554591128,1068447642,1623038770,178,427,4,513856514,In > Out
Sept 2021,207,127,77,232499176,34241123,266740299,65,1,21,198258053,Out > In
Sept 2021,207,151,1165,87142260,315861718,403003978,102,1141,3,228719458,In > Out
Sept 2021,207,66,260,29322665,222968930,252291595,143,260,2,193646265,In > Out
Sept 2021,208,105,70,339974,9293581,9633555,3,70,2,8953607,In > Out
Sept 2021,208,112,2,53876,11231035,11284911,2,2,2,11177159,In > Out
Sept 2021,208,119,3,49280,7197626,7246906,3,3,2,7148346,In > Out
Sept 2021,208,125,2,1553462,716865,2270327,2,2,2,836597,Out > In
Sept 2021,208,127,1,452836,34052718,34505554,1,1,1,33599882,In > Out
Sept 2021,208,128,120,6872064,79940201,86812265,15,120,2,73068137,In > Out
Sept 2021,208,17,3,26317,1695732,1722049,3,3,1,1669415,In > Out
Sept 2021,208,18,2148,714544687,268957378,983502065,6,2039,2,445587309,Out > In
Sept 2021,208,29,3,813174,1719084,2532258,3,3,2,905910,In > Out
Sept 2021,208,30,5,1103485,495983,1599468,3,5,2,607502,Out > In
Sept 2021,208,32,5,163252,1346839,1510091,3,5,2,1183587,In > Out
Sept 2021,208,40,8,82388,11875845,11958233,6,8,2,11793457,In > Out
Sept 2021,208,41,6,362229,1549978,1912207,6,6,2,1187749,In > Out
Sept 2021,208,44,2,53924,13645409,13699333,2,2,1,13591485,In > Out
Sept 2021,208,47,8,58273,3664157,3722430,5,8,2,3605884,In > Out
Sept 2021,208,48,5,36857,2540075,2576932,3,5,2,2503218,In > Out
Sept 2021,208,49,3,224261,9230368,9454629,3,3,2,9006107,In > Out
Sept 2021,208,50,3,29231,1601522,1630753,3,3,1,1572291,In > Out
Sept 2021,208,55,3,25422,1925748,1951170,3,3,1,1900326,In > Out
Sept 2021,208,58,12,622167,7386428,8008595,8,12,2,6764261,In > Out
Sept 2021,208,59,2,13402,825922,839324,2,2,1,812520,In > Out
Sept 2021,208,60,4,1724310,7654678,9378988,4,4,2,5930368,In > Out
Sept 2021,208,62,5,1615846,8465212,10081058,4,5,2,6849366,In > Out
Sept 2021,208,69,3,26986,1712226,1739212,3,3,1,1685240,In > Out
Sept 2021,208,71,3,29215,1845356,1874571,3,3,1,1816141,In > Out
Sept 2021,208,78,2,17772,1177423,1195195,2,2,1,1159651,In > Out
Sept 2021,208,86,2,169764,48630248,48800012,1,2,1,48460484,In > Out
Sept 2021,208,87,17,398228,49220322,49618550,6,17,2,48822094,In > Out
Sept 2021,208,88,7,287845,45633632,45921477,3,7,1,45345787,In > Out
Sept 2021,208,89,1,5256,176194,181450,1,1,1,170938,In > Out
Sept 2021,208,91,3,476788,49557821,50034609,2,3,1,49081033,In > Out
Sept 2021,208,93,3,399095,49443323,49842418,2,3,1,49044228,In > Out
Sept 2021,209,100,4,207084507,6725194,213809701,3,4,2,200359313,Out > In
Sept 2021,209,101,2,100564,8682032,8782596,2,2,1,8581468,In > Out
Sept 2021,209,18,111,8929536,165646295,174575831,33,111,2,156716759,In > Out
Sept 2021,209,204,492,99286396,2271087203,2370373599,34,490,2,2171800807,In > Out
Sept 2021,209,214,38,1422496,102596469,104018965,6,37,2,101173973,In > Out
Sept 2021,209,65,22,40695839,4495068,45190907,7,22,2,36200771,Out > In
Sept 2021,210,36,450,157434957742,72739377959,230174335701,286,1,443,84695579783,Out > In
Sept 2021,210,44,884,548148823344,172407662496,720556485840,647,1,874,375741160848,Out > In
Sept 2021,213,1,111866,74786563374,745928611581,820715174955,8120,24148,779,671142048207,In > Out
Sept 2021,213,10,122700,73753360820,613283240597,687036601417,8566,22289,340,539529879777,In > Out
Sept 2021,213,100,118934,90164462243,648299955052,738464417295,8101,22850,483,558135492809,In > Out
Sept 2021,213,101,99060,139998218738,354955133724,494953352462,8159,22687,710,214956914986,In > Out
Sept 2021,213,102,105740,55731077830,579665529757,635396607587,8632,21112,776,523934451927,In > Out
Sept 2021,213,103,104176,51836127922,543059881384,594896009306,7575,23771,160,491223753462,In > Out
Sept 2021,213,104,109882,46008538455,459835416892,505843955347,7596,24914,449,413826878437,In > Out
Sept 2021,213,105,114971,81888476512,541676399450,623564875962,8576,23748,393,459787922938,In > Out
Sept 2021,213,106,99268,59891251277,417666813104,477558064381,7912,22885,164,357775561827,In > Out
Sept 2021,213,107,110886,77381078753,453410030958,530791109711,8280,23018,254,376028952205,In > Out
Sept 2021,213,108,94646,58099654347,490183445297,548283099644,6949,22194,343,432083790950,In > Out
Sept 2021,213,109,97707,56351158951,545625198284,601976357235,7471,22140,190,489274039333,In > Out
Sept 2021,213,11,109766,67694198145,446068266813,513762464958,8164,23572,502,378374068668,In > Out
Sept 2021,213,110,99409,74092659931,465353765054,539446424985,7169,21567,230,391261105123,In > Out
Sept 2021,213,111,109117,86698035432,475706811836,562404847268,7985,22489,233,389008776404,In > Out
Sept 2021,213,112,89126,47536860326,447952377356,495489237682,7111,24800,319,400415517030,In > Out
Sept 2021,213,113,98483,52942261364,414385047956,467327309320,7464,20774,164,361442786592,In > Out
Sept 2021,213,114,110053,57758784889,482301769013,540060553902,8059,22385,408,424542984124,In > Out
Sept 2021,213,115,87532,53139572592,435450286300,488589858892,6693,20866,168,382310713708,In > Out
Sept 2021,213,116,99088,95035065907,471140631959,566175697866,7486,20253,215,376105566052,In > Out
Sept 2021,213,117,107280,69696679629,479171785849,548868465478,8225,22868,369,409475106220,In > Out
Sept 2021,213,118,117479,73854601742,602355222610,676209824352,8441,22770,270,528500620868,In > Out
Sept 2021,213,119,92371,59071961819,444032415558,503104377377,7258,20515,175,384960453739,In > Out
Sept 2021,213,12,117318,74914445104,465514978129,540429423233,7898,23525,212,390600533025,In > Out
Sept 2021,213,120,97900,51757839189,422538928035,474296767224,7841,22569,597,370781088846,In > Out
Sept 2021,213,121,102396,50096508274,450800392125,500896900399,7257,22717,168,400703883851,In > Out
Sept 2021,213,122,90220,56353264018,353142234054,409495498072,6771,21126,214,296788970036,In > Out
Sept 2021,213,123,107479,70486684982,452039685825,522526370807,7641,21318,262,381553000843,In > Out
Sept 2021,213,124,113605,52404408361,595268604650,647673013011,7917,23318,218,542864196289,In > Out
Sept 2021,213,125,116515,54772469657,439563249024,494335718681,7812,22772,234,384790779367,In > Out
Sept 2021,213,126,109083,102707735760,643739030437,746446766197,8636,23839,1105,541031294677,In > Out
Sept 2021,213,127,102805,46227916639,415838515011,462066431650,7533,22471,523,369610598372,In > Out
Sept 2021,213,128,104414,50433152304,735475593650,785908745954,7767,22131,363,685042441346,In > Out
Sept 2021,213,129,115484,116197135094,769613011274,885810146368,7624,22767,313,653415876180,In > Out
Sept 2021,213,13,116102,76926839429,663230185145,740157024574,8069,21206,582,586303345716,In > Out
Sept 2021,213,130,108625,133410228974,1878893004948,2012303233922,8618,22250,573,1745482775974,In > Out
Sept 2021,213,131,101228,58339795349,384496553608,442836348957,7894,21507,160,326156758259,In > Out
Sept 2021,213,132,107577,149174985484,702009338738,851184324222,7856,21844,207,552834353254,In > Out
Sept 2021,213,133,100227,48170626504,454398996658,502569623162,7511,21326,177,406228370154,In > Out
Sept 2021,213,134,103595,45138296436,613577632738,658715929174,7978,21587,189,568439336302,In > Out
Sept 2021,213,135,100702,82425735018,533855735548,616281470566,8004,21804,505,451430000530,In > Out
Sept 2021,213,136,108273,114662065751,536108278792,650770344543,8057,23782,389,421446213041,In > Out
Sept 2021,213,137,116067,65828915530,592087317481,657916233011,8164,22390,246,526258401951,In > Out
Sept 2021,213,138,99426,81761246892,495934660339,577695907231,7553,22870,262,414173413447,In > Out
Sept 2021,213,139,106214,54804401407,586589672759,641394074166,7738,22525,182,531785271352,In > Out
Sept 2021,213,14,100713,58523342263,548870038105,607393380368,7767,22209,321,490346695842,In > Out
Sept 2021,213,140,128900,80592533607,617486119033,698078652640,8392,22334,236,536893585426,In > Out
Sept 2021,213,141,105863,54850766536,502036527543,556887294079,7767,21951,201,447185761007,In > Out
Sept 2021,213,142,92748,50676213159,432729827622,483406040781,7199,21066,188,382053614463,In > Out
Sept 2021,213,143,110803,74081736143,680080861875,754162598018,7683,21118,210,605999125732,In > Out
Sept 2021,213,144,111773,71267367961,670608608342,741875976303,9166,22680,1133,599341240381,In > Out
Sept 2021,213,145,92797,75875978317,432131377365,508007355682,7641,21736,393,356255399048,In > Out
Sept 2021,213,146,114974,108469543513,535989487513,644459031026,8325,21886,303,427519944000,In > Out
Sept 2021,213,147,111747,38729513016,506816599362,545546112378,8742,25304,217,468087086346,In > Out
Sept 2021,213,148,96466,77229237601,546721252840,623950490441,7620,22159,319,469492015239,In > Out
Sept 2021,213,149,113848,95864231498,567827848612,663692080110,8731,22269,536,471963617114,In > Out
Sept 2021,213,15,104042,87855647827,495454758924,583310406751,7625,21070,212,407599111097,In > Out
Sept 2021,213,150,105612,59432802763,471361645813,530794448576,7954,22728,193,411928843050,In > Out
Sept 2021,213,151,108229,71531251002,985505559149,1057036810151,7852,23195,174,913974308147,In > Out
Sept 2021,213,152,105240,65330413303,440374949462,505705362765,7583,22625,239,375044536159,In > Out
Sept 2021,213,153,96958,56822641327,576800469411,633623110738,7830,21799,342,519977828084,In > Out
Sept 2021,213,154,107385,86419444898,527372157981,613791602879,8496,21931,883,440952713083,In > Out
Sept 2021,213,155,95931,42873897859,486511446289,529385344148,7428,23048,388,443637548430,In > Out
Sept 2021,213,156,103663,93043943689,544189541137,637233484826,7998,21263,892,451145597448,In > Out
Sept 2021,213,157,94056,54251971748,433961187775,488213159523,7471,21821,339,379709216027,In > Out
Sept 2021,213,158,99753,76710384384,507348304772,584058689156,7573,22434,670,430637920388,In > Out
Sept 2021,213,159,100884,42833476553,397595111248,440428587801,7769,21833,222,354761634695,In > Out
Sept 2021,213,16,118477,49564727916,455578925050,505143652966,8218,22512,299,406014197134,In > Out
Sept 2021,213,160,105374,61625262287,505869333093,567494595380,7973,21717,545,444244070806,In > Out
Sept 2021,213,161,100153,79263170014,499198340865,578461510879,7486,21759,181,419935170851,In > Out
Sept 2021,213,162,119531,64871925611,726384470162,791256395773,8049,21365,640,661512544551,In > Out
Sept 2021,213,163,102402,70680570995,478563870372,549244441367,7989,21067,627,407883299377,In > Out
Sept 2021,213,164,100485,64765903973,480217524117,544983428090,7542,22072,274,415451620144,In > Out
Sept 2021,213,165,108906,60084257009,581652868412,641737125421,8058,21591,375,521568611403,In > Out
Sept 2021,213,166,85672,74865630106,384598490658,459464120764,7065,20877,332,309732860552,In > Out
Sept 2021,213,167,106727,241771664541,639812566854,881584231395,8219,20902,273,398040902313,In > Out
Sept 2021,213,168,110893,65800836114,665597042084,731397878198,7861,21718,218,599796205970,In > Out
Sept 2021,213,169,105337,77103089735,620779574210,697882663945,8059,22489,239,543676484475,In > Out
Sept 2021,213,17,111733,57997003603,471269727121,529266730724,9134,22948,1189,413272723518,In > Out
Sept 2021,213,170,103889,61638049875,460254883280,521892933155,7631,22197,248,398616833405,In > Out
Sept 2021,213,171,103455,89868402566,540262771481,630131174047,8217,20671,741,450394368915,In > Out
Sept 2021,213,172,114211,84362129959,695235730511,779597860470,8630,21353,361,610873600552,In > Out
Sept 2021,213,173,109506,80834743222,510963411556,591798154778,8067,21848,258,430128668334,In > Out
Sept 2021,213,174,110984,55428102505,534137261565,589565364070,8688,22895,821,478709159060,In > Out
Sept 2021,213,175,109621,69749868898,488231804694,557981673592,8049,23545,420,418481935796,In > Out
Sept 2021,213,176,97034,60250842026,423982638326,484233480352,7853,21386,211,363731796300,In > Out
Sept 2021,213,177,108333,58309056290,517149021946,575458078236,7936,22114,209,458839965656,In > Out
Sept 2021,213,178,106030,56314365851,504264884780,560579250631,7505,22388,186,447950518929,In > Out
Sept 2021,213,179,100692,157901657551,467432411835,625334069386,8143,23006,341,309530754284,In > Out
Sept 2021,213,18,92571,38505558650,448333788972,486839347622,7446,22438,327,409828230322,In > Out
Sept 2021,213,180,106440,58450349983,442783706237,501234056220,7852,22244,176,384333356254,In > Out
Sept 2021,213,181,106014,48572044457,504628334110,553200378567,8321,22904,261,456056289653,In > Out
Sept 2021,213,182,116006,66489594614,590802493319,657292087933,7864,22324,223,524312898705,In > Out
Sept 2021,213,183,116998,76103776907,586717299525,662821076432,8623,22194,1053,510613522618,In > Out
Sept 2021,213,184,110140,93456767595,812387930421,905844698016,7335,21965,404,718931162826,In > Out
Sept 2021,213,185,102987,51432785503,480191349981,531624135484,7674,22213,248,428758564478,In > Out
Sept 2021,213,186,113861,121233781011,604851239076,726085020087,8347,23471,328,483617458065,In > Out
Sept 2021,213,187,114794,58422070406,868593804156,927015874562,7968,21614,285,810171733750,In > Out
Sept 2021,213,188,133776,100322901254,790642159168,890965060422,8724,22739,376,690319257914,In > Out
Sept 2021,213,189,117559,64459725204,537705875536,602165600740,9576,22379,1487,473246150332,In > Out
Sept 2021,213,19,126494,69462789532,539322942012,608785731544,8762,21857,324,469860152480,In > Out
Sept 2021,213,190,100850,51449342658,700451837239,751901179897,7208,21634,162,649002494581,In > Out
Sept 2021,213,191,114193,60040922773,549330878351,609371801124,8859,22003,753,489289955578,In > Out
Sept 2021,213,192,106581,65588328534,492782448993,558370777527,8094,21529,401,427194120459,In > Out
Sept 2021,213,193,111286,69630366438,594104203789,663734570227,8762,23172,300,524473837351,In > Out
Sept 2021,213,194,116593,59179442245,531438344044,590617786289,8465,22681,289,472258901799,In > Out
Sept 2021,213,195,97636,69493908571,463979821695,533473730266,7197,21301,242,394485913124,In > Out
Sept 2021,213,196,122978,81424674214,593064403188,674489077402,8686,23128,381,511639728974,In > Out
Sept 2021,213,197,121048,68494280350,569404930098,637899210448,7915,22917,261,500910649748,In > Out
Sept 2021,213,198,122779,86703618627,602613883876,689317502503,8758,22719,618,515910265249,In > Out
Sept 2021,213,199,115019,110138172393,851004730235,961142902628,7846,23079,187,740866557842,In > Out
Sept 2021,213,2,114597,115908828597,648244393492,764153222089,7871,23409,208,532335564895,In > Out
Sept 2021,213,20,106973,72085219465,574991160009,647076379474,8010,23077,201,502905940544,In > Out
Sept 2021,213,200,109158,81458460659,612630498797,694088959456,8100,21735,424,531172038138,In > Out
Sept 2021,213,201,131248,93520110312,772704428779,866224539091,9108,23975,324,679184318467,In > Out
Sept 2021,213,202,105528,78339546919,416196553666,494536100585,8210,21975,223,337857006747,In > Out
Sept 2021,213,203,108196,64187860618,669992358332,734180218950,8093,22216,408,605804497714,In > Out
Sept 2021,213,204,116663,80640553439,570761579209,651402132648,8039,22173,382,490121025770,In > Out
Sept 2021,213,205,119824,75437739240,554228957427,629666696667,8154,23614,248,478791218187,In > Out
Sept 2021,213,206,137642,96418440949,900563982301,996982423250,9035,21732,457,804145541352,In > Out
Sept 2021,213,207,112202,43758791312,440044088719,483802880031,7810,21876,200,396285297407,In > Out
Sept 2021,213,208,116086,72769493862,507988996309,580758490171,8175,23096,172,435219502447,In > Out
Sept 2021,213,209,150130,82175530382,1309771994662,1391947525044,8965,22138,580,1227596464280,In > Out
Sept 2021,213,21,107051,66828596307,591232432306,658061028613,8149,21771,222,524403835999,In > Out
Sept 2021,213,210,115932,83629488387,679371626019,763001114406,8650,22549,246,595742137632,In > Out
Sept 2021,213,211,125908,72140096243,720968068981,793108165224,8409,23376,357,648827972738,In > Out
Sept 2021,213,212,129271,89306149495,713930199591,803236349086,8312,22742,823,624624050096,In > Out
Sept 2021,213,213,118039,87926423584,471172562944,559098986528,8281,23064,315,383246139360,In > Out
Sept 2021,213,214,122460,109598188524,571636526742,681234715266,8234,23339,221,462038338218,In > Out
Sept 2021,213,215,103463,60714545577,509875320908,570589866485,7325,22424,184,449160775331,In > Out
Sept 2021,213,216,120604,104643122042,634040578516,738683700558,8103,23428,469,529397456474,In > Out
Sept 2021,213,217,111190,72611406170,512440111228,585051517398,8075,23017,450,439828705058,In > Out
Sept 2021,213,218,114813,63707163373,526124648549,589831811922,8068,23612,212,462417485176,In > Out
Sept 2021,213,219,122423,107494325140,541510546657,649004871797,8028,22274,297,434016221517,In > Out
Sept 2021,213,22,112370,60720844143,538069003866,598789848009,7673,22132,215,477348159723,In > Out
Sept 2021,213,220,110341,81285245911,551630025613,632915271524,8496,21943,509,470344779702,In > Out
Sept 2021,213,221,120746,59457327726,630600300103,690057627829,8566,23002,241,571142972377,In > Out
Sept 2021,213,222,121697,174532100619,665470280715,840002381334,8720,23004,292,490938180096,In > Out
Sept 2021,213,223,116457,132716501946,686527571216,819244073162,8492,22567,391,553811069270,In > Out
Sept 2021,213,224,111898,57432145645,588992706448,646424852093,7967,22264,406,531560560803,In > Out
Sept 2021,213,225,128646,76644982306,656536480292,733181462598,9282,22070,729,579891497986,In > Out
Sept 2021,213,226,121787,116434360433,468446393846,584880754279,8176,22389,407,352012033413,In > Out
Sept 2021,213,227,116308,88899013451,574858705665,663757719116,8887,23893,617,485959692214,In > Out
Sept 2021,213,228,111637,72689487847,485659238783,558348726630,8072,22629,213,412969750936,In > Out
Sept 2021,213,229,122756,79194838659,490870295190,570065133849,8755,23457,441,411675456531,In > Out
Sept 2021,213,23,118646,102808039144,723465006381,826273045525,8418,22747,380,620656967237,In > Out
Sept 2021,213,230,111201,74184766763,633246898781,707431665544,7372,23995,975,559062132018,In > Out
Sept 2021,213,231,142731,137131776949,545467944684,682599721633,8635,24115,401,408336167735,In > Out
Sept 2021,213,232,128089,79827753792,682556302288,762384056080,8485,23821,430,602728548496,In > Out
Sept 2021,213,233,127211,80092752102,630849671594,710942423696,8946,22184,365,550756919492,In > Out
Sept 2021,213,234,100585,65292594754,439265544313,504558139067,7607,22485,188,373972949559,In > Out
Sept 2021,213,235,124584,81695358004,691389832073,773085190077,8369,23904,224,609694474069,In > Out
Sept 2021,213,236,109265,71017738655,499414579936,570432318591,8037,22170,434,428396841281,In > Out
Sept 2021,213,237,112596,83321531772,806869350082,890190881854,8157,20528,795,723547818310,In > Out
Sept 2021,213,238,151251,104903098088,899790673488,1004693771576,10025,23248,627,794887575400,In > Out
Sept 2021,213,239,133984,102900867734,640753235053,743654102787,8574,23033,213,537852367319,In > Out
Sept 2021,213,24,128643,105891693162,524443553409,630335246571,8520,23690,424,418551860247,In > Out
Sept 2021,213,240,105527,72124738156,452153696274,524278434430,8002,22964,527,380028958118,In > Out
Sept 2021,213,241,130967,90554643933,653341713387,743896357320,8749,23150,257,562787069454,In > Out
Sept 2021,213,242,111397,77214057570,501309969164,578524026734,7699,22542,253,424095911594,In > Out
Sept 2021,213,243,120242,74155958064,605669717882,679825675946,7805,23147,213,531513759818,In > Out
Sept 2021,213,244,114604,64022598781,638027246365,702049845146,8021,22475,539,574004647584,In > Out
Sept 2021,213,245,118814,98885317819,572256487565,671141805384,8808,23869,572,473371169746,In > Out
Sept 2021,213,246,130350,90521773583,688918611534,779440385117,8572,23491,358,598396837951,In > Out
Sept 2021,213,247,117503,70798343791,597725061807,668523405598,8360,24270,435,526926718016,In > Out
Sept 2021,213,248,105507,79765530127,440482724836,520248254963,7709,22733,225,360717194709,In > Out
Sept 2021,213,249,115408,54191400136,668679837996,722871238132,8889,21378,259,614488437860,In > Out
Sept 2021,213,25,116089,57118630607,466484286093,523602916700,7383,21085,305,409365655486,In > Out
Sept 2021,213,250,111240,59085417984,495612154584,554697572568,8277,22594,367,436526736600,In > Out
Sept 2021,213,251,108628,83538578896,719678116602,803216695498,8101,23837,452,636139537706,In > Out
Sept 2021,213,252,109096,144745162856,504236292156,648981455012,8734,22305,1364,359491129300,In > Out
Sept 2021,213,253,105629,79313015305,597738314745,677051330050,8148,22088,238,518425299440,In > Out
Sept 2021,213,26,107850,81959187816,616571749265,698530937081,7913,22571,232,534612561449,In > Out
Sept 2021,213,27,125814,65711090557,538848676952,604559767509,8230,23125,419,473137586395,In > Out
Sept 2021,213,28,106072,80346311921,412857685557,493203997478,8048,21899,345,332511373636,In > Out
Sept 2021,213,29,116095,69463706609,602533064894,671996771503,8141,21724,233,533069358285,In > Out
Sept 2021,213,3,100962,52009874451,446587325712,498597200163,7860,22849,331,394577451261,In > Out
Sept 2021,213,30,116693,98069168962,465313171160,563382340122,7354,21655,222,367244002198,In > Out
Sept 2021,213,31,126702,106246138396,533646407040,639892545436,8914,22658,1106,427400268644,In > Out
Sept 2021,213,32,100346,56932132318,450227179985,507159312303,7166,23270,300,393295047667,In > Out
Sept 2021,213,33,91320,72127558526,425089908544,497217467070,6965,21430,339,352962350018,In > Out
Sept 2021,213,34,106727,45076606797,517870405458,562947012255,7998,22165,198,472793798661,In > Out
Sept 2021,213,35,119772,93695641386,625975199403,719670840789,8071,23320,230,532279558017,In > Out
Sept 2021,213,36,104692,58481490218,468961811788,527443302006,7394,22450,198,410480321570,In > Out
Sept 2021,213,37,104204,47789391621,390364301780,438153693401,7317,21417,177,342574910159,In > Out
Sept 2021,213,38,94265,73794757408,486036052763,559830810171,7607,21327,410,412241295355,In > Out
Sept 2021,213,39,105516,77909766610,958973866819,1036883633429,8105,23157,337,881064100209,In > Out
Sept 2021,213,4,105264,72619687083,448181765090,520801452173,7620,22272,263,375562078007,In > Out
Sept 2021,213,40,101782,121757421511,521635388431,643392809942,7859,21750,199,399877966920,In > Out
Sept 2021,213,41,115579,53644306844,771386911757,825031218601,8349,22380,330,717742604913,In > Out
Sept 2021,213,42,106043,61316586752,499335689502,560652276254,7877,21526,322,438019102750,In > Out
Sept 2021,213,43,117267,86063578746,623884370786,709947949532,8030,22853,195,537820792040,In > Out
Sept 2021,213,44,122933,141995795810,643192494363,785188290173,8842,23242,320,501196698553,In > Out
Sept 2021,213,45,109307,53362918328,469828594931,523191513259,7962,22147,274,416465676603,In > Out
Sept 2021,213,46,107048,66816001517,548939120963,615755122480,8093,22045,326,482123119446,In > Out
Sept 2021,213,47,109566,89271312161,472215414751,561486726912,8410,24842,488,382944102590,In > Out
Sept 2021,213,48,108380,101034606977,491575632932,592610239909,7827,21918,237,390541025955,In > Out
Sept 2021,213,49,116563,91913638763,566747993425,658661632188,7925,23445,250,474834354662,In > Out
Sept 2021,213,5,118241,70812886198,695808310346,766621196544,8529,23795,315,624995424148,In > Out
Sept 2021,213,50,114918,144631866531,586833305814,731465172345,8446,22581,264,442201439283,In > Out
Sept 2021,213,51,101661,66230916429,443242130354,509473046783,7142,23375,183,377011213925,In > Out
Sept 2021,213,52,95445,65290335609,391871548003,457161883612,7279,21783,168,326581212394,In > Out
Sept 2021,213,53,133275,75215189805,661981362275,737196552080,8235,22580,317,586766172470,In > Out
Sept 2021,213,54,100460,98218077040,484330486835,582548563875,7392,22863,253,386112409795,In > Out
Sept 2021,213,55,96288,58077017243,370905296107,428982313350,6953,22847,225,312828278864,In > Out
Sept 2021,213,56,114516,64801728960,591079717447,655881446407,8549,22883,385,526277988487,In > Out
Sept 2021,213,57,112956,66905568095,801069858599,867975426694,8313,22998,339,734164290504,In > Out
Sept 2021,213,58,100755,52763531609,465094533944,517858065553,7391,21161,152,412331002335,In > Out
Sept 2021,213,59,96177,101187754802,567976784675,669164539477,7639,21444,584,466789029873,In > Out
Sept 2021,213,6,103855,56074552161,549088549404,605163101565,7668,21514,166,493013997243,In > Out
Sept 2021,213,60,103669,92585176454,667565699640,760150876094,7449,21569,277,574980523186,In > Out
Sept 2021,213,61,108122,70827384366,549949632639,620777017005,8346,21882,257,479122248273,In > Out
Sept 2021,213,62,120031,118073351568,610872765284,728946116852,8311,23429,329,492799413716,In > Out
Sept 2021,213,63,88463,56326578038,490276554139,546603132177,7495,20166,507,433949976101,In > Out
Sept 2021,213,64,97333,65212269356,532457898495,597670167851,7008,21139,226,467245629139,In > Out
Sept 2021,213,65,119159,77742631862,640643442524,718386074386,8515,24872,351,562900810662,In > Out
Sept 2021,213,66,88455,48521713178,411499822334,460021535512,7290,21208,187,362978109156,In > Out
Sept 2021,213,67,92821,53157745323,437321035758,490478781081,7006,21901,210,384163290435,In > Out
Sept 2021,213,68,102071,64112756802,454790985684,518903742486,7415,23055,253,390678228882,In > Out
Sept 2021,213,69,108234,70510179761,516338878579,586849058340,8371,21961,289,445828698818,In > Out
Sept 2021,213,7,114104,57127845280,526208296826,583336142106,8315,22564,365,469080451546,In > Out
Sept 2021,213,70,94464,50261286147,526800847792,577062133939,7645,21383,171,476539561645,In > Out
Sept 2021,213,71,93668,47233110552,423307584265,470540694817,7030,20827,290,376074473713,In > Out
Sept 2021,213,72,100011,51887223366,517557231178,569444454544,7197,22751,313,465670007812,In > Out
Sept 2021,213,73,111840,74144733531,607220140552,681364874083,8090,20989,219,533075407021,In > Out
Sept 2021,213,74,105624,66500689847,490948239995,557448929842,7557,22063,242,424447550148,In > Out
Sept 2021,213,75,99768,54126416582,481437602786,535564019368,7396,23316,195,427311186204,In > Out
Sept 2021,213,76,93012,74349857519,407306675365,481656532884,7362,20946,163,332956817846,In > Out
Sept 2021,213,77,92210,53904449747,446171153838,500075603585,6919,21836,183,392266704091,In > Out
Sept 2021,213,78,90326,57186029537,506460684844,563646714381,7266,21290,344,449274655307,In > Out
Sept 2021,213,79,126922,86749799247,627958384477,714708183724,8839,22099,516,541208585230,In > Out
Sept 2021,213,8,122739,70408461460,659873584561,730282046021,8939,23423,721,589465123101,In > Out
Sept 2021,213,80,112155,72248666997,558523053573,630771720570,8630,23282,348,486274386576,In > Out
Sept 2021,213,81,115164,68567661141,450139006278,518706667419,8454,24204,199,381571345137,In > Out
Sept 2021,213,82,107306,71784575335,542767162062,614551737397,8151,22358,593,470982586727,In > Out
Sept 2021,213,83,109385,100290128441,556598997893,656889126334,7945,22171,431,456308869452,In > Out
Sept 2021,213,84,106736,53360327086,439528094617,492888421703,7849,22984,234,386167767531,In > Out
Sept 2021,213,85,93880,67032283714,595976632059,663008915773,7621,22850,457,528944348345,In > Out
Sept 2021,213,86,111002,138012269067,502726573933,640738843000,8035,22224,359,364714304866,In > Out
Sept 2021,213,87,112458,54429739033,472424706444,526854445477,8241,22387,281,417994967411,In > Out
Sept 2021,213,88,105409,76180459772,431900996740,508081456512,7892,22542,297,355720536968,In > Out
Sept 2021,213,89,114700,94822279532,552850561164,647672840696,8682,22367,241,458028281632,In > Out
Sept 2021,213,9,111098,95565374953,583110119127,678675494080,8227,22046,344,487544744174,In > Out
Sept 2021,213,90,112201,73719721180,536777549687,610497270867,8001,23300,278,463057828507,In > Out
Sept 2021,213,91,101444,49881401010,418035346330,467916747340,7480,24090,232,368153945320,In > Out
Sept 2021,213,92,98019,65610565606,474696183439,540306749045,7207,22302,151,409085617833,In > Out
Sept 2021,213,93,102593,59878952592,381719223494,441598176086,7539,22786,184,321840270902,In > Out
Sept 2021,213,94,110787,63656016343,534067082162,597723098505,7707,22666,213,470411065819,In > Out
Sept 2021,213,95,109727,64868849319,553364877710,618233727029,7881,22140,163,488496028391,In > Out
Sept 2021,213,96,95621,91613494876,454512735240,546126230116,7595,20216,190,362899240364,In > Out
Sept 2021,213,97,99278,50153613168,502237151176,552390764344,7336,21808,199,452083538008,In > Out
Sept 2021,213,98,100015,50474308682,561397039753,611871348435,7512,21887,240,510922731071,In > Out
Sept 2021,213,99,145742,51275126912,508131432914,559406559826,7656,22573,242,456856306002,In > Out
Sept 2021,214,146,29,3937121,87120421,91057542,10,29,1,83183300,In > Out
Sept 2021,215,103,2,1058706,122255271,123313977,1,2,1,121196565,In > Out
Sept 2021,215,113,614,4599782709,2954029909,7553812618,152,426,122,1645752800,Out > In
Sept 2021,215,115,32,1503407,12439915,13943322,16,32,2,10936508,In > Out
Sept 2021,215,120,851,57412058,1442894570,1500306628,51,832,2,1385482512,In > Out
Sept 2021,215,139,523,1615243611,3805607795,5420851406,47,523,3,2190364184,In > Out
Sept 2021,215,142,925,153777865,565966946,719744811,56,902,3,412189081,In > Out
Sept 2021,215,149,74,5035997,34273132,39309129,16,74,1,29237135,In > Out
Sept 2021,215,154,13,34301897,29851555,64153452,6,13,4,4450342,Out > In
Sept 2021,215,157,1456,797224933,624822167,1422047100,184,1386,3,172402766,Out > In
Sept 2021,215,163,148,9788664,428669078,438457742,52,148,2,418880414,In > Out
Sept 2021,215,171,59,6977135,110608297,117585432,16,59,2,103631162,In > Out
Sept 2021,215,181,746,119437290,1685034077,1804471367,52,745,2,1565596787,In > Out
Sept 2021,215,195,13,986400,33466902,34453302,6,13,2,32480502,In > Out
Sept 2021,215,204,11,3380241,110117302,113497543,7,11,2,106737061,In > Out
Sept 2021,215,205,3,98618,2505742,2604360,2,3,1,2407124,In > Out
Sept 2021,215,209,529,124176737,2168564372,2292741109,46,524,2,2044387635,In > Out
Sept 2021,215,220,11,176378454,998987005,1175365459,9,11,3,822608551,In > Out
Sept 2021,215,24,187,8988894,346536185,355525079,26,187,2,337547291,In > Out
Sept 2021,215,26,9,699889,40606221,41306110,9,9,2,39906332,In > Out
Sept 2021,215,38,64,1393037,80502507,81895544,11,64,2,79109470,In > Out
Sept 2021,215,42,9,1939605,162463459,164403064,7,9,2,160523854,In > Out
Sept 2021,215,51,12256,5472208529,14020186598,19492395127,892,8690,7,8547978069,In > Out
Sept 2021,215,54,405,79261299,216263503,295524802,148,399,2,137002204,In > Out
Sept 2021,215,55,364,35780227,242380404,278160631,19,359,2,206600177,In > Out
Sept 2021,215,62,80,7366809,71860142,79226951,13,80,2,64493333,In > Out
Sept 2021,215,71,597,111305132,1187961718,1299266850,84,590,2,1076656586,In > Out
Sept 2021,215,74,1,136720,29166988,29303708,1,1,1,29030268,In > Out
Sept 2021,215,78,601,9470857,634945162,644416019,49,591,2,625474305,In > Out
Sept 2021,215,86,11,1977333,108590617,110567950,4,11,2,106613284,In > Out
Sept 2021,215,97,800,31697859,1498252192,1529950051,27,798,2,1466554333,In > Out
Sept 2021,22,67,219,16842519,381293989,398136508,57,208,2,364451470,In > Out
Sept 2021,220,32,6,5232050,168864,5400914,4,1,6,5063186,Out > In
Sept 2021,221,102,15,347150,10450160,10797310,9,15,2,10103010,In > Out
Sept 2021,221,117,589,26108444,606431057,632539501,183,577,2,580322613,In > Out
Sept 2021,221,121,7,307998,11893163,12201161,4,7,2,11585165,In > Out
Sept 2021,221,132,13,60882,5472732,5533614,3,13,1,5411850,In > Out
Sept 2021,221,146,5,457206,9646179,10103385,4,5,2,9188973,In > Out
Sept 2021,221,147,91,13167339,286444467,299611806,36,91,2,273277128,In > Out
Sept 2021,221,152,186,16564642,659662532,676227174,91,185,2,643097890,In > Out
Sept 2021,221,159,59,7148872,171176371,178325243,35,59,2,164027499,In > Out
Sept 2021,221,16,144,92234070,222291736,314525806,16,116,30,130057666,In > Out
Sept 2021,221,161,1,15453,1273560,1289013,1,1,1,1258107,In > Out
Sept 2021,221,165,1927,220666475,2053433393,2274099868,31,474,2,1832766918,In > Out
Sept 2021,221,168,1178,4292249789,13969263382,18261513171,342,1138,7,9677013593,In > Out
Sept 2021,221,181,992,155488427,821198215,976686642,85,959,3,665709788,In > Out
Sept 2021,221,185,427,231970456,1037968996,1269939452,170,424,4,805998540,In > Out
Sept 2021,221,192,519,32002474,708641825,740644299,190,512,2,676639351,In > Out
Sept 2021,221,200,657,8715591,602162701,610878292,31,647,2,593447110,In > Out
Sept 2021,221,208,170,14010195,831169573,845179768,19,170,2,817159378,In > Out
Sept 2021,221,212,188,17443876,235100241,252544117,83,187,4,217656365,In > Out
Sept 2021,221,214,226,19924646,292413968,312338614,53,225,2,272489322,In > Out
Sept 2021,221,217,4,49324,2288806,2338130,4,4,2,2239482,In > Out
Sept 2021,221,22,25,824699,75921110,76745809,9,24,3,75096411,In > Out
Sept 2021,221,24,1270,144110706,1876777693,2020888399,262,1095,4,1732666987,In > Out
Sept 2021,221,36,363,147783099,1154756919,1302540018,142,363,3,1006973820,In > Out
Sept 2021,221,40,201,4735524,332758181,337493705,92,200,2,328022657,In > Out
Sept 2021,221,42,1,434547,7936,442483,1,1,1,426611,Out > In
Sept 2021,221,46,2330,2052559692,4527345830,6579905522,452,2159,24,2474786138,In > Out
Sept 2021,221,57,594,199610780,559366003,758976783,161,583,2,359755223,In > Out
Sept 2021,221,68,4104,888789854,15294500964,16183290818,791,3629,4,14405711110,In > Out
Sept 2021,221,80,2284,1289355313,4784541073,6073896386,174,2156,4,3495185760,In > Out
Sept 2021,221,82,481,193044260,4776190109,4969234369,116,448,2,4583145849,In > Out
Sept 2021,221,84,1360,159365426,616348763,775714189,267,1333,2,456983337,In > Out
Sept 2021,221,97,964,531705357,2336289331,2867994688,192,938,3,1804583974,In > Out
Sept 2021,222,2,7,14834,814071,828905,3,7,1,799237,In > Out
Sept 2021,224,125,1,5575,354169,359744,1,1,1,348594,In > Out
Sept 2021,224,172,74,2557930,94367611,96925541,20,74,2,91809681,In > Out
Sept 2021,224,179,546,75704606,2796541818,2872246424,136,542,4,2720837212,In > Out
Sept 2021,224,201,393,10293974,371530556,381824530,43,389,1,361236582,In > Out
Sept 2021,224,221,561,83026974,2114759482,2197786456,181,553,3,2031732508,In > Out
Sept 2021,224,223,473,113815887,5456823298,5570639185,54,473,2,5343007411,In > Out
Sept 2021,224,5,1620,115365293,1879532345,1994897638,571,1536,2,1764167052,In > Out
Sept 2021,225,103,471,171341823,771444890,942786713,169,470,3,600103067,In > Out
Sept 2021,225,105,187,4457467364,192077433,4649544797,53,185,2,4265389931,Out > In
Sept 2021,225,107,20,1193171,47191763,48384934,9,20,2,45998592,In > Out
Sept 2021,225,109,94,7151603,126519763,133671366,18,94,2,119368160,In > Out
Sept 2021,225,111,328,41346542,909196302,950542844,120,326,3,867849760,In > Out
Sept 2021,225,122,196,49071095,2236434284,2285505379,102,196,2,2187363189,In > Out
Sept 2021,225,130,119,6110304,118508934,124619238,43,117,2,112398630,In > Out
Sept 2021,225,136,1858,251930527,3103187245,3355117772,348,1763,5,2851256718,In > Out
Sept 2021,225,138,288,58556184,144960437,203516621,73,287,2,86404253,In > Out
Sept 2021,225,144,187,28125693,193785795,221911488,60,187,2,165660102,In > Out
Sept 2021,225,149,1092,211747819,803437665,1015185484,210,1053,4,591689846,In > Out
Sept 2021,225,152,790,105976979,152512002,258488981,14,768,2,46535023,In > Out
Sept 2021,225,172,1,7174,333048,340222,1,1,1,325874,In > Out
Sept 2021,225,193,53,5301464,36284470,41585934,13,53,1,30983006,In > Out
Sept 2021,225,200,3,62384,3101022,3163406,2,3,1,3038638,In > Out
Sept 2021,225,202,257,23884436,101799966,125684402,21,255,2,77915530,In > Out
Sept 2021,225,206,28,1273380,44976403,46249783,20,28,2,43703023,In > Out
Sept 2021,225,21,1,8926,242779,251705,1,1,1,233853,In > Out
Sept 2021,225,211,150,19694035,335922546,355616581,27,148,2,316228511,In > Out
Sept 2021,225,219,821,29073002,1084031673,1113104675,219,821,2,1054958671,In > Out
Sept 2021,225,222,374,136334247,1080340211,1216674458,123,361,3,944005964,In > Out
Sept 2021,225,23,288,25882260,37762447,63644707,18,276,1,11880187,In > Out
Sept 2021,225,232,81,1443497,35430636,36874133,4,81,2,33987139,In > Out
Sept 2021,225,8,2974,2078708631,14967086172,17045794803,676,2752,12,12888377541,In > Out
Sept 2021,225,85,29,7319798,566473529,573793327,7,29,2,559153731,In > Out
Sept 2021,226,110,787,285460991,4910931812,5196392803,60,779,2,4625470821,In > Out
Sept 2021,226,73,469,150562765,1338970583,1489533348,66,466,2,1188407818,In > Out
Sept 2021,226,78,685,293049461,4334704665,4627754126,96,677,2,4041655204,In > Out
Sept 2021,226,94,384,17586116,1570882069,1588468185,30,381,2,1553295953,In > Out
Sept 2021,228,100,869,104478780,4876420432,4980899212,226,858,5,4771941652,In > Out
Sept 2021,228,103,281,64759295,1667352077,1732111372,116,281,3,1602592782,In > Out
Sept 2021,228,104,707,72310322,1453219145,1525529467,233,699,4,1380908823,In > Out
Sept 2021,228,105,645,1007450966,3257506298,4264957264,236,634,9,2250055332,In > Out
Sept 2021,228,107,2037,829694268,7601030955,8430725223,503,1936,6,6771336687,In > Out
Sept 2021,228,11,393,106332365,588704575,695036940,152,388,5,482372210,In > Out
Sept 2021,228,110,424,140392471,1584759865,1725152336,211,420,9,1444367394,In > Out
Sept 2021,228,113,725,488258436,2559870951,3048129387,258,716,6,2071612515,In > Out
Sept 2021,228,114,1070,401325366,2034644911,2435970277,423,1024,5,1633319545,In > Out
Sept 2021,228,116,956,298931411,5848007198,6146938609,302,925,8,5549075787,In > Out
Sept 2021,228,117,765,233922180,1475374967,1709297147,247,736,7,1241452787,In > Out
Sept 2021,228,119,577,231329022,2788933874,3020262896,255,569,8,2557604852,In > Out
Sept 2021,228,12,593,1017621766,12633256424,13650878190,229,586,5,11615634658,In > Out
Sept 2021,228,123,1532,912959774,7768164170,8681123944,516,1484,13,6855204396,In > Out
Sept 2021,228,124,399,101827645,824241469,926069114,189,398,4,722413824,In > Out
Sept 2021,228,127,562,208822946,4205801263,4414624209,214,559,6,3996978317,In > Out
Sept 2021,228,128,314,214501944,3389457418,3603959362,155,310,6,3174955474,In > Out
Sept 2021,228,131,1017,504670554,27183075744,27687746298,223,1002,4,26678405190,In > Out
Sept 2021,228,132,1206,535778315,6681346154,7217124469,302,1129,12,6145567839,In > Out
Sept 2021,228,134,788,5822005290,4415292930,10237298220,180,764,12,1406712360,Out > In
Sept 2021,228,135,170,83992629,2501844728,2585837357,80,170,3,2417852099,In > Out
Sept 2021,228,138,769,69028652,1663343174,1732371826,200,759,5,1594314522,In > Out
Sept 2021,228,14,2173,269434690,17509689775,17779124465,664,2093,12,17240255085,In > Out
Sept 2021,228,140,166,171846863,364608516,536455379,60,166,4,192761653,In > Out
Sept 2021,228,142,948,87202760,2769232491,2856435251,265,920,11,2682029731,In > Out
Sept 2021,228,145,445,198601287,8388410556,8587011843,113,423,7,8189809269,In > Out
Sept 2021,228,146,1079,1848816850,8042539787,9891356637,354,1050,21,6193722937,In > Out
Sept 2021,228,149,925,409514742,3985174068,4394688810,223,907,4,3575659326,In > Out
Sept 2021,228,15,640,97513041,1766843336,1864356377,225,626,7,1669330295,In > Out
Sept 2021,228,150,261,52048992,404200185,456249177,90,257,3,352151193,In > Out
Sept 2021,228,151,1805,584440714,25927947329,26512388043,391,1735,4,25343506615,In > Out
Sept 2021,228,152,736,146933459,5950598575,6097532034,201,724,7,5803665116,In > Out
Sept 2021,228,153,550,81987722,1524179526,1606167248,239,547,7,1442191804,In > Out
Sept 2021,228,154,1138,561647499,5114109551,5675757050,226,1118,3,4552462052,In > Out
Sept 2021,228,155,148,72911898,121184290,194096188,67,148,3,48272392,In > Out
Sept 2021,228,159,2487,572393537,13579947468,14152341005,455,2351,6,13007553931,In > Out
Sept 2021,228,16,469,125427715,1072857002,1198284717,179,462,15,947429287,In > Out
Sept 2021,228,160,1448,2119404537,8451331133,10570735670,343,1410,6,6331926596,In > Out
Sept 2021,228,161,476,213511989,3865741661,4079253650,212,467,5,3652229672,In > Out
Sept 2021,228,164,5053,459083075,9488597668,9947680743,367,4818,6,9029514593,In > Out
Sept 2021,228,165,608,163076724,2473974755,2637051479,247,606,11,2310898031,In > Out
Sept 2021,228,168,584,123047712,795786489,918834201,160,583,5,672738777,In > Out
Sept 2021,228,169,1093,207264637,3973158506,4180423143,308,1060,9,3765893869,In > Out
Sept 2021,228,171,561,90469073,3003847403,3094316476,144,555,4,2913378330,In > Out
Sept 2021,228,175,739,88286382,3398740283,3487026665,247,720,5,3310453901,In > Out
Sept 2021,228,178,494,199556588,4170938578,4370495166,131,492,5,3971381990,In > Out
Sept 2021,228,18,367,85945292,2001567911,2087513203,137,364,4,1915622619,In > Out
Sept 2021,228,180,771,292510046,3961777217,4254287263,217,756,12,3669267171,In > Out
Sept 2021,228,181,1413,151686851,3061660292,3213347143,388,1399,8,2909973441,In > Out
Sept 2021,228,183,654,159891977,3122847793,3282739770,234,639,3,2962955816,In > Out
Sept 2021,228,184,1237,1386413055,2015972206,3402385261,288,1190,12,629559151,In > Out
Sept 2021,228,187,914,130286546,1214321294,1344607840,183,899,13,1084034748,In > Out
Sept 2021,228,191,657,397779285,4779919749,5177699034,257,636,7,4382140464,In > Out
Sept 2021,228,193,676,348006592,1340042566,1688049158,278,666,5,992035974,In > Out
Sept 2021,228,194,233,9203687760,9690686770,18894374530,80,231,7,486999010,In > Out
Sept 2021,228,195,1275,470858150,16913490582,17384348732,424,1247,8,16442632432,In > Out
Sept 2021,228,196,465,63593147,1558136786,1621729933,150,464,4,1494543639,In > Out
Sept 2021,228,198,373,168953721,3128700240,3297653961,98,363,6,2959746519,In > Out
Sept 2021,228,199,1357,942681587,4571511854,5514193441,370,1327,14,3628830267,In > Out
Sept 2021,228,200,530,69635819,1102965681,1172601500,171,525,7,1033329862,In > Out
Sept 2021,228,201,940,741882656,4648014755,5389897411,285,914,14,3906132099,In > Out
Sept 2021,228,202,1341,152613414,4749746847,4902360261,339,1311,4,4597133433,In > Out
Sept 2021,228,203,252,40128184,1089172366,1129300550,83,247,2,1049044182,In > Out
Sept 2021,228,204,1263,784307315,30367018631,31151325946,298,1243,7,29582711316,In > Out
Sept 2021,228,206,1189,149498665,4844927094,4994425759,439,1157,3,4695428429,In > Out
Sept 2021,228,208,1727,1650817151,22343797348,23994614499,393,1633,9,20692980197,In > Out
Sept 2021,228,209,955,316625321,4057411504,4374036825,147,944,10,3740786183,In > Out
Sept 2021,228,21,370,526666563,2585332333,3111998896,182,370,5,2058665770,In > Out
Sept 2021,228,210,720,261898216,18849795986,19111694202,199,703,4,18587897770,In > Out
Sept 2021,228,211,1148,134355534,9844670052,9979025586,180,1051,4,9710314518,In > Out
Sept 2021,228,212,1384,2017568958,129523436142,131541005100,229,1348,5,127505867184,In > Out
Sept 2021,228,214,328,199404832,2009890086,2209294918,110,312,8,1810485254,In > Out
Sept 2021,228,215,607,86656162,4986813294,5073469456,136,593,4,4900157132,In > Out
Sept 2021,228,216,646,1229452796,2238103094,3467555890,238,634,16,1008650298,In > Out
Sept 2021,228,217,558,78048076,1918101693,1996149769,187,545,1,1840053617,In > Out
Sept 2021,228,218,301,564246375,2279477536,2843723911,113,300,4,1715231161,In > Out
Sept 2021,228,221,1102,163293809,7881390990,8044684799,265,1073,6,7718097181,In > Out
Sept 2021,228,23,2809,1144823789,12374110379,13518934168,772,2543,116,11229286590,In > Out
Sept 2021,228,24,277,27307893,719321383,746629276,135,276,5,692013490,In > Out
Sept 2021,228,27,800,65654916,1672000127,1737655043,228,790,4,1606345211,In > Out
Sept 2021,228,30,1078,274481450,3630270546,3904751996,223,1060,8,3355789096,In > Out
Sept 2021,228,31,288,44609220,269706795,314316015,142,287,4,225097575,In > Out
Sept 2021,228,32,700,304517486,1218963782,1523481268,288,682,21,914446296,In > Out
Sept 2021,228,33,92,48807294,167533838,216341132,50,92,3,118726544,In > Out
Sept 2021,228,35,1980,811143187,8948248282,9759391469,332,1924,9,8137105095,In > Out
Sept 2021,228,36,261,46198189,967639511,1013837700,109,255,3,921441322,In > Out
Sept 2021,228,37,243,30173195,895034587,925207782,103,242,3,864861392,In > Out
Sept 2021,228,39,1077,295876032,3288066583,3583942615,439,1063,17,2992190551,In > Out
Sept 2021,228,4,852,754934114,2541147709,3296081823,229,838,7,1786213595,In > Out
Sept 2021,228,41,560,505388645,5193450960,5698839605,227,551,7,4688062315,In > Out
Sept 2021,228,42,533,70769103,1134686141,1205455244,214,519,5,1063917038,In > Out
Sept 2021,228,43,1082,165684670,6303904404,6469589074,307,1046,4,6138219734,In > Out
Sept 2021,228,44,1063,862697137,10472395997,11335093134,242,1059,6,9609698860,In > Out
Sept 2021,228,45,2024,461829667,52207699410,52669529077,484,1896,6,51745869743,In > Out
Sept 2021,228,47,367,53764307,955032687,1008796994,180,363,4,901268380,In > Out
Sept 2021,228,48,689,230807943,16804369587,17035177530,206,681,5,16573561644,In > Out
Sept 2021,228,5,299,46934162,1755946130,1802880292,132,298,4,1709011968,In > Out
Sept 2021,228,51,579,105576272,4502521433,4608097705,167,579,6,4396945161,In > Out
Sept 2021,228,52,729,201523521,6428128887,6629652408,278,704,4,6226605366,In > Out
Sept 2021,228,53,504,51091852,1432054310,1483146162,158,494,2,1380962458,In > Out
Sept 2021,228,55,4,369284,887069,1256353,3,4,1,517785,In > Out
Sept 2021,228,57,1726,1170193836,5215243681,6385437517,326,1648,7,4045049845,In > Out
Sept 2021,228,61,187,271521630,857238601,1128760231,83,187,3,585716971,In > Out
Sept 2021,228,62,195,140638655,478791337,619429992,97,194,8,338152682,In > Out
Sept 2021,228,63,1621,243183477,2447747680,2690931157,321,1575,7,2204564203,In > Out
Sept 2021,228,65,1791,1217289435,18340099374,19557388809,381,1721,8,17122809939,In > Out
Sept 2021,228,67,326,129979056,492134739,622113795,136,324,5,362155683,In > Out
Sept 2021,228,68,351,130539762,1131835518,1262375280,126,347,4,1001295756,In > Out
Sept 2021,228,70,778,261260049,2811152809,3072412858,327,769,7,2549892760,In > Out
Sept 2021,228,71,736,179485268,3053367070,3232852338,289,727,5,2873881802,In > Out
Sept 2021,228,72,251,213627732,689220608,902848340,88,251,3,475592876,In > Out
Sept 2021,228,74,1326,446541961,5095449744,5541991705,371,1296,6,4648907783,In > Out
Sept 2021,228,79,892,199845742,7783770098,7983615840,305,866,11,7583924356,In > Out
Sept 2021,228,8,251,186756096,2993315885,3180071981,98,245,2,2806559789,In > Out
Sept 2021,228,81,409,78546188,2275921890,2354468078,144,405,5,2197375702,In > Out
Sept 2021,228,82,374,54056856,839269002,893325858,143,372,4,785212146,In > Out
Sept 2021,228,85,2224,603417828,28571035699,29174453527,430,2163,7,27967617871,In > Out
Sept 2021,228,9,1226,191470848,4494963316,4686434164,378,1205,6,4303492468,In > Out
Sept 2021,228,92,495,217899325,2421262737,2639162062,206,470,6,2203363412,In > Out
Sept 2021,228,95,577,64401944,1531836752,1596238696,272,565,19,1467434808,In > Out
Sept 2021,228,97,618,88392889,2292296112,2380689001,192,614,1,2203903223,In > Out
Sept 2021,228,98,1833,590638720,10835675583,11426314303,429,1716,8,10245036863,In > Out
Sept 2021,229,103,1184,691560534,5832156596,6523717130,375,1161,5,5140596062,In > Out
Sept 2021,229,104,703,4399353539,6806262087,11205615626,206,686,20,2406908548,In > Out
Sept 2021,229,107,545,293001879,4302480342,4595482221,161,538,13,4009478463,In > Out
Sept 2021,229,108,1625,314943590,10386122680,10701066270,469,1557,5,10071179090,In > Out
Sept 2021,229,11,1249,844186404,4652289520,5496475924,314,1208,22,3808103116,In > Out
Sept 2021,229,110,787,316633987,2101624716,2418258703,194,773,8,1784990729,In > Out
Sept 2021,229,111,1090,172079577,12563499936,12735579513,301,1036,6,12391420359,In > Out
Sept 2021,229,115,165,59112592,227083345,286195937,93,165,5,167970753,In > Out
Sept 2021,229,118,1159,440692226,2776658528,3217350754,426,1142,10,2335966302,In > Out
Sept 2021,229,119,509,304916158,975123501,1280039659,204,505,11,670207343,In > Out
Sept 2021,229,120,917,191636084,2419306397,2610942481,206,912,10,2227670313,In > Out
Sept 2021,229,122,613,482004379,2137428252,2619432631,230,613,4,1655423873,In > Out
Sept 2021,229,123,634,59507338,1901616946,1961124284,253,629,7,1842109608,In > Out
Sept 2021,229,124,231,30753131,684468874,715222005,93,229,2,653715743,In > Out
Sept 2021,229,125,186,391107264,1880748007,2271855271,98,184,3,1489640743,In > Out
Sept 2021,229,126,605,418115998,1766070365,2184186363,244,593,5,1347954367,In > Out
Sept 2021,229,127,982,388749590,5150865071,5539614661,199,952,6,4762115481,In > Out
Sept 2021,229,128,647,521333836,9569591278,10090925114,189,642,4,9048257442,In > Out
Sept 2021,229,129,882,204887023,3837979745,4042866768,355,864,5,3633092722,In > Out
Sept 2021,229,130,1949,351565963,4646112286,4997678249,445,1863,5,4294546323,In > Out
Sept 2021,229,132,800,133091332,3428410981,3561502313,261,780,9,3295319649,In > Out
Sept 2021,229,133,744,279447538,6191849513,6471297051,293,732,5,5912401975,In > Out
Sept 2021,229,134,1604,518077311,7940141670,8458218981,360,1556,13,7422064359,In > Out
Sept 2021,229,135,448,68133992,1133363324,1201497316,194,440,8,1065229332,In > Out
Sept 2021,229,137,629,80168874,5778653273,5858822147,148,617,6,5698484399,In > Out
Sept 2021,229,138,225,30638852,1159661814,1190300666,83,221,4,1129022962,In > Out
Sept 2021,229,139,298,1492093094,2539990046,4032083140,100,295,5,1047896952,In > Out
Sept 2021,229,14,63,12060985,112731895,124792880,51,63,3,100670910,In > Out
Sept 2021,229,142,1224,353170331,8163103894,8516274225,333,1210,6,7809933563,In > Out
Sept 2021,229,143,757,518929651,3132406006,3651335657,232,729,9,2613476355,In > Out
Sept 2021,229,144,659,1194916237,3415668616,4610584853,272,658,11,2220752379,In > Out
Sept 2021,229,145,888,220484281,4902221616,5122705897,306,874,14,4681737335,In > Out
Sept 2021,229,146,516,648175287,9708218352,10356393639,182,512,5,9060043065,In > Out
Sept 2021,229,148,572,262788946,9674211330,9937000276,194,549,5,9411422384,In > Out
Sept 2021,229,149,318,42014885,1153165403,1195180288,166,316,5,1111150518,In > Out
Sept 2021,229,15,1571,208238991,13664360234,13872599225,359,1523,8,13456121243,In > Out
Sept 2021,229,150,1976,603468386,9191586634,9795055020,492,1921,7,8588118248,In > Out
Sept 2021,229,151,462,66105715,1646016511,1712122226,189,457,5,1579910796,In > Out
Sept 2021,229,153,427,55767203,1060838941,1116606144,157,419,5,1005071738,In > Out
Sept 2021,229,154,807,686234373,3461767230,4148001603,271,789,6,2775532857,In > Out
Sept 2021,229,155,658,147320068,3509326853,3656646921,254,650,8,3362006785,In > Out
Sept 2021,229,156,441,181037105,1763404265,1944441370,128,439,7,1582367160,In > Out
Sept 2021,229,158,374,39820541,708345092,748165633,121,372,7,668524551,In > Out
Sept 2021,229,159,1010,198688400,7734464172,7933152572,282,999,8,7535775772,In > Out
Sept 2021,229,160,235,100856056,964258758,1065114814,90,232,5,863402702,In > Out
Sept 2021,229,168,1176,470561681,3711204432,4181766113,379,1155,7,3240642751,In > Out
Sept 2021,229,170,804,912014829,15885126754,16797141583,285,792,5,14973111925,In > Out
Sept 2021,229,171,642,130405344,1328880728,1459286072,170,639,6,1198475384,In > Out
Sept 2021,229,174,658,111708546,2539843540,2651552086,215,642,3,2428134994,In > Out
Sept 2021,229,175,823,152679031,3586625960,3739304991,283,816,9,3433946929,In > Out
Sept 2021,229,177,556,268307288,6186453082,6454760370,161,543,5,5918145794,In > Out
Sept 2021,229,178,1628,4770584705,12788199216,17558783921,436,1553,8,8017614511,In > Out
Sept 2021,229,18,2161,535160502,11489777549,12024938051,524,2096,5,10954617047,In > Out
Sept 2021,229,180,1267,279572858,10124037652,10403610510,437,1204,8,9844464794,In > Out
Sept 2021,229,181,711,180884627,5283453604,5464338231,228,691,5,5102568977,In > Out
Sept 2021,229,182,1094,5582018772,17738215718,23320234490,348,1054,10,12156196946,In > Out
Sept 2021,229,184,438,204429136,780390817,984819953,187,437,4,575961681,In > Out
Sept 2021,229,186,451,898070578,3139716972,4037787550,107,449,6,2241646394,In > Out
Sept 2021,229,189,98,15148795,582825543,597974338,53,98,3,567676748,In > Out
Sept 2021,229,190,1144,544586078,9436120287,9980706365,299,1103,10,8891534209,In > Out
Sept 2021,229,191,492,354650639,7787503443,8142154082,125,489,191,7432852804,In > Out
Sept 2021,229,192,633,161319840,4348798150,4510117990,185,628,5,4187478310,In > Out
Sept 2021,229,193,937,276901444,1469342381,1746243825,244,928,5,1192440937,In > Out
Sept 2021,229,194,614,186891289,2426084934,2612976223,255,611,5,2239193645,In > Out
Sept 2021,229,195,458,261115712,3092059396,3353175108,199,457,3,2830943684,In > Out
Sept 2021,229,199,218,255300944,779660563,1034961507,72,218,1,524359619,In > Out
Sept 2021,229,20,1139,171692405,4490044089,4661736494,437,1114,11,4318351684,In > Out
Sept 2021,229,200,582,225853498,2323838663,2549692161,223,577,8,2097985165,In > Out
Sept 2021,229,203,699,100625067,2441930977,2542556044,239,696,3,2341305910,In > Out
Sept 2021,229,208,419,492409145,3908550960,4400960105,214,412,8,3416141815,In > Out
Sept 2021,229,210,1022,168345716,5329880633,5498226349,296,1010,6,5161534917,In > Out
Sept 2021,229,211,319,154891020,489128125,644019145,130,319,4,334237105,In > Out
Sept 2021,229,212,853,284888578,9363301113,9648189691,240,845,5,9078412535,In > Out
Sept 2021,229,213,1303,811565959,4374371813,5185937772,448,1255,26,3562805854,In > Out
Sept 2021,229,214,2107,777393803,11652855312,12430249115,404,1980,12,10875461509,In > Out
Sept 2021,229,215,589,71713316,2561148876,2632862192,177,577,6,2489435560,In > Out
Sept 2021,229,216,732,349542085,4233458681,4583000766,223,711,9,3883916596,In > Out
Sept 2021,229,217,231,246362095,920308273,1166670368,78,229,5,673946178,In > Out
Sept 2021,229,218,366,239024256,3735104966,3974129222,118,365,4,3496080710,In > Out
Sept 2021,229,219,1113,400147781,6905585604,7305733385,250,1097,10,6505437823,In > Out
Sept 2021,229,222,1185,331030951,8952249041,9283279992,339,1154,4,8621218090,In > Out
Sept 2021,229,223,764,264224022,6145981230,6410205252,263,761,9,5881757208,In > Out
Sept 2021,229,23,369,65108322,944340450,1009448772,175,368,6,879232128,In > Out
Sept 2021,229,26,993,157195791,14667611996,14824807787,164,972,9,14510416205,In > Out
Sept 2021,229,27,474,367799584,1516787397,1884586981,198,469,6,1148987813,In > Out
Sept 2021,229,30,440,69266341,1513115138,1582381479,158,439,3,1443848797,In > Out
Sept 2021,229,32,723,444538364,2202632663,2647171027,242,712,11,1758094299,In > Out
Sept 2021,229,38,557,159287884,7142116040,7301403924,229,544,8,6982828156,In > Out
Sept 2021,229,4,168,12045324,625734622,637779946,34,168,1,613689298,In > Out
Sept 2021,229,43,570,46299051,1874709796,1921008847,105,566,3,1828410745,In > Out
Sept 2021,229,44,346,1793507388,4524793195,6318300583,102,337,10,2731285807,In > Out
Sept 2021,229,45,1632,1452783950,9274597372,10727381322,321,1558,8,7821813422,In > Out
Sept 2021,229,46,365,92265125,2418715356,2510980481,122,363,6,2326450231,In > Out
Sept 2021,229,5,267,1850518283,6690804695,8541322978,75,262,5,4840286412,In > Out
Sept 2021,229,52,455,47750748,1922429005,1970179753,151,451,3,1874678257,In > Out
Sept 2021,229,53,878,290067361,14909537665,15199605026,255,835,19,14619470304,In > Out
Sept 2021,229,54,610,71261606,1876836539,1948098145,204,604,3,1805574933,In > Out
Sept 2021,229,55,1066,601465502,4961129200,5562594702,286,1039,4,4359663698,In > Out
Sept 2021,229,58,1056,265511077,5421206235,5686717312,202,1044,6,5155695158,In > Out
Sept 2021,229,59,856,731194941,5959964757,6691159698,244,852,5,5228769816,In > Out
Sept 2021,229,6,778,14693620347,1694990732,16388611079,228,766,7,12998629615,Out > In
Sept 2021,229,63,250,779142905,418063259,1197206164,131,250,3,361079646,Out > In
Sept 2021,229,64,485,103500722,2994477551,3097978273,127,466,6,2890976829,In > Out
Sept 2021,229,66,942,445443631,3232959407,3678403038,257,923,8,2787515776,In > Out
Sept 2021,229,67,2882,755837930,21958540935,22714378865,657,2695,12,21202703005,In > Out
Sept 2021,229,69,487,297373285,2805081344,3102454629,105,486,6,2507708059,In > Out
Sept 2021,229,70,1427,1074054458,37266191602,38340246060,266,1338,6,36192137144,In > Out
Sept 2021,229,71,431,266167662,969164702,1235332364,145,429,4,702997040,In > Out
Sept 2021,229,72,318,473283835,574578547,1047862382,129,318,3,101294712,In > Out
Sept 2021,229,73,563,122078770,2798761382,2920840152,195,556,7,2676682612,In > Out
Sept 2021,229,74,279,155358196,3381410230,3536768426,139,277,3,3226052034,In > Out
Sept 2021,229,76,69,5191285,214129834,219321119,44,68,1,208938549,In > Out
Sept 2021,229,77,910,107183096,3905769194,4012952290,193,906,6,3798586098,In > Out
Sept 2021,229,78,418,92516901,2648533556,2741050457,149,413,6,2556016655,In > Out
Sept 2021,229,79,842,688690273,6088433994,6777124267,326,831,9,5399743721,In > Out
Sept 2021,229,8,700,179598217,7331347336,7510945553,201,688,5,7151749119,In > Out
Sept 2021,229,80,597,1601170769,6692304631,8293475400,221,593,8,5091133862,In > Out
Sept 2021,229,81,851,3522190076,5646709056,9168899132,166,834,18,2124518980,In > Out
Sept 2021,229,83,176,12914590,362432448,375347038,108,175,4,349517858,In > Out
Sept 2021,229,89,634,188808337,2585912283,2774720620,182,627,6,2397103946,In > Out
Sept 2021,229,90,634,88315968,2286075158,2374391126,171,617,5,2197759190,In > Out
Sept 2021,229,92,1673,673440635,4813532692,5486973327,338,1595,10,4140092057,In > Out
Sept 2021,229,93,945,203691174,3692238190,3895929364,229,925,5,3488547016,In > Out
Sept 2021,229,94,849,172333171,4712113514,4884446685,257,838,7,4539780343,In > Out
Sept 2021,229,96,513,85708955,6602602937,6688311892,72,510,1,6516893982,In > Out
Sept 2021,229,99,1098,340538352,3197054800,3537593152,214,1056,5,2856516448,In > Out
Sept 2021,23,4,108,7505489,275590621,283096110,4,108,1,268085132,In > Out
Sept 2021,232,239,964,212236683,7816773031,8029009714,183,890,15,7604536348,In > Out
Sept 2021,234,114,342,19518927,263332189,282851116,131,339,2,243813262,In > Out
Sept 2021,234,120,303,43663184,229225333,272888517,98,298,2,185562149,In > Out
Sept 2021,234,126,372,26742892,729617997,756360889,174,369,4,702875105,In > Out
Sept 2021,234,129,1545,3056462465,3987321949,7043784414,242,1474,6,930859484,In > Out
Sept 2021,234,130,523,89413219,1382187097,1471600316,63,518,3,1292773878,In > Out
Sept 2021,234,132,6,308444,2128272,2436716,4,6,2,1819828,In > Out
Sept 2021,234,139,11,604285,10953768,11558053,8,11,2,10349483,In > Out
Sept 2021,234,144,82,20120791,649801865,669922656,33,82,2,629681074,In > Out
Sept 2021,234,151,1129,12879095630,1068861554,13947957184,36,1086,2,11810234076,Out > In
Sept 2021,234,154,555,126843515,1193403749,1320247264,81,548,3,1066560234,In > Out
Sept 2021,234,198,1704,637613886,9546623501,10184237387,75,1641,2,8909009615,In > Out
Sept 2021,234,228,166,119344374,4786005464,4905349838,21,166,2,4666661090,In > Out
Sept 2021,234,233,896,291614778,2549456436,2841071214,119,881,3,2257841658,In > Out
Sept 2021,234,29,307,28990847,3435177995,3464168842,58,307,3,3406187148,In > Out
Sept 2021,234,40,4219,680528754,2050448452,2730977206,288,3723,2,1369919698,In > Out
Sept 2021,234,52,95,6584092,28565919,35150011,18,95,2,21981827,In > Out
Sept 2021,234,65,540,176510634,1261111361,1437621995,238,494,3,1084600727,In > Out
Sept 2021,234,66,170,161478263,8018048763,8179527026,35,168,3,7856570500,In > Out
Sept 2021,234,84,2279,365125334,1708605088,2073730422,50,2129,2,1343479754,In > Out
Sept 2021,234,89,344,42110672,897170340,939281012,135,342,3,855059668,In > Out
Sept 2021,235,212,252,1483942,109666449,111150391,4,247,1,108182507,In > Out
Sept 2021,235,223,508473,4424459381,212960124622,217384584003,526,28230,2,208535665241,In > Out
Sept 2021,236,253,28643,34579901309,62658107335,97238008644,2889,15978,28,28078206026,In > Out
Sept 2021,239,161,27,3932305,113487207,117419512,19,27,2,109554902,In > Out
Sept 2021,239,162,173,23996524,743308880,767305404,29,172,2,719312356,In > Out
Sept 2021,239,164,328,32613154,782029275,814642429,105,326,2,749416121,In > Out
Sept 2021,239,165,193,20566051,548492182,569058233,58,181,2,527926131,In > Out
Sept 2021,239,166,170,22123534,685645709,707769243,29,169,2,663522175,In > Out
Sept 2021,239,172,170,31371247,581146195,612517442,28,170,2,549774948,In > Out
Sept 2021,239,173,182,26498528,717571115,744069643,31,182,2,691072587,In > Out
Sept 2021,239,175,172,23384086,687509135,710893221,30,172,2,664125049,In > Out
Sept 2021,239,184,155,13564983,203409452,216974435,70,153,2,189844469,In > Out
Sept 2021,239,185,32,2087851,20557819,22645670,22,32,2,18469968,In > Out
Sept 2021,239,186,164,35198964,1273332996,1308531960,29,163,2,1238134032,In > Out
Sept 2021,239,187,200,40743974,675509060,716253034,37,198,2,634765086,In > Out
Sept 2021,239,188,159,28413584,604728827,633142411,35,159,2,576315243,In > Out
Sept 2021,239,192,428,25446438,989386249,1014832687,32,427,2,963939811,In > Out
Sept 2021,239,194,135,20047100,774621457,794668557,33,133,2,754574357,In > Out
Sept 2021,239,197,495,109826647,5902326023,6012152670,66,465,2,5792499376,In > Out
Sept 2021,239,198,109,14959640,307451237,322410877,22,108,2,292491597,In > Out
Sept 2021,239,199,198,34218733,1461241275,1495460008,46,194,2,1427022542,In > Out
Sept 2021,239,200,167,19030658,452122554,471153212,32,166,2,433091896,In > Out
Sept 2021,239,203,151,14613523,216301661,230915184,19,150,2,201688138,In > Out
Sept 2021,239,205,49,4250137,154251318,158501455,23,49,2,150001181,In > Out
Sept 2021,239,206,27,3061055,22226419,25287474,20,27,2,19165364,In > Out
Sept 2021,239,217,81,5631538,126214721,131846259,20,79,2,120583183,In > Out
Sept 2021,239,220,48,1651480,27745333,29396813,22,48,2,26093853,In > Out
Sept 2021,239,63,1,124782,8990,133772,1,1,1,115792,Out > In
Sept 2021,241,136,31,2207969,495532279,497740248,3,31,2,493324310,In > Out
Sept 2021,241,181,42,3185183,655902458,659087641,4,42,2,652717275,In > Out
Sept 2021,241,182,291,25564539,563858177,589422716,45,288,2,538293638,In > Out
Sept 2021,241,196,1535,18323009,628388948,646711957,18,1491,2,610065939,In > Out
Sept 2021,241,199,32,1766628,270036103,271802731,5,32,2,268269475,In > Out
Sept 2021,241,220,176,15035486,511269814,526305300,57,176,2,496234328,In > Out
Sept 2021,241,223,68,2849432,163085581,165935013,8,68,2,160236149,In > Out
Sept 2021,241,233,688,68518217,766617361,835135578,284,673,3,698099144,In > Out
Sept 2021,241,234,182,8865306,193992316,202857622,97,182,3,185127010,In > Out
Sept 2021,241,6,14,733343,57110906,57844249,2,14,1,56377563,In > Out
Sept 2021,242,104,5,2508287,3210007,5718294,5,5,3,701720,In > Out
Sept 2021,242,140,394,127185833,594814196,722000029,40,392,2,467628363,In > Out
Sept 2021,242,41,160,1271897995,604252762,1876150757,6,160,8,667645233,Out > In
Sept 2021,242,44,1196,35178442,1004629183,1039807625,411,1170,3,969450741,In > Out
Sept 2021,242,45,18,283930317,700985106,984915423,5,18,16,417054789,In > Out
Sept 2021,246,103,147,7283182,167059141,174342323,42,147,2,159775959,In > Out
Sept 2021,246,109,798,63590061,759422254,823012315,57,787,2,695832193,In > Out
Sept 2021,246,125,318,70704271,873955188,944659459,42,314,2,803250917,In > Out
Sept 2021,246,128,192,17923152,432706110,450629262,36,192,2,414782958,In > Out
Sept 2021,246,129,358,111521639,822811243,934332882,65,351,2,711289604,In > Out
Sept 2021,246,134,192,17699463,460334911,478034374,30,190,2,442635448,In > Out
Sept 2021,246,137,323,40359177,842445700,882804877,68,318,2,802086523,In > Out
Sept 2021,246,143,305,24376999,424591283,448968282,71,299,2,400214284,In > Out
Sept 2021,246,144,139,22970154,763144979,786115133,44,139,3,740174825,In > Out
Sept 2021,246,170,440,24312326,436185235,460497561,160,437,2,411872909,In > Out
Sept 2021,246,171,207,19380641,459449799,478830440,38,200,2,440069158,In > Out
Sept 2021,246,172,259,30702657,693274332,723976989,29,251,2,662571675,In > Out
Sept 2021,246,181,394,79597488,983981108,1063578596,39,390,2,904383620,In > Out
Sept 2021,246,187,250,23185299,744579139,767764438,40,249,2,721393840,In > Out
Sept 2021,246,192,191,515832260,462404730,978236990,37,189,2,53427530,Out > In
Sept 2021,246,193,241,38576266,706513939,745090205,59,229,3,667937673,In > Out
Sept 2021,246,194,198,16336896,388819495,405156391,27,196,2,372482599,In > Out
Sept 2021,246,197,616,81015423,748688315,829703738,113,603,2,667672892,In > Out
Sept 2021,246,199,295,49577822,810522687,860100509,62,289,2,760944865,In > Out
Sept 2021,246,20,67,2941335,78439375,81380710,18,67,2,75498040,In > Out
Sept 2021,246,203,380,67351970,583680766,651032736,50,364,2,516328796,In > Out
Sept 2021,246,204,236,22381455,378804082,401185537,29,233,2,356422627,In > Out
Sept 2021,246,214,317,31614549,764111728,795726277,51,314,2,732497179,In > Out
Sept 2021,246,220,301,30368896,757860110,788229006,76,295,3,727491214,In > Out
Sept 2021,246,227,181,18091313,437828023,455919336,27,178,2,419736710,In > Out
Sept 2021,246,230,1,9616,2162750,2172366,1,1,1,2153134,In > Out
Sept 2021,246,232,281,73718717,569094126,642812843,66,270,2,495375409,In > Out
Sept 2021,246,235,7,101326,16201767,16303093,4,7,2,16100441,In > Out
Sept 2021,246,242,651,26278361,652625458,678903819,118,651,2,626347097,In > Out
Sept 2021,246,244,654,181767168,10363289579,10545056747,97,642,2,10181522411,In > Out
Sept 2021,246,41,321,30286264,785999700,816285964,70,314,2,755713436,In > Out
Sept 2021,246,42,382,36756848,878063370,914820218,90,374,2,841306522,In > Out
Sept 2021,246,43,310,70781902,833228817,904010719,45,301,2,762446915,In > Out
Sept 2021,246,44,273,31301566,747426474,778728040,55,269,2,716124908,In > Out
Sept 2021,246,45,233,23771747,503436768,527208515,36,231,2,479665021,In > Out
Sept 2021,246,46,259,28844743,724138529,752983272,60,255,2,695293786,In > Out
Sept 2021,246,47,381,76036929,832357951,908394880,61,370,2,756321022,In > Out
Sept 2021,246,48,339,32426733,843218088,875644821,77,330,2,810791355,In > Out
Sept 2021,246,49,359,72467752,730038377,802506129,73,353,2,657570625,In > Out
Sept 2021,246,50,336,32951255,946991896,979943151,90,328,2,914040641,In > Out
Sept 2021,246,51,311,31707132,863538434,895245566,60,302,2,831831302,In > Out
Sept 2021,246,52,364,41070754,887478300,928549054,81,349,2,846407546,In > Out
Sept 2021,246,53,382,40551455,879425666,919977121,73,378,2,838874211,In > Out
Sept 2021,246,54,359,72748120,932289403,1005037523,82,351,2,859541283,In > Out
Sept 2021,246,55,428,68410066,819672467,888082533,97,419,2,751262401,In > Out
Sept 2021,246,56,305,29993911,822328125,852322036,63,292,2,792334214,In > Out
Sept 2021,246,57,378,35040948,918055588,953096536,85,369,2,883014640,In > Out
Sept 2021,246,58,303,31624403,815408645,847033048,62,297,2,783784242,In > Out
Sept 2021,246,59,379,34360304,889441595,923801899,104,367,2,855081291,In > Out
Sept 2021,246,60,393,77179925,822923711,900103636,96,386,2,745743786,In > Out
Sept 2021,246,61,637,134935094,2968942829,3103877923,94,626,2,2834007735,In > Out
Sept 2021,246,63,292,30437548,857571403,888008951,60,284,2,827133855,In > Out
Sept 2021,246,64,383,37196675,740056541,777253216,73,378,2,702859866,In > Out
Sept 2021,246,65,413,88726215,1159915843,1248642058,76,375,2,1071189628,In > Out
Sept 2021,246,66,864,114648865,2744585666,2859234531,99,840,2,2629936801,In > Out
Sept 2021,246,67,345,51758879,513297832,565056711,94,338,2,461538953,In > Out
Sept 2021,246,68,149,9359636,446077750,455437386,56,148,2,436718114,In > Out
Sept 2021,246,69,375,76084501,882299810,958384311,66,371,2,806215309,In > Out
Sept 2021,246,70,399,35127963,980811431,1015939394,97,394,2,945683468,In > Out
Sept 2021,246,71,370,32176743,941115405,973292148,105,367,2,908938662,In > Out
Sept 2021,246,72,378,29622286,938283210,967905496,118,375,2,908660924,In > Out
Sept 2021,246,73,414,76789581,896690360,973479941,81,411,2,819900779,In > Out
Sept 2021,246,74,312,35799094,1468135085,1503934179,76,309,2,1432335991,In > Out
Sept 2021,246,75,349,40293770,1309192356,1349486126,66,346,2,1268898586,In > Out
Sept 2021,246,76,206,16885598,704120364,721005962,63,199,2,687234766,In > Out
Sept 2021,246,77,218,16700506,764181305,780881811,74,215,2,747480799,In > Out
Sept 2021,246,78,418,45764464,904699521,950463985,88,399,2,858935057,In > Out
Sept 2021,246,79,392,41394605,941367974,982762579,96,389,2,899973369,In > Out
Sept 2021,246,80,342,17344645,820433404,837778049,85,338,2,803088759,In > Out
Sept 2021,246,81,375,38297586,1463926556,1502224142,97,371,2,1425628970,In > Out
Sept 2021,246,82,325,36230409,921465489,957695898,60,319,2,885235080,In > Out
Sept 2021,246,83,333,30374117,799569749,829943866,78,327,2,769195632,In > Out
Sept 2021,246,84,313,21377114,388749094,410126208,71,311,2,367371980,In > Out
Sept 2021,246,85,405,72905263,1078484448,1151389711,64,398,2,1005579185,In > Out
Sept 2021,246,86,346,19498803,783757977,803256780,89,339,2,764259174,In > Out
Sept 2021,246,87,405,66930695,608391770,675322465,89,398,2,541461075,In > Out
Sept 2021,248,108,432,73187725,772468084,845655809,59,431,2,699280359,In > Out
Sept 2021,248,47,239,101061930,447763547,548825477,47,232,3,346701617,In > Out
Sept 2021,250,204,10088,893925797,10235261778,11129187575,1042,7645,9,9341335981,In > Out
Sept 2021,250,3,14,2485013,1852778,4337791,1,1,1,632235,Out > In
Sept 2021,250,51,25,5351479,5155390,10506869,7,18,10,196089,Out > In
Sept 2021,250,56,2257,534908136,4996585510,5531493646,328,2213,5,4461677374,In > Out
Sept 2021,250,62,549,84944529,481123888,566068417,139,542,6,396179359,In > Out
Sept 2021,256,11,7,4002027,103731,4105758,5,1,7,3898296,Out > In
Sept 2021,256,12,13,31127009,764788,31891797,6,13,1,30362221,Out > In
Sept 2021,256,15,4,654330,413226,1067556,2,4,2,241104,Out > In
Sept 2021,256,248,238833,93067192281,1248764179523,1341831371804,14053,27058,510,1155696987242,In > Out
Sept 2021,256,249,246528,99155213779,1364515794651,1463671008430,14215,28134,695,1265360580872,In > Out
Sept 2021,256,250,358776,201732023986,1547769602535,1749501626521,14216,28231,860,1346037578549,In > Out
Sept 2021,256,251,264435,104179291849,1872606067533,1976785359382,14720,28969,949,1768426775684,In > Out
Sept 2021,256,252,251305,102950307963,1334286620170,1437236928133,13916,31041,593,1231336312207,In > Out
Sept 2021,256,253,292275,135408453586,1086363146124,1221771599710,14415,27771,444,950954692538,In > Out
Sept 2021,256,254,251559,85820512332,1135222302533,1221042814865,14952,28702,664,1049401790201,In > Out
Sept 2021,256,50,25,7368616,854005560,861374176,13,25,2,846636944,In > Out
Sept 2021,28,129,43,2386132,193669724,196055856,6,43,2,191283592,In > Out
Sept 2021,28,130,40,2440130,135302977,137743107,8,40,2,132862847,In > Out
Sept 2021,28,131,612,2014536,192990645,195005181,11,40,568,190976109,In > Out
Sept 2021,28,133,28,1572785,110649703,112222488,7,28,2,109076918,In > Out
Sept 2021,28,134,42,2273340,163811788,166085128,8,42,2,161538448,In > Out
Sept 2021,28,135,36,1926878,140502491,142429369,9,36,2,138575613,In > Out
Sept 2021,28,137,227,130480050,144126397,274606447,33,37,192,13646347,In > Out
Sept 2021,28,138,1388,642282843,222429730,864712573,37,1233,1277,419853113,Out > In
Sept 2021,28,139,282,165131930,119393019,284524949,28,39,242,45738911,Out > In
Sept 2021,28,141,35,1929960,113640784,115570744,7,35,2,111710824,In > Out
Sept 2021,28,142,35,1753135,130942192,132695327,10,35,2,129189057,In > Out
Sept 2021,28,143,44,2223172,160014773,162237945,11,44,3,157791601,In > Out
Sept 2021,28,144,54,2851667,199255463,202107130,12,53,2,196403796,In > Out
Sept 2021,28,145,42,2611581,148136848,150748429,11,42,2,145525267,In > Out
Sept 2021,28,146,46,1979001,173900760,175879761,11,45,2,171921759,In > Out
Sept 2021,28,147,32,2192849,125144689,127337538,6,32,3,122951840,In > Out
Sept 2021,28,148,2,55712,4690416,4746128,1,2,1,4634704,In > Out
Sept 2021,28,149,39,1776573,136870922,138647495,10,39,2,135094349,In > Out
Sept 2021,28,150,38,1823184,138162136,139985320,10,38,2,136338952,In > Out
Sept 2021,28,151,38,2288941,115471158,117760099,11,38,2,113182217,In > Out
Sept 2021,28,152,35,2719491,358693749,361413240,9,35,2,355974258,In > Out
Sept 2021,28,154,2,43090,4902573,4945663,2,2,1,4859483,In > Out
Sept 2021,28,155,2,56134,4854431,4910565,2,2,1,4798297,In > Out
Sept 2021,28,156,2,60302,4915846,4976148,2,2,1,4855544,In > Out
Sept 2021,28,157,2,42547,3110713,3153260,2,2,1,3068166,In > Out
Sept 2021,28,158,2,56642,4985131,5041773,2,2,1,4928489,In > Out
Sept 2021,28,159,10,123351,13045679,13169030,6,10,1,12922328,In > Out
Sept 2021,28,160,36,2500749,140304749,142805498,9,36,2,137804000,In > Out
Sept 2021,28,161,40,2033436,157145586,159179022,7,40,2,155112150,In > Out
Sept 2021,28,162,39,1824183,132437864,134262047,10,39,2,130613681,In > Out
Sept 2021,28,163,34,1891620,119770161,121661781,10,34,2,117878541,In > Out
Sept 2021,28,164,64,4109211,248054302,252163513,20,64,2,243945091,In > Out
Sept 2021,28,165,2,42756,4875395,4918151,2,2,1,4832639,In > Out
Sept 2021,28,166,2,37358,3880452,3917810,2,2,1,3843094,In > Out
Sept 2021,28,167,45,201037,11142596,11343633,5,5,42,10941559,In > Out
Sept 2021,28,168,12,1169164,271631382,272800546,4,12,2,270462218,In > Out
Sept 2021,28,169,40,2415983,149234713,151650696,8,40,2,146818730,In > Out
Sept 2021,28,170,12,1048806,150665065,151713871,4,12,2,149616259,In > Out
Sept 2021,28,171,8381,42326725,2190860485,2233187210,30,6513,2,2148533760,In > Out
Sept 2021,28,172,33,1881485,99704481,101585966,10,33,2,97822996,In > Out
Sept 2021,28,173,1,22533,2457268,2479801,1,1,1,2434735,In > Out
Sept 2021,28,174,18,1215021,223559053,224774074,9,18,2,222344032,In > Out
Sept 2021,28,175,2,35903,3727547,3763450,2,2,1,3691644,In > Out
Sept 2021,28,176,129,3612484,191940369,195552853,20,128,2,188327885,In > Out
Sept 2021,28,177,10842,3654155066927,22084146400,3676239213327,8,9513,3,3632070920527,Out > In
Sept 2021,28,178,7024,3044236826556,17072240488,3061309067044,8,5741,4,3027164586068,Out > In
Sept 2021,28,179,3726,69325359,2463842028,2533167387,19,3299,5,2394516669,In > Out
Sept 2021,28,181,20959,299971531,8958759099,9258730630,16,10936,11,8658787568,In > Out
Sept 2021,28,182,95,5928540,857631341,863559881,4,95,2,851702801,In > Out
Sept 2021,28,183,36,2435547,149195160,151630707,6,36,2,146759613,In > Out
Sept 2021,28,184,45,3044377,193178660,196223037,7,45,2,190134283,In > Out
Sept 2021,28,185,13,947089,166049008,166996097,3,13,2,165101919,In > Out
Sept 2021,28,186,34,1696814,132539687,134236501,8,34,2,130842873,In > Out
Sept 2021,28,187,40,2913035,164421060,167334095,8,40,2,161508025,In > Out
Sept 2021,28,188,37,2216281,137933208,140149489,10,37,2,135716927,In > Out
Sept 2021,28,189,44,886369,154859830,155746199,12,44,2,153973461,In > Out
Sept 2021,28,190,41,2462712,153112117,155574829,9,41,2,150649405,In > Out
Sept 2021,28,191,42,2683033,156741734,159424767,8,42,2,154058701,In > Out
Sept 2021,28,192,31,2264473,127964092,130228565,8,31,2,125699619,In > Out
Sept 2021,28,193,32,2415348,129271256,131686604,7,32,2,126855908,In > Out
Sept 2021,28,194,40,2605594,160547516,163153110,8,40,2,157941922,In > Out
Sept 2021,28,195,3,85487,7803320,7888807,2,3,1,7717833,In > Out
Sept 2021,28,196,3,65915,5545336,5611251,3,3,1,5479421,In > Out
Sept 2021,28,197,4,80490,7563281,7643771,3,4,1,7482791,In > Out
Sept 2021,28,198,35,1907549,96613682,98521231,8,35,2,94706133,In > Out
Sept 2021,28,199,45,2226997,162433387,164660384,11,44,2,160206390,In > Out
Sept 2021,28,201,31,2039493,108663108,110702601,9,31,2,106623615,In > Out
Sept 2021,28,202,33,1920386,121397897,123318283,7,33,2,119477511,In > Out
Sept 2021,28,203,40,2543516,176752666,179296182,9,40,2,174209150,In > Out
Sept 2021,28,204,59,5996370,724180177,730176547,19,58,2,718183807,In > Out
Sept 2021,28,205,44,2242502,169957731,172200233,11,44,2,167715229,In > Out
Sept 2021,28,206,39,1776852,107671361,109448213,8,39,2,105894509,In > Out
Sept 2021,28,207,117,9920128,518271579,528191707,26,117,2,508351451,In > Out
Sept 2021,29,142,72,4996207,42048547,47044754,14,72,1,37052340,In > Out
Sept 2021,29,19,1257,122443507,880499321,1002942828,388,1217,2,758055814,In > Out
Sept 2021,29,54,306,523279450,770225745,1293505195,164,301,3,246946295,In > Out
Sept 2021,29,67,297,40289860,549968357,590258217,52,292,2,509678497,In > Out
Sept 2021,35,16,5,143580,3017753,3161333,4,5,2,2874173,In > Out
Sept 2021,35,17,2,19293,830040,849333,2,2,1,810747,In > Out
Sept 2021,35,181,4,31432,1890237,1921669,4,4,1,1858805,In > Out
Sept 2021,35,192,17,647104,37709764,38356868,2,17,1,37062660,In > Out
Sept 2021,35,23,2,168624,49654719,49823343,1,2,1,49486095,In > Out
Sept 2021,35,232,1,110016,15284,125300,1,1,1,94732,Out > In
Sept 2021,35,55,62,1409744,8348955,9758699,4,62,1,6939211,In > Out
Sept 2021,38,45,1,128324,34666,162990,1,1,1,93658,Out > In
Sept 2021,4,104,728,1906194014,608439233,2514633247,245,696,29,1297754781,Out > In
Sept 2021,4,105,305,23901572,456924883,480826455,90,304,3,433023311,In > Out
Sept 2021,4,106,560,304593294,398930260,703523554,153,549,6,94336966,In > Out
Sept 2021,4,11,137,13981299,204166455,218147754,12,137,2,190185156,In > Out
Sept 2021,4,112,1276,170823022,751140883,921963905,148,1224,2,580317861,In > Out
Sept 2021,4,14,6,534136,15390611,15924747,6,6,2,14856475,In > Out
Sept 2021,4,15,504,3171378019,1776311767,4947689786,143,489,14,1395066252,Out > In
Sept 2021,4,2,2450,323264668,1215277103,1538541771,214,2288,3,892012435,In > Out
Sept 2021,4,35,1297,91203426,873066666,964270092,154,1244,2,781863240,In > Out
Sept 2021,43,4,1,14774453,9207356,23981809,1,1,1,5567097,Out > In
Sept 2021,44,128,11690,3017020648,65144113565,68161134213,627,8261,188,62127092917,In > Out
Sept 2021,46,101,50,9100396,378367845,387468241,35,50,1,369267449,In > Out
Sept 2021,46,113,157,28472772,934822496,963295268,33,154,2,906349724,In > Out
Sept 2021,46,117,327,28663748,2118699085,2147362833,69,327,2,2090035337,In > Out
Sept 2021,46,119,47,39858380,1409112313,1448970693,23,47,2,1369253933,In > Out
Sept 2021,46,122,123,1618228082,23851548626,25469776708,64,111,4,22233320544,In > Out
Sept 2021,46,130,40,3106287,88777272,91883559,22,40,1,85670985,In > Out
Sept 2021,46,14,2274,1419029029,8273652702,9692681731,533,2186,8,6854623673,In > Out
Sept 2021,46,146,3762,3696441075,168566338331,172262779406,680,3342,20,164869897256,In > Out
Sept 2021,46,149,14,4434752,20268319,24703071,11,14,2,15833567,In > Out
Sept 2021,46,150,316,24174446,1098051852,1122226298,90,314,5,1073877406,In > Out
Sept 2021,46,159,9,8354300,101746666,110100966,7,9,2,93392366,In > Out
Sept 2021,46,162,257,19188794,438158222,457347016,113,257,3,418969428,In > Out
Sept 2021,46,165,7,397887,2246384,2644271,6,7,2,1848497,In > Out
Sept 2021,46,170,280,86519061,2776446247,2862965308,142,279,3,2689927186,In > Out
Sept 2021,46,175,1151,1179860136,78224443798,79404303934,163,1069,52,77044583662,In > Out
Sept 2021,46,178,1584,20850094267,19948973895,40799068162,366,1511,19,901120372,Out > In
Sept 2021,46,187,183,23879853,729496366,753376219,117,183,1,705616513,In > Out
Sept 2021,46,188,284,42282096,2348877829,2391159925,155,279,2,2306595733,In > Out
Sept 2021,46,193,118,8074912,585544742,593619654,47,118,1,577469830,In > Out
Sept 2021,46,195,398,487416283,1439185590,1926601873,167,398,7,951769307,In > Out
Sept 2021,46,196,1835,4172260524,9391821749,13564082273,531,1770,9,5219561225,In > Out
Sept 2021,46,199,137,22911343,356284571,379195914,70,136,3,333373228,In > Out
Sept 2021,46,200,12118,2227575215,93762323607,95989898822,550,8509,8,91534748392,In > Out
Sept 2021,46,205,196,11788418,349037967,360826385,89,194,1,337249549,In > Out
Sept 2021,46,209,13,83687309,227750766,311438075,5,13,2,144063457,In > Out
Sept 2021,46,210,135,38771764,1225024286,1263796050,74,135,4,1186252522,In > Out
Sept 2021,46,212,1733,824804602,3897518639,4722323241,329,1660,5,3072714037,In > Out
Sept 2021,46,220,2582,6364006588,13505695207,19869701795,771,2493,11,7141688619,In > Out
Sept 2021,46,33,306,51187325,940970216,992157541,130,306,2,889782891,In > Out
Sept 2021,46,39,2,191582,227618,419200,2,2,1,36036,In > Out
Sept 2021,46,45,1125,3264720373,5388712350,8653432723,419,1095,10,2123991977,In > Out
Sept 2021,46,50,183,10298597,859675556,869974153,28,183,3,849376959,In > Out
Sept 2021,46,53,560,1811807911,2809062607,4620870518,251,558,5,997254696,In > Out
Sept 2021,46,6,169,324406625,3823330626,4147737251,69,121,34,3498924001,In > Out
Sept 2021,46,62,2805,13336471543,23301540626,36638012169,500,2540,17,9965069083,In > Out
Sept 2021,46,65,329,66178104,3169506520,3235684624,116,328,3,3103328416,In > Out
Sept 2021,46,68,129,6036111,76186564,82222675,52,129,1,70150453,In > Out
Sept 2021,46,75,1521,350938937,12951064042,13302002979,172,1342,24,12600125105,In > Out
Sept 2021,46,8,3726,849442739,9336974204,10186416943,422,3455,12,8487531465,In > Out
Sept 2021,46,80,215,286001780,9295374932,9581376712,109,213,7,9009373152,In > Out
Sept 2021,46,81,993,437510111,19921142860,20358652971,326,993,3,19483632749,In > Out
Sept 2021,46,86,407,158474171,1708631422,1867105593,187,406,4,1550157251,In > Out
Sept 2021,46,94,347,1077758646,52436812403,53514571049,110,331,17,51359053757,In > Out
Sept 2021,46,99,1561,4177474111,14558942951,18736417062,489,1488,11,10381468840,In > Out
Sept 2021,47,53,4716,2397486152,50651618595,53049104747,719,4024,115,48254132443,In > Out
Sept 2021,48,159,5695,1076804544,20585812976,21662617520,509,4845,41,19509008432,In > Out
Sept 2021,48,22,29,1823660,81335018,83158678,20,29,2,79511358,In > Out
Sept 2021,48,36,1309,8613502484,83023665896,91637168380,289,1262,16,74410163412,In > Out
Sept 2021,48,38,27167,5479700422,145217761487,150697461909,274,13240,2,139738061065,In > Out
Sept 2021,48,39,4489,13274809939,23021805126,36296615065,698,3925,41,9746995187,In > Out
Sept 2021,48,41,2891,586445951,8700578024,9287023975,506,2644,26,8114132073,In > Out
Sept 2021,48,59,1676,9912820427,6038762043,15951582470,174,1599,9,3874058384,Out > In
Sept 2021,48,61,3806,266457666,12931986594,13198444260,2,3806,1,12665528928,In > Out
Sept 2021,49,113,53506,22435170769,112618281168,135053451937,2552,16107,23,90183110399,In > Out
Sept 2021,49,114,73744,152482443459,209920737325,362403180784,1619,22750,516,57438293866,In > Out
Sept 2021,49,115,29182,75090190173,74150223765,149240413938,1493,14049,12,939966408,Out > In
Sept 2021,49,116,30379,10831128417,63627853271,74458981688,1738,16310,18,52796724854,In > Out
Sept 2021,49,117,52156,19726306684,102520774226,122247080910,2021,21443,14,82794467542,In > Out
Sept 2021,49,118,56267,23892275254,86712685268,110604960522,2481,22769,24,62820410014,In > Out
Sept 2021,49,119,47541,15303890172,172317445142,187621335314,2509,19975,16,157013554970,In > Out
Sept 2021,49,120,40880,21207770836,571040048614,592247819450,2215,16369,32,549832277778,In > Out
Sept 2021,49,121,52241,13145001625,173061092513,186206094138,1959,20154,23,159916090888,In > Out
Sept 2021,49,122,71796,15150393099,142928851013,158079244112,2113,23112,445,127778457914,In > Out
Sept 2021,49,123,37454,23140252040,67746362746,90886614786,2072,15456,20,44606110706,In > Out
Sept 2021,49,124,48237,22758061972,114597810213,137355872185,3067,17960,19,91839748241,In > Out
Sept 2021,49,125,192206,29210400870,300080007375,329290408245,3547,16909,5,270869606505,In > Out
Sept 2021,49,126,192259,28569642247,291443802336,320013444583,3795,16980,8,262874160089,In > Out
Sept 2021,5,103,2,366097,23020,389117,2,1,2,343077,Out > In
Sept 2021,5,2,28,4458715,294635577,299094292,13,28,1,290176862,In > Out
Sept 2021,5,22,54,3102075,288152119,291254194,21,53,5,285050044,In > Out
Sept 2021,5,23,30,17043063,204342470,221385533,26,29,3,187299407,In > Out
Sept 2021,5,25,996,33543104,3811553031,3845096135,118,969,4,3778009927,In > Out
Sept 2021,5,27,3017,31984540,3541383144,3573367684,40,2928,3,3509398604,In > Out
Sept 2021,5,30,14,6821909,565776439,572598348,3,14,1,558954530,In > Out
Sept 2021,5,31,11,4786641,402616339,407402980,2,11,1,397829698,In > Out
Sept 2021,5,6,37,125645551,546091,126191642,2,37,1,125099460,Out > In
Sept 2021,5,66,1,812,2959126,2959938,1,1,1,2958314,In > Out
Sept 2021,50,241,7,286182,905983,1192165,3,7,1,619801,In > Out
Sept 2021,50,51,43,2589830,154924531,157514361,6,43,2,152334701,In > Out
Sept 2021,50,52,16,987597,83502648,84490245,8,16,2,82515051,In > Out
Sept 2021,51,10,17,4260303,216087335,220347638,2,17,1,211827032,In > Out
Sept 2021,51,151,1134,360338689,1218405943,1578744632,245,1101,7,858067254,In > Out
Sept 2021,51,152,125,6762911,107140417,113903328,51,125,2,100377506,In > Out
Sept 2021,51,154,471,126106761,8732431331,8858538092,75,466,207,8606324570,In > Out
Sept 2021,51,160,795,75361322,1565174488,1640535810,10,191,3,1489813166,In > Out
Sept 2021,51,161,230,29132208,1112540190,1141672398,101,228,2,1083407982,In > Out
Sept 2021,51,167,1,11524,539932,551456,1,1,1,528408,In > Out
Sept 2021,51,172,192,27131189,642003432,669134621,43,191,2,614872243,In > Out
Sept 2021,51,173,1570,428602363,4788270435,5216872798,221,1497,4,4359668072,In > Out
Sept 2021,51,174,71,10868767,342986794,353855561,35,69,2,332118027,In > Out
Sept 2021,51,177,152,11204934,711593504,722798438,13,150,2,700388570,In > Out
Sept 2021,51,182,432,206534547,11734203124,11940737671,9,416,400,11527668577,In > Out
Sept 2021,51,183,4,13120,561358,574478,4,4,1,548238,In > Out
Sept 2021,51,194,59,5395283,79451824,84847107,21,59,2,74056541,In > Out
Sept 2021,51,196,14,145486,2774404,2919890,2,14,1,2628918,In > Out
Sept 2021,51,201,27,221838352,1177781819,1399620171,24,27,3,955943467,In > Out
Sept 2021,51,207,1311,891634060,3832904915,4724538975,300,1266,7,2941270855,In > Out
Sept 2021,51,209,306,108411571,631751967,740163538,89,305,3,523340396,In > Out
Sept 2021,51,210,159,20628903,289986020,310614923,51,158,2,269357117,In > Out
Sept 2021,51,226,1116,143671307,1622207051,1765878358,239,1071,7,1478535744,In > Out
Sept 2021,51,230,1180,304361917,1549703571,1854065488,383,1148,4,1245341654,In > Out
Sept 2021,51,239,616,574376879,940289521,1514666400,193,602,4,365912642,In > Out
Sept 2021,51,4,14,3172111,147892727,151064838,2,14,1,144720616,In > Out
Sept 2021,51,45,2108,1231972672,3580914604,4812887276,335,1957,3,2348941932,In > Out
Sept 2021,51,5,15,5574826,276519063,282093889,2,15,1,270944237,In > Out
Sept 2021,51,50,6705,15705463114,16034437667,31739900781,543,5488,6,328974553,In > Out
Sept 2021,51,51,103,10583985,569467786,580051771,27,103,3,558883801,In > Out
Sept 2021,51,53,61,9002693,625588500,634591193,14,61,2,616585807,In > Out
Sept 2021,51,54,4146,13149389645,18180931282,31330320927,298,3654,5,5031541637,In > Out
Sept 2021,51,59,2,1069845,28555368,29625213,1,2,1,27485523,In > Out
Sept 2021,51,60,3,6077182,160259569,166336751,1,3,1,154182387,In > Out
Sept 2021,51,62,186,29887142,528241216,558128358,41,185,2,498354074,In > Out
Sept 2021,51,63,156,16011999,863482668,879494667,24,156,2,847470669,In > Out
Sept 2021,51,65,18,3870064,303672605,307542669,8,18,2,299802541,In > Out
Sept 2021,51,67,136,14952254,339397314,354349568,21,135,2,324445060,In > Out
Sept 2021,51,68,615,113942227,2146697519,2260639746,281,608,2,2032755292,In > Out
Sept 2021,51,69,343,40073911,961696240,1001770151,171,338,2,921622329,In > Out
Sept 2021,52,10,52,13061207,382032955,395094162,18,52,3,368971748,In > Out
Sept 2021,52,113,883,120345441,141902662,262248103,62,883,2,21557221,In > Out
Sept 2021,52,115,174,6356679,326754864,333111543,35,172,2,320398185,In > Out
Sept 2021,52,119,197,7287215,751756978,759044193,38,197,2,744469763,In > Out
Sept 2021,52,12,48,3501136,709513158,713014294,14,43,3,706012022,In > Out
Sept 2021,52,120,297,15533593,979925241,995458834,60,297,2,964391648,In > Out
Sept 2021,52,141,28,1595752,103294806,104890558,2,28,1,101699054,In > Out
Sept 2021,52,142,4,36216,6065614,6101830,2,4,1,6029398,In > Out
Sept 2021,52,143,53,4788901,450526469,455315370,25,53,2,445737568,In > Out
Sept 2021,52,149,23,2522363,419759199,422281562,4,23,2,417236836,In > Out
Sept 2021,52,15,34,237708,32805388,33043096,8,34,1,32567680,In > Out
Sept 2021,52,16,26,163619,21610875,21774494,8,26,1,21447256,In > Out
Sept 2021,52,164,30,6864544,217498968,224363512,9,30,2,210634424,In > Out
Sept 2021,52,172,37,256503,26028273,26284776,7,37,1,25771770,In > Out
Sept 2021,52,199,62,287072190,2499999978,2787072168,27,62,46,2212927788,In > Out
Sept 2021,52,22,42,292448,36112004,36404452,9,42,1,35819556,In > Out
Sept 2021,52,24,35,1789010,315863573,317652583,7,35,2,314074563,In > Out
Sept 2021,52,25,28,1272970,147653653,148926623,10,28,2,146380683,In > Out
Sept 2021,52,251,104,22268772,1275326373,1297595145,51,104,4,1253057601,In > Out
Sept 2021,52,252,5,181235,1389858,1571093,5,5,1,1208623,In > Out
Sept 2021,52,29,31,2252532,187649916,189902448,3,31,2,185397384,In > Out
Sept 2021,52,33,15,1124370,132139316,133263686,2,15,1,131014946,In > Out
Sept 2021,52,35,123,87363652,11013291677,11100655329,5,122,91,10925928025,In > Out
Sept 2021,52,36,35,2587578,353409449,355997027,4,35,2,350821871,In > Out
Sept 2021,52,37,31,2141774,379440876,381582650,3,31,2,377299102,In > Out
Sept 2021,52,38,46,17182600,2205423559,2222606159,15,46,16,2188240959,In > Out
Sept 2021,52,6,54,3942537,518573152,522515689,10,54,2,514630615,In > Out
Sept 2021,52,8,25,1780946,162744487,164525433,9,25,2,160963541,In > Out
Sept 2021,52,9,28,1703390,516066198,517769588,2,28,1,514362808,In > Out
Sept 2021,52,90,135,70272276,742231497,812503773,47,135,5,671959221,In > Out
Sept 2021,52,92,373,25889146,1661297328,1687186474,204,367,3,1635408182,In > Out
Sept 2021,52,95,105,11577086,1267825540,1279402626,39,102,3,1256248454,In > Out
Sept 2021,52,97,29,8898862,138617244,147516106,19,13,19,129718382,In > Out
Sept 2021,53,169,7,683025463,695394703,1378420166,1,7,6,12369240,In > Out
Sept 2021,53,171,27782,245937456,7576642422,7822579878,253,17686,2,7330704966,In > Out
Sept 2021,54,103,171,14508116,168990232,183498348,28,171,2,154482116,In > Out
Sept 2021,54,104,264,23585256,343564229,367149485,59,260,2,319978973,In > Out
Sept 2021,54,105,226,19310336,252763961,272074297,63,225,2,233453625,In > Out
Sept 2021,54,106,258,36329519,224830432,261159951,71,256,2,188500913,In > Out
Sept 2021,54,107,196,19669029,286854041,306523070,41,194,2,267185012,In > Out
Sept 2021,54,108,257,18687687,318494901,337182588,61,254,2,299807214,In > Out
Sept 2021,54,109,333,24534269,481802770,506337039,91,328,2,457268501,In > Out
Sept 2021,54,110,230,16400274,230548603,246948877,65,229,2,214148329,In > Out
Sept 2021,54,115,111,8803841,30994137,39797978,15,111,1,22190296,In > Out
Sept 2021,54,116,101,7955349,67592454,75547803,12,101,2,59637105,In > Out
Sept 2021,54,117,106,9849711,75892583,85742294,14,104,2,66042872,In > Out
Sept 2021,54,118,117,10367374,83379700,93747074,14,117,2,73012326,In > Out
Sept 2021,54,119,112,9379205,65919818,75299023,12,112,2,56540613,In > Out
Sept 2021,54,120,105,7189704,34731792,41921496,11,105,1,27542088,In > Out
Sept 2021,54,121,105,7380816,40751982,48132798,12,104,1,33371166,In > Out
Sept 2021,54,122,113,10355670,92292033,102647703,12,113,2,81936363,In > Out
Sept 2021,54,127,120,11430157,168626250,180056407,16,120,2,157196093,In > Out
Sept 2021,54,128,219,15089332,344014311,359103643,67,219,2,328924979,In > Out
Sept 2021,54,129,329,76171581,1047213463,1123385044,102,326,2,971041882,In > Out
Sept 2021,54,130,125,10400385,86461764,96862149,14,124,2,76061379,In > Out
Sept 2021,54,131,249,28851248,831426916,860278164,46,244,3,802575668,In > Out
Sept 2021,54,132,188,23753220,628894766,652647986,39,187,2,605141546,In > Out
Sept 2021,54,133,267,23959054,283080355,307039409,71,265,2,259121301,In > Out
Sept 2021,54,134,317,33782685,572298569,606081254,87,314,2,538515884,In > Out
Sept 2021,54,139,134,12437443,123887909,136325352,16,133,2,111450466,In > Out
Sept 2021,54,140,379,58445450,1049007895,1107453345,100,374,2,990562445,In > Out
Sept 2021,54,141,207,18474193,136232593,154706786,67,207,2,117758400,In > Out
Sept 2021,54,142,292,36551422,720774661,757326083,73,290,2,684223239,In > Out
Sept 2021,54,143,129,10087316,33110825,43198141,13,129,1,23023509,In > Out
Sept 2021,54,144,470,118968304,1071642586,1190610890,141,460,4,952674282,In > Out
Sept 2021,54,145,299,108798380,838503269,947301649,86,295,3,729704889,In > Out
Sept 2021,54,146,404,39028418,533494761,572523179,124,401,2,494466343,In > Out
Sept 2021,54,147,110,9998089,99588672,109586761,16,110,2,89590583,In > Out
Sept 2021,54,151,22,2306231,478606571,480912802,4,22,2,476300340,In > Out
Sept 2021,54,155,24,1853285,444470967,446324252,4,24,2,442617682,In > Out
Sept 2021,54,160,77,4597821,731950453,736548274,32,76,2,727352632,In > Out
Sept 2021,54,167,357,140617628,1114282171,1254899799,44,357,2,973664543,In > Out
Sept 2021,54,20,63,2931219,500370120,503301339,25,63,2,497438901,In > Out
Sept 2021,54,21,21,940136,140261565,141201701,4,21,2,139321429,In > Out
Sept 2021,54,22,29,3402325,702165223,705567548,10,29,2,698762898,In > Out
Sept 2021,54,24,22,2343351,585956990,588300341,4,22,2,583613639,In > Out
Sept 2021,54,25,22,1432403,344854649,346287052,4,22,2,343422246,In > Out
Sept 2021,54,26,24,2170780,371450992,373621772,5,24,2,369280212,In > Out
Sept 2021,54,27,22,1622773,237711972,239334745,4,22,2,236089199,In > Out
Sept 2021,54,28,23,2453509,554408620,556862129,4,23,2,551955111,In > Out
Sept 2021,54,29,21,1173565,193115144,194288709,4,21,2,191941579,In > Out
Sept 2021,54,30,22,1335730,168308112,169643842,4,22,2,166972382,In > Out
Sept 2021,54,31,22,1457754,336392452,337850206,4,22,2,334934698,In > Out
Sept 2021,54,32,11,1056318,215156712,216213030,3,11,1,214100394,In > Out
Sept 2021,54,33,22,2144124,533770643,535914767,5,22,2,531626519,In > Out
Sept 2021,54,34,21,2954675,665642045,668596720,4,21,2,662687370,In > Out
Sept 2021,54,35,24,1360403,158621446,159981849,4,24,2,157261043,In > Out
Sept 2021,54,36,23,1809620,320649775,322459395,4,23,2,318840155,In > Out
Sept 2021,54,37,23,2525528,637360180,639885708,5,23,2,634834652,In > Out
Sept 2021,54,38,23,1526221,273866014,275392235,5,23,2,272339793,In > Out
Sept 2021,54,39,22,1597117,384200324,385797441,4,22,2,382603207,In > Out
Sept 2021,54,40,24,2894528,659379672,662274200,5,24,2,656485144,In > Out
Sept 2021,54,41,22,1644105,346649552,348293657,4,22,2,345005447,In > Out
Sept 2021,54,42,22,1507361,283202893,284710254,4,22,2,281695532,In > Out
Sept 2021,54,43,24,3099611,697354713,700454324,5,24,2,694255102,In > Out
Sept 2021,54,44,201,7032180,406672968,413705148,120,198,2,399640788,In > Out
Sept 2021,54,45,24,1073410,168294730,169368140,4,24,2,167221320,In > Out
Sept 2021,54,46,18,1579246,285308121,286887367,4,18,2,283728875,In > Out
Sept 2021,54,47,22,2613616,555686992,558300608,4,22,2,553073376,In > Out
Sept 2021,54,48,24,1473315,179543385,181016700,4,24,2,178070070,In > Out
Sept 2021,54,49,24,2856549,600229150,603085699,4,24,2,597372601,In > Out
Sept 2021,54,50,22,2359453,608607819,610967272,4,22,2,606248366,In > Out
Sept 2021,54,51,22,1375037,195647785,197022822,4,22,2,194272748,In > Out
Sept 2021,54,52,22,1545921,279652365,281198286,4,22,2,278106444,In > Out
Sept 2021,54,53,24,2881446,619454684,622336130,4,24,2,616573238,In > Out
Sept 2021,54,54,24,2431995,534824809,537256804,4,24,2,532392814,In > Out
Sept 2021,54,55,23,1706450,384314633,386021083,4,23,2,382608183,In > Out
Sept 2021,54,56,18,1035996,143119640,144155636,4,18,2,142083644,In > Out
Sept 2021,54,57,20,1878743,514511573,516390316,4,20,2,512632830,In > Out
Sept 2021,54,58,55,4850722,530393876,535244598,26,54,2,525543154,In > Out
Sept 2021,54,59,21,1681805,300568433,302250238,4,21,2,298886628,In > Out
Sept 2021,54,60,104,27185352,697664958,724850310,47,103,2,670479606,In > Out
Sept 2021,54,61,24,1635493,315737201,317372694,4,24,2,314101708,In > Out
Sept 2021,54,62,23,2740149,646438398,649178547,4,23,2,643698249,In > Out
Sept 2021,54,63,22,1545836,341158206,342704042,4,22,2,339612370,In > Out
Sept 2021,54,64,22,1923621,428136320,430059941,4,22,2,426212699,In > Out
Sept 2021,54,67,19,1336480,239820762,241157242,4,19,2,238484282,In > Out
Sept 2021,54,68,24,2002596,414701710,416704306,4,24,2,412699114,In > Out
Sept 2021,54,69,23,2980537,673450285,676430822,5,23,2,670469748,In > Out
Sept 2021,54,70,22,1144845,196945868,198090713,4,22,2,195801023,In > Out
Sept 2021,54,71,77,11977603,642267734,654245337,28,75,2,630290131,In > Out
Sept 2021,54,72,47,5360715,419146909,424507624,19,47,2,413786194,In > Out
Sept 2021,54,73,23,1889904,415632807,417522711,5,23,2,413742903,In > Out
Sept 2021,54,74,164,13748703,734985677,748734380,29,163,2,721236974,In > Out
Sept 2021,54,76,22,1759198,324082628,325841826,4,22,2,322323430,In > Out
Sept 2021,54,77,299,150409413,1053780857,1204190270,33,297,2,903371444,In > Out
Sept 2021,54,79,23,1750175,350772568,352522743,4,23,2,349022393,In > Out
Sept 2021,54,80,22,6635057,335822852,342457909,4,22,2,329187795,In > Out
Sept 2021,54,81,24,2852323,660146056,662998379,4,24,2,657293733,In > Out
Sept 2021,54,82,23,2080531,589737866,591818397,4,23,2,587657335,In > Out
Sept 2021,54,83,30,1342679,216398048,217740727,9,30,2,215055369,In > Out
Sept 2021,54,84,33,2436114,594062197,596498311,8,33,2,591626083,In > Out
Sept 2021,54,85,20,2553828,548816345,551370173,4,20,2,546262517,In > Out
Sept 2021,54,86,25,3292062,758275022,761567084,4,25,2,754982960,In > Out
Sept 2021,54,91,124,10207692,92728933,102936625,14,124,2,82521241,In > Out
Sept 2021,54,92,128,9872346,99568914,109441260,14,128,2,89696568,In > Out
Sept 2021,54,93,110,9316758,32822402,42139160,12,110,1,23505644,In > Out
Sept 2021,54,95,109,8168405,39255203,47423608,11,109,1,31086798,In > Out
Sept 2021,54,97,113,8723528,34482705,43206233,12,113,2,25759177,In > Out
Sept 2021,54,98,130,11103637,64908794,76012431,17,130,2,53805157,In > Out
Sept 2021,54,99,111,7449754,34886856,42336610,11,111,1,27437102,In > Out
Sept 2021,55,105,1268,220498550,1456703460,1677202010,242,1216,3,1236204910,In > Out
Sept 2021,55,109,96,5164104,98711008,103875112,56,95,2,93546904,In > Out
Sept 2021,55,143,35,2894757,5172264,8067021,2,35,1,2277507,In > Out
Sept 2021,55,96,26,1348355,8156990,9505345,8,26,1,6808635,In > Out
Sept 2021,56,130,279,56402447,303674691,360077138,35,279,2,247272244,In > Out
Sept 2021,56,134,2889,569599839,2595012619,3164612458,266,2727,3,2025412780,In > Out
Sept 2021,56,135,187,3103961,98868346,101972307,30,187,2,95764385,In > Out
Sept 2021,56,139,7,6107784,6326005,12433789,6,7,1,218221,In > Out
Sept 2021,56,143,6,35502,1633807,1669309,2,6,1,1598305,In > Out
Sept 2021,56,146,90,5898167,152787219,158685386,64,90,2,146889052,In > Out
Sept 2021,56,147,2991,731139221,1790096022,2521235243,228,2755,6,1058956801,In > Out
Sept 2021,56,148,359,36908757,3337021319,3373930076,53,354,2,3300112562,In > Out
Sept 2021,56,154,283,12243667,250756664,263000331,27,282,2,238512997,In > Out
Sept 2021,56,158,1510,339269248,2778552309,3117821557,272,1436,2,2439283061,In > Out
Sept 2021,56,164,301,18633633,1402720255,1421353888,53,298,2,1384086622,In > Out
Sept 2021,56,166,91,7496632,205539753,213036385,48,90,2,198043121,In > Out
Sept 2021,56,176,22,2039157,480670510,482709667,4,22,2,478631353,In > Out
Sept 2021,56,181,389,1114737856,424821136,1539558992,155,380,3,689916720,Out > In
Sept 2021,56,183,719,259199932,964082626,1223282558,261,711,3,704882694,In > Out
Sept 2021,56,184,124,15392010,403795190,419187200,72,124,2,388403180,In > Out
Sept 2021,56,194,16,91399,11434002,11525401,7,16,1,11342603,In > Out
Sept 2021,56,196,611,213494126,2314880412,2528374538,38,591,2,2101386286,In > Out
Sept 2021,56,221,17,2069103,327753673,329822776,2,17,1,325684570,In > Out
Sept 2021,56,223,60,1480759,96817079,98297838,22,60,2,95336320,In > Out
Sept 2021,56,224,543,105810699,2063406087,2169216786,45,539,2,1957595388,In > Out
Sept 2021,56,225,777,89444327,1797613000,1887057327,46,765,2,1708168673,In > Out
Sept 2021,56,226,189,3818632,600647265,604465897,42,188,2,596828633,In > Out
Sept 2021,56,241,388,182222219,1641114502,1823336721,168,383,3,1458892283,In > Out
Sept 2021,56,242,7171,1347507397,2140359877,3487867274,199,6235,3,792852480,In > Out
Sept 2021,56,243,45,2426542,335033107,337459649,17,45,2,332606565,In > Out
Sept 2021,56,244,754,95961409,441850138,537811547,12,742,2,345888729,In > Out
Sept 2021,56,253,901,24575136,2214080674,2238655810,100,838,2,2189505538,In > Out
Sept 2021,57,133,13,123965,5337392,5461357,5,13,1,5213427,In > Out
Sept 2021,57,134,714,66661160,702219152,768880312,74,702,2,635557992,In > Out
Sept 2021,57,155,2,242131,21572,263703,2,2,1,220559,Out > In
Sept 2021,57,160,450,130521016,2438621047,2569142063,26,445,2,2308100031,In > Out
Sept 2021,57,166,32,2408684,3898089,6306773,2,32,1,1489405,In > Out
Sept 2021,57,170,166,16560217,223017062,239577279,23,166,2,206456845,In > Out
Sept 2021,57,171,1033,157719170,4300721845,4458441015,61,1021,2,4143002675,In > Out
Sept 2021,57,172,744,50595820,2959028916,3009624736,57,735,2,2908433096,In > Out
Sept 2021,57,174,30,10603076,423491707,434094783,2,30,1,412888631,In > Out
Sept 2021,57,179,1066,163925665,1072069508,1235995173,319,1020,2,908143843,In > Out
Sept 2021,57,180,1400,9393533484,356703055,9750236539,22,1344,4,9036830429,Out > In
Sept 2021,57,2,8,2285351,92380266,94665617,4,8,2,90094915,In > Out
Sept 2021,57,202,14,759751,4793378,5553129,11,14,1,4033627,In > Out
Sept 2021,57,207,99,1442548447,31949924,1474498371,12,99,5,1410598523,Out > In
Sept 2021,57,212,28,1059051,55589290,56648341,12,28,1,54530239,In > Out
Sept 2021,57,214,113,22422329,498247628,520669957,54,113,3,475825299,In > Out
Sept 2021,57,228,1,7394,191328,198722,1,1,1,183934,In > Out
Sept 2021,57,231,69,4997317,41097376,46094693,16,69,2,36100059,In > Out
Sept 2021,57,235,71,4081552,152174761,156256313,14,71,2,148093209,In > Out
Sept 2021,57,240,751,28702254,1171791668,1200493922,156,737,2,1143089414,In > Out
Sept 2021,57,245,8,104303,2034061,2138364,8,8,1,1929758,In > Out
Sept 2021,58,218,4722,1960823484,14092857869,16053681353,856,4103,6,12132034385,In > Out
Sept 2021,58,228,37,1297508,114016546,115314054,9,37,2,112719038,In > Out
Sept 2021,58,234,851,1422670464,6149229948,7571900412,254,782,8,4726559484,In > Out
Sept 2021,58,236,279,12562083,577603739,590165822,53,275,2,565041656,In > Out
Sept 2021,6,177,703,39704597,2483896603,2523601200,82,659,2,2444192006,In > Out
Sept 2021,6,231,323,35469941,1222335345,1257805286,102,294,5,1186865404,In > Out
Sept 2021,6,232,2090,285216870,1492689545,1777906415,390,1926,6,1207472675,In > Out
Sept 2021,6,235,118,26712124,802987513,829699637,22,118,2,776275389,In > Out
Sept 2021,6,238,35,574732,38837215,39411947,20,35,2,38262483,In > Out
Sept 2021,6,243,2,191402,3129442,3320844,2,2,1,2938040,In > Out
Sept 2021,6,247,116,3284131,392461460,395745591,19,116,2,389177329,In > Out
Sept 2021,6,252,31,1766130,295706656,297472786,8,31,2,293940526,In > Out
Sept 2021,6,253,204,13981042,995736687,1009717729,29,202,2,981755645,In > Out
Sept 2021,6,32,178,19415675,91728973,111144648,24,178,2,72313298,In > Out
Sept 2021,6,34,2047,327900617,3081386402,3409287019,567,1925,2,2753485785,In > Out
Sept 2021,6,38,19,5097146,377597747,382694893,6,19,2,372500601,In > Out
Sept 2021,6,45,996,1068444011,7406048867,8474492878,254,969,8,6337604856,In > Out
Sept 2021,6,61,286,17144813,588705868,605850681,40,283,2,571561055,In > Out
Sept 2021,6,68,252,22422070,891185623,913607693,43,250,2,868763553,In > Out
Sept 2021,6,7,11,4636734,3192494,7829228,6,10,1,1444240,Out > In
Sept 2021,65,114,34,224332293,32499338,256831631,31,2,13,191832955,Out > In
Sept 2021,65,117,272,93780594,963842338,1057622932,34,269,2,870061744,In > Out
Sept 2021,65,181,816,472005084,4398975775,4870980859,263,797,5,3926970691,In > Out
Sept 2021,65,226,4702,14026971776,20843484216,34870455992,210,4093,3,6816512440,In > Out
Sept 2021,65,236,91,8600930,219425268,228026198,52,91,2,210824338,In > Out
Sept 2021,65,28,1771,292517950,7371956327,7664474277,177,1696,2,7079438377,In > Out
Sept 2021,65,31,387,11209259,566433403,577642662,39,377,2,555224144,In > Out
Sept 2021,65,44,2236,292388006,2911079078,3203467084,242,2090,2,2618691072,In > Out
Sept 2021,65,60,1467,114537723863,8764812979,123302536842,312,1397,2,105772910884,Out > In
Sept 2021,65,70,740,567364323,3072598425,3639962748,227,740,4,2505234102,In > Out
Sept 2021,65,89,4,295903,13003845,13299748,3,4,2,12707942,In > Out
Sept 2021,7,108,25,960191,68108644,69068835,8,25,1,67148453,In > Out
Sept 2021,7,119,18676,9601845198,83380106118,92981951316,1864,13459,15,73778260920,In > Out
Sept 2021,7,129,253,36110113,1663054464,1699164577,28,252,3,1626944351,In > Out
Sept 2021,7,163,776,456398225,573327578,1029725803,4,756,1,116929353,In > Out
Sept 2021,7,165,1635,1195469685,12739005010,13934474695,88,1635,2,11543535325,In > Out
Sept 2021,7,186,1,171140,4699,175839,1,1,1,166441,Out > In
Sept 2021,7,2,397,58985167,1805201499,1864186666,110,396,2,1746216332,In > Out
Sept 2021,7,208,37,1776693,146695917,148472610,9,37,2,144919224,In > Out
Sept 2021,7,49,1408,425261132,7046761041,7472022173,273,1377,4,6621499909,In > Out
Sept 2021,7,56,1380,245259721,422109128,667368849,104,1354,2,176849407,In > Out
Sept 2021,7,90,1699,412562137,977004699,1389566836,173,1615,3,564442562,In > Out
Sept 2021,7,91,32,2357432,4383073,6740505,2,32,1,2025641,In > Out
Sept 2021,7,94,3473,4877251192,10385634868,15262886060,729,3075,3,5508383676,In > Out
Sept 2021,70,10,1217,114626180,4406457139,4521083319,235,1162,8,4291830959,In > Out
Sept 2021,70,100,643,166820796,2599957893,2766778689,246,639,10,2433137097,In > Out
Sept 2021,70,101,1516,403985737,8901471761,9305457498,265,1455,7,8497486024,In > Out
Sept 2021,70,103,1234,271936273,2290135281,2562071554,248,1223,6,2018199008,In > Out
Sept 2021,70,104,7801,737855671,34072413343,34810269014,562,7146,33,33334557672,In > Out
Sept 2021,70,106,1989,243655739,1963401829,2207057568,237,1890,6,1719746090,In > Out
Sept 2021,70,107,995,336915336,6219922923,6556838259,333,970,7,5883007587,In > Out
Sept 2021,70,108,1715,779568455,11543682783,12323251238,396,1637,9,10764114328,In > Out
Sept 2021,70,11,1159,115446668,5492450898,5607897566,336,1135,6,5377004230,In > Out
Sept 2021,70,113,574,216783756,1184558570,1401342326,183,571,4,967774814,In > Out
Sept 2021,70,114,841,181671677,5053982142,5235653819,335,817,6,4872310465,In > Out
Sept 2021,70,121,355,92513760,1471194304,1563708064,147,354,5,1378680544,In > Out
Sept 2021,70,124,1491,210235648,5401927896,5612163544,289,1397,21,5191692248,In > Out
Sept 2021,70,128,1287,293723084,6008756566,6302479650,412,1266,5,5715033482,In > Out
Sept 2021,70,13,2087,859266786,30915792587,31775059373,314,2049,8,30056525801,In > Out
Sept 2021,70,131,847,487465774,8321823681,8809289455,266,836,11,7834357907,In > Out
Sept 2021,70,134,138,47200863,541812600,589013463,76,138,6,494611737,In > Out
Sept 2021,70,135,1605,544468551,15159320641,15703789192,366,1548,4,14614852090,In > Out
Sept 2021,70,136,1209,248457784,6258906542,6507364326,308,1164,9,6010448758,In > Out
Sept 2021,70,138,373,74230311,4001517833,4075748144,144,372,4,3927287522,In > Out
Sept 2021,70,139,654,565245705,8009342743,8574588448,245,645,6,7444097038,In > Out
Sept 2021,70,14,1664,567143845,4080803363,4647947208,595,1617,5,3513659518,In > Out
Sept 2021,70,140,617,248004060,1541331045,1789335105,197,614,4,1293326985,In > Out
Sept 2021,70,141,532,624943712,6816734430,7441678142,195,527,7,6191790718,In > Out
Sept 2021,70,142,242,14268082,652023091,666291173,65,241,3,637755009,In > Out
Sept 2021,70,146,342,65883611,445257620,511141231,149,342,5,379374009,In > Out
Sept 2021,70,148,1580,397497000,31562302227,31959799227,287,1535,10,31164805227,In > Out
Sept 2021,70,149,505,466090049,8982562434,9448652483,170,502,5,8516472385,In > Out
Sept 2021,70,15,726,267370068,17342513704,17609883772,301,700,4,17075143636,In > Out
Sept 2021,70,151,654,144486697,1193463091,1337949788,186,652,5,1048976394,In > Out
Sept 2021,70,158,398,125440029,2299366361,2424806390,154,396,6,2173926332,In > Out
Sept 2021,70,159,779,282009055,5175351402,5457360457,347,769,4,4893342347,In > Out
Sept 2021,70,165,1793,171059166,4277258579,4448317745,402,1675,15,4106199413,In > Out
Sept 2021,70,166,4842,1759372526,14877725369,16637097895,498,4407,6,13118352843,In > Out
Sept 2021,70,168,789,231179487,1181906582,1413086069,191,784,5,950727095,In > Out
Sept 2021,70,171,85,5201830,123525585,128727415,56,84,3,118323755,In > Out
Sept 2021,70,174,569,67510574,5166654449,5234165023,217,565,6,5099143875,In > Out
Sept 2021,70,175,543,60640881,1904625900,1965266781,165,538,7,1843985019,In > Out
Sept 2021,70,177,733,175557017,7458363538,7633920555,258,711,14,7282806521,In > Out
Sept 2021,70,178,536,341943721,2611601365,2953545086,183,530,4,2269657644,In > Out
Sept 2021,70,179,184,18407891,1006639841,1025047732,82,182,2,988231950,In > Out
Sept 2021,70,18,533,143110569,10260347017,10403457586,195,532,3,10117236448,In > Out
Sept 2021,70,181,681,916437344,4702784738,5619222082,257,664,6,3786347394,In > Out
Sept 2021,70,183,1674,329049947,5317741745,5646791692,392,1642,5,4988691798,In > Out
Sept 2021,70,187,1641,238357983,8275036214,8513394197,254,1599,6,8036678231,In > Out
Sept 2021,70,188,363,94848849,2357449781,2452298630,122,362,4,2262600932,In > Out
Sept 2021,70,189,1244,167253915,4803051396,4970305311,403,1215,13,4635797481,In > Out
Sept 2021,70,19,595,103038687,1074844142,1177882829,209,589,4,971805455,In > Out
Sept 2021,70,192,1131,440966247,16799929193,17240895440,317,1094,4,16358962946,In > Out
Sept 2021,70,193,1157,316690649,4521154319,4837844968,360,1099,8,4204463670,In > Out
Sept 2021,70,197,735,654991274,4722821008,5377812282,235,730,8,4067829734,In > Out
Sept 2021,70,199,786,568485585,5760383803,6328869388,268,772,8,5191898218,In > Out
Sept 2021,70,20,893,70238324,2385831537,2456069861,286,868,6,2315593213,In > Out
Sept 2021,70,200,807,85024186,2153332652,2238356838,231,798,5,2068308466,In > Out
Sept 2021,70,201,864,100870853,3027107654,3127978507,280,833,5,2926236801,In > Out
Sept 2021,70,204,505,122084344,5597389994,5719474338,173,495,4,5475305650,In > Out
Sept 2021,70,206,1016,527855940,2094938699,2622794639,348,982,13,1567082759,In > Out
Sept 2021,70,207,214,27271782,1187137481,1214409263,114,213,4,1159865699,In > Out
Sept 2021,70,208,645,262252910,18143828766,18406081676,211,632,3,17881575856,In > Out
Sept 2021,70,209,451,46417581,759338494,805756075,179,447,4,712920913,In > Out
Sept 2021,70,21,509,222371079,3343923453,3566294532,169,500,5,3121552374,In > Out
Sept 2021,70,210,975,257422376,7889212431,8146634807,272,960,12,7631790055,In > Out
Sept 2021,70,211,1297,518874495,19251125709,19770000204,299,1280,5,18732251214,In > Out
Sept 2021,70,214,522,229182229,2195382516,2424564745,184,516,8,1966200287,In > Out
Sept 2021,70,217,386,21825973,619076858,640902831,93,384,2,597250885,In > Out
Sept 2021,70,218,1485,3109277943,6124593841,9233871784,388,1423,18,3015315898,In > Out
Sept 2021,70,222,1067,207599186,2458434836,2666034022,366,1018,5,2250835650,In > Out
Sept 2021,70,223,915,275687439,3741169037,4016856476,203,896,5,3465481598,In > Out
Sept 2021,70,23,1311,1123698603,2333183130,3456881733,286,1267,7,1209484527,In > Out
Sept 2021,70,25,647,914770173,5437691295,6352461468,278,637,5,4522921122,In > Out
Sept 2021,70,26,625,79867153,2988105718,3067972871,230,621,4,2908238565,In > Out
Sept 2021,70,27,934,584873098,2688518032,3273391130,314,910,10,2103644934,In > Out
Sept 2021,70,28,1058,79296300,2822296639,2901592939,211,1042,6,2743000339,In > Out
Sept 2021,70,30,563,331758797,4374199503,4705958300,264,556,5,4042440706,In > Out
Sept 2021,70,32,694,3083248773,3497202006,6580450779,212,677,4,413953233,In > Out
Sept 2021,70,33,1649,128945837,6578039493,6706985330,425,1603,7,6449093656,In > Out
Sept 2021,70,34,558,107601132,16600196590,16707797722,218,550,5,16492595458,In > Out
Sept 2021,70,35,1297,793126297,8582990131,9376116428,302,1190,6,7789863834,In > Out
Sept 2021,70,37,1290,285660777,5476439546,5762100323,448,1235,3,5190778769,In > Out
Sept 2021,70,4,936,527430002,4576737984,5104167986,281,916,7,4049307982,In > Out
Sept 2021,70,40,747,131572812,3921754313,4053327125,338,723,4,3790181501,In > Out
Sept 2021,70,43,314,123322318,881574581,1004896899,161,312,2,758252263,In > Out
Sept 2021,70,44,2596,699142429,7786826300,8485968729,289,2469,12,7087683871,In > Out
Sept 2021,70,47,1334,417211910,18382058269,18799270179,238,1272,3,17964846359,In > Out
Sept 2021,70,51,1115,163296468,4833360202,4996656670,258,1098,6,4670063734,In > Out
Sept 2021,70,54,1045,1961340705,5078989652,7040330357,265,1030,10,3117648947,In > Out
Sept 2021,70,56,3033,411316040,8027595153,8438911193,406,2785,5,7616279113,In > Out
Sept 2021,70,58,1224,360203441,10161863588,10522067029,237,1171,5,9801660147,In > Out
Sept 2021,70,59,397,567010792,3525980374,4092991166,158,393,11,2958969582,In > Out
Sept 2021,70,6,651,192772530,2134922758,2327695288,213,640,7,1942150228,In > Out
Sept 2021,70,61,1603,2315154477,9656429222,11971583699,393,1558,23,7341274745,In > Out
Sept 2021,70,62,1479,357359233,4733216632,5090575865,294,1396,6,4375857399,In > Out
Sept 2021,70,64,726,78448706,3585445127,3663893833,184,713,4,3506996421,In > Out
Sept 2021,70,66,518,417494506,11411390408,11828884914,211,517,6,10993895902,In > Out
Sept 2021,70,67,3127,634406652,7696885182,8331291834,490,2964,34,7062478530,In > Out
Sept 2021,70,68,328,228903170,1404105878,1633009048,166,324,5,1175202708,In > Out
Sept 2021,70,7,467,94886387,1348116424,1443002811,160,461,7,1253230037,In > Out
Sept 2021,70,70,969,436211884,4537644912,4973856796,332,934,9,4101433028,In > Out
Sept 2021,70,72,677,106651154,8323162179,8429813333,255,662,5,8216511025,In > Out
Sept 2021,70,74,471,1189030542,2055957750,3244988292,120,468,8,866927208,In > Out
Sept 2021,70,75,1008,1202728693,4553021984,5755750677,334,963,7,3350293291,In > Out
Sept 2021,70,76,727,160474920,2093365519,2253840439,224,724,6,1932890599,In > Out
Sept 2021,70,77,852,1001972619,3003895468,4005868087,246,822,4,2001922849,In > Out
Sept 2021,70,83,1006,186627526,4405082634,4591710160,327,989,3,4218455108,In > Out
Sept 2021,70,85,753,2058862145,6778204890,8837067035,277,741,8,4719342745,In > Out
Sept 2021,70,89,1312,258572699,8444233215,8702805914,357,1260,10,8185660516,In > Out
Sept 2021,70,91,445,265409688,2562388576,2827798264,199,442,8,2296978888,In > Out
Sept 2021,70,92,367,329822893,735180775,1065003668,137,361,4,405357882,In > Out
Sept 2021,70,95,374,110053488,2125698724,2235752212,155,369,6,2015645236,In > Out
Sept 2021,70,96,787,170556605,2849146052,3019702657,246,777,5,2678589447,In > Out
Sept 2021,73,101,68,24134193,1804145371,1828279564,23,68,2,1780011178,In > Out
Sept 2021,73,105,1703,554097457,2708110374,3262207831,191,1652,6,2154012917,In > Out
Sept 2021,73,106,385,21755792,2618724043,2640479835,49,382,2,2596968251,In > Out
Sept 2021,73,107,1041,111101415,1788982059,1900083474,268,1003,2,1677880644,In > Out
Sept 2021,73,108,942,74050385,945038819,1019089204,363,917,3,870988434,In > Out
Sept 2021,73,109,1124,182421690,2616202008,2798623698,129,1094,2,2433780318,In > Out
Sept 2021,73,11,1010,272473402,16235292501,16507765903,32,995,9,15962819099,In > Out
Sept 2021,73,111,2459,225721869,6092859131,6318581000,630,2288,2,5867137262,In > Out
Sept 2021,73,113,539,44231238,3025466490,3069697728,56,539,2,2981235252,In > Out
Sept 2021,73,115,1219,54406511,3789237415,3843643926,151,1179,2,3734830904,In > Out
Sept 2021,73,117,4182,558904868,7470666014,8029570882,628,3799,5,6911761146,In > Out
Sept 2021,73,12,25,1478694,29058779,30537473,13,25,2,27580085,In > Out
Sept 2021,73,120,3404,2335654180,6644446899,8980101079,357,3131,4,4308792719,In > Out
Sept 2021,73,121,718,355528564,3694420518,4049949082,257,706,3,3338891954,In > Out
Sept 2021,73,127,2436,304474779,4709008020,5013482799,510,2237,3,4404533241,In > Out
Sept 2021,73,130,1815,255641725,3308085309,3563727034,250,1712,5,3052443584,In > Out
Sept 2021,73,132,106,44077727,2416403492,2460481219,29,106,2,2372325765,In > Out
Sept 2021,73,134,264,21504684,1018513320,1040018004,103,264,2,997008636,In > Out
Sept 2021,73,138,1981,230207112,8143060925,8373268037,344,1863,3,7912853813,In > Out
Sept 2021,73,139,2878,165724374,4082696708,4248421082,222,2639,2,3916972334,In > Out
Sept 2021,73,14,15,2006688,236186557,238193245,8,15,2,234179869,In > Out
Sept 2021,73,142,26,1218632,56347735,57566367,11,26,2,55129103,In > Out
Sept 2021,73,143,1655,153831824,3940699991,4094531815,346,1586,3,3786868167,In > Out
Sept 2021,73,144,454,35137582,4108017382,4143154964,76,454,2,4072879800,In > Out
Sept 2021,73,145,1098,173047830,2276137910,2449185740,69,1012,2,2103090080,In > Out
Sept 2021,73,157,42,10200961,7093097,17294058,9,9,35,3107864,Out > In
Sept 2021,73,16,560,87325538,1886609132,1973934670,62,556,2,1799283594,In > Out
Sept 2021,73,160,13,2793807,3463007,6256814,8,13,1,669200,In > Out
Sept 2021,73,163,592,97088612,3086090930,3183179542,130,589,2,2989002318,In > Out
Sept 2021,73,166,209,10869571,410977776,421847347,22,209,2,400108205,In > Out
Sept 2021,73,169,3491,1562764949,7079233171,8641998120,350,3116,4,5516468222,In > Out
Sept 2021,73,17,735,56995754,2357318605,2414314359,97,735,3,2300322851,In > Out
Sept 2021,73,170,33,467313,16677633,17144946,17,33,1,16210320,In > Out
Sept 2021,73,172,2805,510929273,9368950778,9879880051,486,2595,4,8858021505,In > Out
Sept 2021,73,181,40631,35870938245,100161692449,136032630694,3064,16517,24,64290754204,In > Out
Sept 2021,73,182,2,397527,162743,560270,1,2,1,234784,Out > In
Sept 2021,73,187,1292,404748482,2765103134,3169851616,125,1253,4,2360354652,In > Out
Sept 2021,73,189,1,6574,184219,190793,1,1,1,177645,In > Out
Sept 2021,73,193,2,397067,165432,562499,1,2,1,231635,Out > In
Sept 2021,73,200,59,7279126,193858651,201137777,23,59,3,186579525,In > Out
Sept 2021,73,206,448,39346849,565865035,605211884,75,439,2,526518186,In > Out
Sept 2021,73,208,1800,464491845,3338661677,3803153522,458,1717,12,2874169832,In > Out
Sept 2021,73,21,7,1142030,482294,1624324,2,7,1,659736,Out > In
Sept 2021,73,215,2946,1615198846,5414999468,7030198314,651,2750,3,3799800622,In > Out
Sept 2021,73,218,61,22688726,1831090616,1853779342,33,61,3,1808401890,In > Out
Sept 2021,73,22,1362,86834141,2962123398,3048957539,243,1310,2,2875289257,In > Out
Sept 2021,73,23,30,24220454,1453191568,1477412022,15,30,2,1428971114,In > Out
Sept 2021,73,237,1,63890,45723,109613,1,1,1,18167,Out > In
Sept 2021,73,244,19,788580,51644112,52432692,16,19,2,50855532,In > Out
Sept 2021,73,245,94,3946732,123930517,127877249,21,94,1,119983785,In > Out
Sept 2021,73,25,1159,285156249,4535719914,4820876163,358,1107,3,4250563665,In > Out
Sept 2021,73,27,1012,100500551,3014358910,3114859461,87,978,4,2913858359,In > Out
Sept 2021,73,28,438,38225976,382381588,420607564,33,437,2,344155612,In > Out
Sept 2021,73,29,6,312544,347951,660495,2,6,1,35407,In > Out
Sept 2021,73,3,1,217988,21682,239670,1,1,1,196306,Out > In
Sept 2021,73,30,1021,105586515,3222735207,3328321722,193,985,4,3117148692,In > Out
Sept 2021,73,31,310,146784023,3357810256,3504594279,55,301,3,3211026233,In > Out
Sept 2021,73,32,38,18194807,971039953,989234760,19,38,2,952845146,In > Out
Sept 2021,73,33,144,25201273,1242392427,1267593700,42,144,2,1217191154,In > Out
Sept 2021,73,38,656,210016930,4143190974,4353207904,165,650,4,3933174044,In > Out
Sept 2021,73,39,856,125173025,4507820573,4632993598,225,827,2,4382647548,In > Out
Sept 2021,73,4,16,34418048,1785910234,1820328282,4,16,2,1751492186,In > Out
Sept 2021,73,41,375,39344799,2556863014,2596207813,86,373,2,2517518215,In > Out
Sept 2021,73,42,496,181177904,2477756815,2658934719,165,486,3,2296578911,In > Out
Sept 2021,73,45,1913,232260879,3858092511,4090353390,278,1782,4,3625831632,In > Out
Sept 2021,73,47,1700,269536942,4878805424,5148342366,563,1609,3,4609268482,In > Out
Sept 2021,73,48,823,115085444,4837266175,4952351619,161,818,2,4722180731,In > Out
Sept 2021,73,5,433,78005066,1353259183,1431264249,24,427,2,1275254117,In > Out
Sept 2021,73,53,114,31350892,2594153931,2625504823,35,113,2,2562803039,In > Out
Sept 2021,73,55,122,33408077,2088046998,2121455075,28,122,2,2054638921,In > Out
Sept 2021,73,56,858,437968011,3692073592,4130041603,214,831,3,3254105581,In > Out
Sept 2021,73,57,18,2401003,92761699,95162702,9,18,2,90360696,In > Out
Sept 2021,73,58,5875,1018617886,6269196237,7287814123,444,4908,5,5250578351,In > Out
Sept 2021,73,59,1210,270133589,5112643355,5382776944,292,1166,4,4842509766,In > Out
Sept 2021,73,6,143,88582358,1461122792,1549705150,42,142,2,1372540434,In > Out
Sept 2021,73,62,2508,261769446,4623967095,4885736541,292,2340,3,4362197649,In > Out
Sept 2021,73,64,603,56861470,824281371,881142841,167,597,3,767419901,In > Out
Sept 2021,73,69,1330,88617610,5411597235,5500214845,12,1270,2,5322979625,In > Out
Sept 2021,73,70,1612,537864957,4419874682,4957739639,358,1548,4,3882009725,In > Out
Sept 2021,73,72,2024,460651040,5557897048,6018548088,444,1933,6,5097246008,In > Out
Sept 2021,73,76,1042,389618774,3919190589,4308809363,160,1011,3,3529571815,In > Out
Sept 2021,73,78,1599,266788939,4198291650,4465080589,222,1531,4,3931502711,In > Out
Sept 2021,73,79,4921,2018568925,7172204328,9190773253,356,4321,4,5153635403,In > Out
Sept 2021,73,80,11797,1426285553,8245919342,9672204895,466,8355,4,6819633789,In > Out
Sept 2021,73,82,264,9913911,861971233,871885144,56,264,2,852057322,In > Out
Sept 2021,73,83,1366,387035764,11570870541,11957906305,226,1300,2,11183834777,In > Out
Sept 2021,73,86,730,80598451,6374264747,6454863198,160,710,2,6293666296,In > Out
Sept 2021,73,89,128,17130776,1658737958,1675868734,40,128,2,1641607182,In > Out
Sept 2021,73,9,1,2425,107942,110367,1,1,1,105517,In > Out
Sept 2021,73,90,674,46847147,2777512807,2824359954,106,665,3,2730665660,In > Out
Sept 2021,73,91,3686,384628996,8141000814,8525629810,123,3319,3,7756371818,In > Out
Sept 2021,73,94,3,402460,440424,842884,2,3,1,37964,In > Out
Sept 2021,73,96,127,37626515,1958964222,1996590737,27,127,2,1921337707,In > Out
Sept 2021,73,98,122,100482494,3632200524,3732683018,34,122,2,3531718030,In > Out
Sept 2021,73,99,18862,1527711456,80247564530,81775275986,1008,11180,5,78719853074,In > Out
Sept 2021,74,10,1906,145845792,1202419075,1348264867,489,1815,2,1056573283,In > Out
Sept 2021,74,104,8,256769,12647475,12904244,6,8,2,12390706,In > Out
Sept 2021,74,106,32,17196922,97334443,114531365,17,32,2,80137521,In > Out
Sept 2021,74,108,954,268583649,1459268703,1727852352,130,937,3,1190685054,In > Out
Sept 2021,74,113,141,19750485,721142783,740893268,42,141,2,701392298,In > Out
Sept 2021,74,115,543,318300850,732073398,1050374248,181,543,5,413772548,In > Out
Sept 2021,74,116,4725,12887983616,15435020398,28323004014,233,4159,4,2547036782,In > Out
Sept 2021,74,117,233,43482839,186819933,230302772,90,229,2,143337094,In > Out
Sept 2021,74,12,128,2624563,77206250,79830813,43,127,3,74581687,In > Out
Sept 2021,74,121,941,109342366,2954199361,3063541727,63,937,2,2844856995,In > Out
Sept 2021,74,125,1,6037,146128,152165,1,1,1,140091,In > Out
Sept 2021,74,126,112,4351567,44380555,48732122,8,112,2,40028988,In > Out
Sept 2021,74,127,1440,274587723,1410950337,1685538060,69,1368,2,1136362614,In > Out
Sept 2021,74,135,39,2646419,108122674,110769093,10,39,2,105476255,In > Out
Sept 2021,74,14,114,38309043,4809098348,4847407391,40,113,2,4770789305,In > Out
Sept 2021,74,142,67,8462112,34367461,42829573,25,67,2,25905349,In > Out
Sept 2021,74,143,1115,289195198,1615429446,1904624644,181,1082,3,1326234248,In > Out
Sept 2021,74,149,34,6977948,309267855,316245803,14,34,2,302289907,In > Out
Sept 2021,74,152,636,236600557,4187312769,4423913326,172,633,4,3950712212,In > Out
Sept 2021,74,154,1,7463092,3077068,10540160,1,1,1,4386024,Out > In
Sept 2021,74,156,1,268480,17100445,17368925,1,1,1,16831965,In > Out
Sept 2021,74,163,17,1841563,160128409,161969972,4,17,2,158286846,In > Out
Sept 2021,74,167,345,61488732,405663207,467151939,69,341,2,344174475,In > Out
Sept 2021,74,169,1988,512615490,2405693602,2918309092,203,1884,2,1893078112,In > Out
Sept 2021,74,172,1336,222283009,3952628466,4174911475,478,1285,3,3730345457,In > Out
Sept 2021,74,177,60,1512663,90086984,91599647,18,60,2,88574321,In > Out
Sept 2021,74,178,20,4000857,14453424,18454281,12,14,6,10452567,In > Out
Sept 2021,74,179,981,201647619,854529253,1056176872,71,959,2,652881634,In > Out
Sept 2021,74,180,18,1075277,5761478,6836755,17,18,2,4686201,In > Out
Sept 2021,74,181,42,4077643,395512796,399590439,9,42,2,391435153,In > Out
Sept 2021,74,182,365,81830247,358228745,440058992,70,361,2,276398498,In > Out
Sept 2021,74,185,48,1928909,129993936,131922845,11,48,1,128065027,In > Out
Sept 2021,74,195,553,141825424,3923833887,4065659311,47,553,2,3782008463,In > Out
Sept 2021,74,202,1151,666013744,2543514905,3209528649,321,1105,3,1877501161,In > Out
Sept 2021,74,203,96,13469664,234636387,248106051,36,95,3,221166723,In > Out
Sept 2021,74,204,1329,119222880,7891177248,8010400128,235,1263,3,7771954368,In > Out
Sept 2021,74,207,240,2090875946,981047599,3071923545,90,239,3,1109828347,Out > In
Sept 2021,74,21,1448,783480615,3997260251,4780740866,362,1387,5,3213779636,In > Out
Sept 2021,74,211,1483,97489133,4303131002,4400620135,454,1412,3,4205641869,In > Out
Sept 2021,74,217,638,78220978,3124652330,3202873308,43,631,2,3046431352,In > Out
Sept 2021,74,219,144,8177269,713278249,721455518,55,144,2,705100980,In > Out
Sept 2021,74,221,180,44147172,124394193,168541365,22,180,2,80247021,In > Out
Sept 2021,74,225,1706,182725934,2073994302,2256720236,425,1633,6,1891268368,In > Out
Sept 2021,74,229,3325,420209611,21238867090,21659076701,665,2792,32,20818657479,In > Out
Sept 2021,74,23,54,3095327,115252938,118348265,11,54,2,112157611,In > Out
Sept 2021,74,234,631,32479628,1099962612,1132442240,114,629,4,1067482984,In > Out
Sept 2021,74,237,147,10100349,495931952,506032301,49,146,2,485831603,In > Out
Sept 2021,74,239,1539,181062356,3815212472,3996274828,336,1446,2,3634150116,In > Out
Sept 2021,74,250,1108,451632543,4390394262,4842026805,318,1070,6,3938761719,In > Out
Sept 2021,74,253,942,571566000,2009090876,2580656876,240,914,4,1437524876,In > Out
Sept 2021,74,4,1594,138914938,1713196641,1852111579,399,1517,3,1574281703,In > Out
Sept 2021,74,40,28,576807588,1070686752,1647494340,19,28,4,493879164,In > Out
Sept 2021,74,41,330,57755016,2364493058,2422248074,53,330,2,2306738042,In > Out
Sept 2021,74,44,12,706230,30746718,31452948,6,12,1,30040488,In > Out
Sept 2021,74,45,12,1575625,1878948,3454573,8,9,2,303323,In > Out
Sept 2021,74,52,264,24223076,118526549,142749625,29,264,2,94303473,In > Out
Sept 2021,74,57,5,174871,2934989,3109860,4,5,1,2760118,In > Out
Sept 2021,74,58,412,30235031,1663258155,1693493186,172,411,3,1633023124,In > Out
Sept 2021,74,6,122,7041162,203566016,210607178,49,122,2,196524854,In > Out
Sept 2021,74,65,455,174515695,988450126,1162965821,217,448,5,813934431,In > Out
Sept 2021,74,71,86,10400145,131715547,142115692,56,86,2,121315402,In > Out
Sept 2021,74,75,59,5996430,70147291,76143721,27,59,2,64150861,In > Out
Sept 2021,74,85,4,393842,1764038,2157880,4,4,1,1370196,In > Out
Sept 2021,74,89,45,1579956,48898106,50478062,36,45,1,47318150,In > Out
Sept 2021,74,9,259,24147149,312841899,336989048,100,256,2,288694750,In > Out
Sept 2021,74,91,2227,210055972,3293022553,3503078525,376,2114,4,3082966581,In > Out
Sept 2021,74,93,865,284941667,2243722493,2528664160,195,846,5,1958780826,In > Out
Sept 2021,75,144,1134,41509344,895566725,937076069,76,1091,3,854057381,In > Out
Sept 2021,77,121,18,517737,2087962,2605699,5,3,2,1570225,In > Out
Sept 2021,77,122,493,27867650,79761252,107628902,5,8,2,51893602,In > Out
Sept 2021,77,123,1193,143427160,360214753,503641913,5,7,2,216787593,In > Out
Sept 2021,77,231,2930,988759102,16564923303,17553682405,695,2741,14,15576164201,In > Out
Sept 2021,79,10,7,2173246,191625,2364871,2,7,1,1981621,Out > In
Sept 2021,79,11,24226,12601379460,98185974292,110787353752,73,11976,25,85584594832,In > Out
Sept 2021,79,14,1,276668,221634706,221911374,1,1,1,221358038,In > Out
Sept 2021,79,16,873,172201627362,46378064758,218579692120,56,847,318,125823562604,Out > In
Sept 2021,79,18,4,233075,7916052,8149127,2,4,1,7682977,In > Out
Sept 2021,79,20,5,3881257,685964152,689845409,4,5,1,682082895,In > Out
Sept 2021,79,200,10,22513049,5129350571,5151863620,4,10,2,5106837522,In > Out
Sept 2021,79,201,3,2534563,974974496,977509059,2,3,2,972439933,In > Out
Sept 2021,79,202,9,403607,64801432,65205039,1,9,1,64397825,In > Out
Sept 2021,79,205,34,4753437,727416913,732170350,6,34,2,722663476,In > Out
Sept 2021,79,21,78,8335846,2974193772,2982529618,13,78,1,2965857926,In > Out
Sept 2021,79,30,40,1473438,149922899,151396337,7,40,2,148449461,In > Out
Sept 2021,79,8,10,340959,19139398,19480357,5,10,2,18798439,In > Out
Sept 2021,79,9,3,30097,4053140,4083237,3,3,1,4023043,In > Out
Sept 2021,80,108,1485,286324646,3423231129,3709555775,221,1420,4,3136906483,In > Out
Sept 2021,80,9,2209,593285008,2594164288,3187449296,392,2127,5,2000879280,In > Out
Sept 2021,81,139,1365,3094207596,79021582,3173229178,2,1341,1,3015186014,Out > In
Sept 2021,81,141,14,1196751,19249088,20445839,12,14,2,18052337,In > Out
Sept 2021,81,143,597859,86086446401,186729782465,272816228866,2772,22210,75,100643336064,In > Out
Sept 2021,81,144,4,587749,122216,709965,1,4,1,465533,Out > In
Sept 2021,81,28,7,212432,12906857,13119289,3,7,2,12694425,In > Out
Sept 2021,81,29,3,132224,7956022,8088246,2,3,1,7823798,In > Out
Sept 2021,81,30,66,977215779,29066014,1006281793,5,66,2,948149765,Out > In
Sept 2021,81,31,63,1241563273,42235503,1283798776,3,63,2,1199327770,Out > In
Sept 2021,81,32,2,1383667,207824,1591491,2,2,2,1175843,Out > In
Sept 2021,81,33,5,988826,75740,1064566,1,5,1,913086,Out > In
Sept 2021,81,35,92,22401460,3732937645,3755339105,24,92,2,3710536185,In > Out
Sept 2021,81,45,22,8426146,9076259,17502405,5,22,2,650113,In > Out
Sept 2021,82,10,1178,260825575,2191110655,2451936230,358,1136,6,1930285080,In > Out
Sept 2021,82,11,878,266611448,5215635649,5482247097,140,858,2,4949024201,In > Out
Sept 2021,82,120,952,68004118,491799140,559803258,140,934,2,423795022,In > Out
Sept 2021,82,123,253,16944630,301898879,318843509,118,250,2,284954249,In > Out
Sept 2021,82,127,670,98010448,2639850066,2737860514,228,657,4,2541839618,In > Out
Sept 2021,82,133,32,1150221,23919973,25070194,16,32,2,22769752,In > Out
Sept 2021,82,142,2013,176054165,2458464595,2634518760,471,1898,3,2282410430,In > Out
Sept 2021,82,146,202,11106137,387442173,398548310,59,202,3,376336036,In > Out
Sept 2021,82,150,1346,595694021,5566636293,6162330314,415,1302,33,4970942272,In > Out
Sept 2021,82,151,403,32555690,125154333,157710023,25,396,2,92598643,In > Out
Sept 2021,82,162,1079,126739758,1334634283,1461374041,139,1070,3,1207894525,In > Out
Sept 2021,82,208,1,6752,271208,277960,1,1,1,264456,In > Out
Sept 2021,82,231,5,159612,6913529,7073141,3,5,2,6753917,In > Out
Sept 2021,82,239,38,3860582,43861322,47721904,9,38,1,40000740,In > Out
Sept 2021,82,241,2,112337,4414361,4526698,2,2,1,4302024,In > Out
Sept 2021,82,39,28,2459674,21548803,24008477,17,28,1,19089129,In > Out
Sept 2021,82,44,84,3453727,23993819,27447546,28,84,3,20540092,In > Out
Sept 2021,82,50,596,88759303,835977878,924737181,192,587,2,747218575,In > Out
Sept 2021,82,53,345,40479424,376608356,417087780,36,337,2,336128932,In > Out
Sept 2021,82,58,28,354150,29424970,29779120,7,28,3,29070820,In > Out
Sept 2021,82,62,14,617192,131320807,131937999,3,14,1,130703615,In > Out
Sept 2021,82,81,987,376487402,3663772782,4040260184,282,965,4,3287285380,In > Out
Sept 2021,82,82,12,1394181,7683859,9078040,8,12,2,6289678,In > Out
Sept 2021,82,92,2316,4251154558,11032672120,15283826678,410,2224,9,6781517562,In > Out
Sept 2021,82,97,5,284918,1139942,1424860,5,5,2,855024,In > Out
Sept 2021,82,99,1,4799,126284,131083,1,1,1,121485,In > Out
Sept 2021,83,113,481,45311843,995698375,1041010218,184,478,2,950386532,In > Out
Sept 2021,83,116,77,6246461,516344371,522590832,42,77,2,510097910,In > Out
Sept 2021,83,121,11,2853048,36984494,39837542,10,11,2,34131446,In > Out
Sept 2021,83,125,1235,82728269,1816778585,1899506854,398,1119,2,1734050316,In > Out
Sept 2021,83,145,322,16600034,352228740,368828774,142,320,2,335628706,In > Out
Sept 2021,83,147,62,9120907,387911630,397032537,32,62,2,378790723,In > Out
Sept 2021,83,149,937,193085227,2187504486,2380589713,216,912,4,1994419259,In > Out
Sept 2021,83,150,682,65790980,682934636,748725616,214,672,2,617143656,In > Out
Sept 2021,83,152,624,59837038,919349723,979186761,224,615,2,859512685,In > Out
Sept 2021,83,153,1430,153610384,2145988517,2299598901,551,1375,3,1992378133,In > Out
Sept 2021,83,154,1348,89703634,3459824973,3549528607,425,1307,2,3370121339,In > Out
Sept 2021,83,157,393,54803006,641359114,696162120,145,392,2,586556108,In > Out
Sept 2021,83,158,1168,301869389,11453660821,11755530210,358,1127,2,11151791432,In > Out
Sept 2021,83,161,293,68188720,1150418329,1218607049,130,293,2,1082229609,In > Out
Sept 2021,83,162,630,77613748,1944734200,2022347948,243,600,3,1867120452,In > Out
Sept 2021,83,167,1125,215307115,2998887919,3214195034,278,1077,5,2783580804,In > Out
Sept 2021,83,226,1638,8369121262,3350043058,11719164320,327,1618,6,5019078204,Out > In
Sept 2021,83,35,1272,146821349,1655287155,1802108504,480,1240,5,1508465806,In > Out
Sept 2021,83,36,1311,142882081,1011263397,1154145478,410,1259,2,868381316,In > Out
Sept 2021,83,39,2960,1124460280,7457548559,8582008839,646,2731,93,6333088279,In > Out
Sept 2021,84,38,1935,627435571,12159878046,12787313617,329,1825,4,11532442475,In > Out
Sept 2021,84,41,1130,68918076,2212522768,2281440844,279,1100,3,2143604692,In > Out
Sept 2021,85,100,9,857344,12484208,13341552,7,9,1,11626864,In > Out
Sept 2021,85,101,1894,1261212284,7049493415,8310705699,410,1853,4,5788281131,In > Out
Sept 2021,85,102,1032,50692690,1918502921,1969195611,208,996,2,1867810231,In > Out
Sept 2021,85,103,52,2227219,22980617,25207836,25,52,3,20753398,In > Out
Sept 2021,85,104,38,6228464,38835001,45063465,25,38,2,32606537,In > Out
Sept 2021,85,105,741,779099027,2176671210,2955770237,268,724,3,1397572183,In > Out
Sept 2021,85,106,63,1823450,50137105,51960555,33,63,2,48313655,In > Out
Sept 2021,85,107,257,40878719,174987962,215866681,131,257,4,134109243,In > Out
Sept 2021,85,108,1080,297271948,1659006735,1956278683,253,1063,4,1361734787,In > Out
Sept 2021,85,109,23,1824587,61237926,63062513,11,23,2,59413339,In > Out
Sept 2021,85,110,359,89358678,423410324,512769002,83,356,2,334051646,In > Out
Sept 2021,85,111,3,124220,8371900,8496120,2,3,2,8247680,In > Out
Sept 2021,85,112,436,65666387,484509631,550176018,211,430,3,418843244,In > Out
Sept 2021,85,113,982,73223375,589764179,662987554,296,952,2,516540804,In > Out
Sept 2021,85,114,138,24004161,164866453,188870614,46,138,7,140862292,In > Out
Sept 2021,85,115,355,276392101,251228243,527620344,134,353,4,25163858,Out > In
Sept 2021,85,116,141,10392520,344414239,354806759,27,141,2,334021719,In > Out
Sept 2021,85,117,300,38231464,337965778,376197242,141,298,2,299734314,In > Out
Sept 2021,85,118,117,12942421,240815341,253757762,50,117,2,227872920,In > Out
Sept 2021,85,119,8,309215,10190632,10499847,7,8,2,9881417,In > Out
Sept 2021,85,120,31,1186105047,1048374781,2234479828,21,31,3,137730266,Out > In
Sept 2021,85,121,244,272722441,1566605704,1839328145,118,242,4,1293883263,In > Out
Sept 2021,85,122,554,194717765,957202430,1151920195,215,546,3,762484665,In > Out
Sept 2021,85,123,24,2216608,17384954,19601562,13,24,1,15168346,In > Out
Sept 2021,85,125,390,29581108,390149855,419730963,127,385,2,360568747,In > Out
Sept 2021,85,126,4535,5861897222,13698643435,19560540657,476,3965,6,7836746213,In > Out
Sept 2021,85,128,76,10988491,195211459,206199950,59,76,2,184222968,In > Out
Sept 2021,85,129,115,368907268,385999075,754906343,59,114,3,17091807,In > Out
Sept 2021,85,130,275,48693435,182411272,231104707,111,272,2,133717837,In > Out
Sept 2021,85,131,340,53310672,2347327681,2400638353,75,337,2,2294017009,In > Out
Sept 2021,85,132,784,1118242615,2197363746,3315606361,244,769,7,1079121131,In > Out
Sept 2021,85,133,77,12315900,455253955,467569855,41,77,2,442938055,In > Out
Sept 2021,85,134,824,2154614776,1618989235,3773604011,340,809,4,535625541,Out > In
Sept 2021,85,135,380,48222169,669708622,717930791,137,376,2,621486453,In > Out
Sept 2021,85,136,4,456078,31719709,32175787,4,4,2,31263631,In > Out
Sept 2021,85,137,160,22421585,383485839,405907424,88,158,2,361064254,In > Out
Sept 2021,85,138,1691,332687644,1770874032,2103561676,422,1618,4,1438186388,In > Out
Sept 2021,85,139,224,31762163,743519475,775281638,120,223,2,711757312,In > Out
Sept 2021,85,140,615,57608239,948410821,1006019060,194,610,2,890802582,In > Out
Sept 2021,85,141,407,128374668,892349925,1020724593,175,403,4,763975257,In > Out
Sept 2021,85,142,605,2737146439,5772542523,8509688962,267,595,5,3035396084,In > Out
Sept 2021,85,143,351,189928809,567007493,756936302,153,347,3,377078684,In > Out
Sept 2021,85,144,68,102956303,151871500,254827803,40,66,5,48915197,In > Out
Sept 2021,85,145,127,416638484,71664321,488302805,73,127,1,344974163,Out > In
Sept 2021,85,146,50,3424399,33218942,36643341,19,49,2,29794543,In > Out
Sept 2021,85,147,64,357865874,857880236,1215746110,43,63,3,500014362,In > Out
Sept 2021,85,148,131,21711362,1237679287,1259390649,28,131,2,1215967925,In > Out
Sept 2021,85,149,201,146257793,385809749,532067542,97,201,4,239551956,In > Out
Sept 2021,85,15,32,4168551,71301848,75470399,20,32,2,67133297,In > Out
Sept 2021,85,150,84,294655925,293206078,587862003,37,82,3,1449847,Out > In
Sept 2021,85,151,167,9774071,607174368,616948439,32,166,2,597400297,In > Out
Sept 2021,85,152,178,23830785,75425772,99256557,48,177,1,51594987,In > Out
Sept 2021,85,154,579,73810683,6234931345,6308742028,95,576,2,6161120662,In > Out
Sept 2021,85,155,567,6059926,1993267763,1999327689,59,563,2,1987207837,In > Out
Sept 2021,85,156,7,191381,13478505,13669886,4,7,1,13287124,In > Out
Sept 2021,85,157,231,19049372,332147252,351196624,115,231,2,313097880,In > Out
Sept 2021,85,16,19,2075441252,422693876,2498135128,14,1,3,1652747376,Out > In
Sept 2021,85,170,415,30865369,2088412711,2119278080,101,414,2,2057547342,In > Out
Sept 2021,85,23,50,2602716,61131723,63734439,27,50,2,58529007,In > Out
Sept 2021,85,24,7,240372,8210394,8450766,3,7,2,7970022,In > Out
Sept 2021,85,28,264,13135272,193223921,206359193,135,263,2,180088649,In > Out
Sept 2021,85,31,6,313633,348597,662230,2,6,1,34964,In > Out
Sept 2021,85,48,343,117558293,171067152,288625445,34,340,2,53508859,In > Out
Sept 2021,85,49,4,160214,457045,617259,4,4,2,296831,In > Out
Sept 2021,85,5,6,13820575,1072080019,1085900594,2,6,1,1058259444,In > Out
Sept 2021,85,51,335,23183201,1626532589,1649715790,83,335,2,1603349388,In > Out
Sept 2021,85,52,124,14044844,125620005,139664849,31,124,2,111575161,In > Out
Sept 2021,85,53,356,33177020,1243445254,1276622274,94,354,2,1210268234,In > Out
Sept 2021,85,54,1087,115595559,506448513,622044072,172,1053,2,390852954,In > Out
Sept 2021,85,55,407,51654128,263847966,315502094,156,403,3,212193838,In > Out
Sept 2021,85,57,751,65685348,2264096277,2329781625,232,734,2,2198410929,In > Out
Sept 2021,85,59,33,2433017,16096335,18529352,14,33,2,13663318,In > Out
Sept 2021,85,6,453,38318326,1221178434,1259496760,50,448,2,1182860108,In > Out
Sept 2021,85,60,115,23920256,243505214,267425470,52,115,2,219584958,In > Out
Sept 2021,85,61,34,6307209,81061219,87368428,13,34,2,74754010,In > Out
Sept 2021,85,62,24,8694482,63213041,71907523,9,24,2,54518559,In > Out
Sept 2021,85,63,33,978894,23244270,24223164,16,33,2,22265376,In > Out
Sept 2021,85,64,24,1706782,81156225,82863007,12,24,2,79449443,In > Out
Sept 2021,85,65,209,4439594,71277213,75716807,89,206,2,66837619,In > Out
Sept 2021,85,66,313,11469584,185479432,196949016,134,306,2,174009848,In > Out
Sept 2021,85,67,72,11369444,45604551,56973995,37,72,2,34235107,In > Out
Sept 2021,85,69,3,90300,6710792,6801092,3,3,2,6620492,In > Out
Sept 2021,85,75,910,73272789,1376061224,1449334013,302,881,2,1302788435,In > Out
Sept 2021,85,77,197,54673470,251802463,306475933,85,196,2,197128993,In > Out
Sept 2021,85,78,9,15741279,44801045,60542324,4,9,2,29059766,In > Out
Sept 2021,85,79,30,1111019,20607350,21718369,13,30,2,19496331,In > Out
Sept 2021,85,81,65,4041213,182760480,186801693,37,65,2,178719267,In > Out
Sept 2021,85,82,11,437290,16226276,16663566,4,11,2,15788986,In > Out
Sept 2021,85,83,19,2152472,27513800,29666272,6,19,2,25361328,In > Out
Sept 2021,85,84,16,5094349,19619716,24714065,6,16,2,14525367,In > Out
Sept 2021,85,85,11,199586,11264385,11463971,6,11,2,11064799,In > Out
Sept 2021,85,86,7,76989,1594538,1671527,4,7,2,1517549,In > Out
Sept 2021,85,87,7,259098,919399,1178497,4,7,2,660301,In > Out
Sept 2021,85,93,9,33584,1342635,1376219,4,9,1,1309051,In > Out
Sept 2021,86,198,2,8009,204469,212478,1,2,1,196460,In > Out
Sept 2021,88,28,434,6967294,106875806,113843100,2,434,1,99908512,In > Out
Sept 2021,89,100,303,12342026,427335604,439677630,41,301,2,414993578,In > Out
Sept 2021,89,104,159,474567401,572420626,1046988027,46,158,2,97853225,In > Out
Sept 2021,89,106,399,46927079,39136554,86063633,18,391,2,7790525,Out > In
Sept 2021,89,107,772,113730948,822266604,935997552,96,759,2,708535656,In > Out
Sept 2021,89,108,5,62770,2371302,2434072,5,5,2,2308532,In > Out
Sept 2021,89,110,189,14678175,1178488886,1193167061,95,189,2,1163810711,In > Out
Sept 2021,89,111,895,20808532,2344896886,2365705418,66,871,2,2324088354,In > Out
Sept 2021,89,121,95,10329361,189374413,199703774,15,95,2,179045052,In > Out
Sept 2021,89,127,641,115827887,384077192,499905079,44,629,2,268249305,In > Out
Sept 2021,89,131,824,346757205,1821314024,2168071229,175,801,3,1474556819,In > Out
Sept 2021,89,136,343,22641213,1115178333,1137819546,128,340,3,1092537120,In > Out
Sept 2021,89,14,1,58433658,295748,58729406,1,1,1,58137910,Out > In
Sept 2021,89,140,5,259455,7849785,8109240,5,5,2,7590330,In > Out
Sept 2021,89,141,770,437627103,1606617890,2044244993,307,748,3,1168990787,In > Out
Sept 2021,89,20,13,70101,5893207,5963308,5,13,1,5823106,In > Out
Sept 2021,89,21,12,68882,6039128,6108010,4,12,1,5970246,In > Out
Sept 2021,89,5,34,3722822,22401703,26124525,11,33,2,18678881,In > Out
Sept 2021,89,50,144,14980162,203786053,218766215,14,124,2,188805891,In > Out
Sept 2021,89,51,544,3053648131,2654974807,5708622938,205,533,5,398673324,Out > In
Sept 2021,89,52,12,253381,14463045,14716426,5,12,2,14209664,In > Out
Sept 2021,89,56,428,73551701,709829197,783380898,69,425,3,636277496,In > Out
Sept 2021,89,60,1759,282309526,1586391608,1868701134,165,1674,4,1304082082,In > Out
Sept 2021,89,61,31,4929440,847331,5776771,8,31,1,4082109,Out > In
Sept 2021,89,62,520,170440706,528453704,698894410,92,515,3,358012998,In > Out
Sept 2021,89,63,1204,188130808,4531736309,4719867117,330,1160,2,4343605501,In > Out
Sept 2021,89,64,218,973637187,873065545,1846702732,117,218,4,100571642,Out > In
Sept 2021,89,65,926,74840555,6286491353,6361331908,131,898,2,6211650798,In > Out
Sept 2021,89,66,2015,533968098,7846195009,8380163107,372,1935,4,7312226911,In > Out
Sept 2021,89,67,330,50998743,34517551,85516294,19,330,2,16481192,Out > In
Sept 2021,89,69,2,660866,39062288,39723154,1,2,1,38401422,In > Out
Sept 2021,89,70,29,593896,24033584,24627480,18,29,2,23439688,In > Out
Sept 2021,89,72,180,22232332,29042304,51274636,19,180,2,6809972,In > Out
Sept 2021,89,73,359,21746976,1901098992,1922845968,41,356,2,1879352016,In > Out
Sept 2021,89,76,947,65523807,1241988730,1307512537,280,919,2,1176464923,In > Out
Sept 2021,89,77,441,11225658,971288392,982514050,56,438,2,960062734,In > Out
Sept 2021,89,79,1999,2249462790,938267674,3187730464,290,1862,2,1311195116,Out > In
Sept 2021,89,80,1173,1603421476,4341274545,5944696021,301,1126,5,2737853069,In > Out
Sept 2021,89,81,655,36067454,750611255,786678709,195,640,2,714543801,In > Out
Sept 2021,89,82,1387,162883532,2270381148,2433264680,434,1331,4,2107497616,In > Out
Sept 2021,89,83,40,2391907,347448424,349840331,18,40,2,345056517,In > Out
Sept 2021,89,84,1385,244074452,390292095,634366547,167,1343,3,146217643,In > Out
Sept 2021,89,85,197,1233121,152009902,153243023,25,197,2,150776781,In > Out
Sept 2021,89,88,36,12219409,306149570,318368979,15,36,2,293930161,In > Out
Sept 2021,89,93,2,3196,254972,258168,2,2,1,251776,In > Out
Sept 2021,89,94,2512,467633259,3376823499,3844456758,380,2323,2,2909190240,In > Out
Sept 2021,89,96,897,127003539,694691244,821694783,140,880,2,567687705,In > Out
Sept 2021,89,98,298,48805487,531337362,580142849,39,296,3,482531875,In > Out
Sept 2021,9,100,593,70953595,35577888,106531483,24,589,2,35375707,Out > In
Sept 2021,9,153,109,162048738,3989087955,4151136693,33,107,2,3827039217,In > Out
Sept 2021,9,156,108,5771259,59532984,65304243,25,108,2,53761725,In > Out
Sept 2021,9,158,317,8341109,689879520,698220629,31,314,2,681538411,In > Out
Sept 2021,9,162,717,120134046,3001720123,3121854169,43,715,2,2881586077,In > Out
Sept 2021,9,51,915,95514178,2419290572,2514804750,65,879,2,2323776394,In > Out
Sept 2021,9,52,679,16491020,1920556442,1937047462,70,679,2,1904065422,In > Out
Sept 2021,9,53,195,8609760,226070252,234680012,80,194,2,217460492,In > Out
Sept 2021,9,54,32,2324729,136647378,138972107,9,32,2,134322649,In > Out
Sept 2021,9,56,32,13714680,670226823,683941503,12,32,1,656512143,In > Out
Sept 2021,9,57,803,216385286,4913309436,5129694722,56,791,2,4696924150,In > Out
Sept 2021,9,59,54,10004358,559653937,569658295,21,54,2,549649579,In > Out
Sept 2021,9,62,7,1593053,247899,1840952,6,7,2,1345154,Out > In
Sept 2021,90,100,32,7805873,239560936,247366809,19,32,2,231755063,In > Out
Sept 2021,90,102,16,1716126,66380904,68097030,11,16,2,64664778,In > Out
Sept 2021,90,104,20,5745586,11821312,17566898,13,20,2,6075726,In > Out
Sept 2021,90,106,40,105851240,5931470293,6037321533,15,40,2,5825619053,In > Out
Sept 2021,90,11,965,127375993,1232607337,1359983330,359,935,4,1105231344,In > Out
Sept 2021,90,112,311,84073312,3723056712,3807130024,141,310,2,3638983400,In > Out
Sept 2021,90,117,133,17167263,901650127,918817390,43,132,2,884482864,In > Out
Sept 2021,90,119,721,168002392,11238683198,11406685590,244,707,4,11070680806,In > Out
Sept 2021,90,120,3,342874,16311646,16654520,3,3,1,15968772,In > Out
Sept 2021,90,121,279,51112943,781111416,832224359,103,267,4,729998473,In > Out
Sept 2021,90,124,4,155348,4643796,4799144,2,4,1,4488448,In > Out
Sept 2021,90,125,254,366431283,6445836631,6812267914,124,251,5,6079405348,In > Out
Sept 2021,90,126,81,18247740,805378968,823626708,37,81,2,787131228,In > Out
Sept 2021,90,127,8,434044,91228479,91662523,4,8,2,90794435,In > Out
Sept 2021,90,133,8,592077,1777611,2369688,4,8,1,1185534,In > Out
Sept 2021,90,135,6,157164,831791,988955,6,6,2,674627,In > Out
Sept 2021,90,136,5,2743556,181409882,184153438,4,5,2,178666326,In > Out
Sept 2021,90,138,24,2299924,87203853,89503777,17,24,2,84903929,In > Out
Sept 2021,90,14,774,100208567,1963060314,2063268881,156,752,2,1862851747,In > Out
Sept 2021,90,143,131,12661641,631887002,644548643,65,131,2,619225361,In > Out
Sept 2021,90,149,91,15252008,180380306,195632314,42,91,3,165128298,In > Out
Sept 2021,90,150,148,40002698,700031753,740034451,60,148,3,660029055,In > Out
Sept 2021,90,152,8,2464561,78803986,81268547,7,8,2,76339425,In > Out
Sept 2021,90,153,106,562544822,357877873,920422695,54,106,3,204666949,Out > In
Sept 2021,90,154,572,71919574,1493830052,1565749626,200,564,2,1421910478,In > Out
Sept 2021,90,157,1428,152822069,5817493226,5970315295,145,1372,2,5664671157,In > Out
Sept 2021,90,158,115,535792921,1648931920,2184724841,56,115,4,1113138999,In > Out
Sept 2021,90,159,643,52745183,899788670,952533853,201,635,3,847043487,In > Out
Sept 2021,90,16,1641,209722833,983946384,1193669217,166,1551,2,774223551,In > Out
Sept 2021,90,160,32,3956929,124434902,128391831,6,32,2,120477973,In > Out
Sept 2021,90,165,1028,826295906,3015877181,3842173087,384,987,6,2189581275,In > Out
Sept 2021,90,167,425,80394584,1350835904,1431230488,158,418,5,1270441320,In > Out
Sept 2021,90,17,324,38466046,1243100783,1281566829,51,323,2,1204634737,In > Out
Sept 2021,90,170,86,9774051,47044036,56818087,47,85,2,37269985,In > Out
Sept 2021,90,182,37,2812670,3536476,6349146,16,37,1,723806,In > Out
Sept 2021,90,183,282,147417777,300251416,447669193,11,280,2,152833639,In > Out
Sept 2021,90,184,1,180682,17831,198513,1,1,1,162851,Out > In
Sept 2021,90,185,449,83672412,1254190410,1337862822,172,443,2,1170517998,In > Out
Sept 2021,90,186,1,124014,9444,133458,1,1,1,114570,Out > In
Sept 2021,90,189,76,7226005,193254443,200480448,42,76,2,186028438,In > Out
Sept 2021,90,190,1,36093,72386,108479,1,1,1,36293,In > Out
Sept 2021,90,22,138,10492428,57416420,67908848,82,138,2,46923992,In > Out
Sept 2021,90,220,100,19037315,43180941,62218256,21,100,2,24143626,In > Out
Sept 2021,90,23,1039,630763513,15532469251,16163232764,122,1008,2,14901705738,In > Out
Sept 2021,90,24,39,8028186,344707619,352735805,23,39,2,336679433,In > Out
Sept 2021,90,25,22,1043591,25656741,26700332,15,22,1,24613150,In > Out
Sept 2021,90,253,8473,2531785488,18960047030,21491832518,1039,7466,6,16428261542,In > Out
Sept 2021,90,27,1184,150010043,3555445279,3705455322,407,1142,6,3405435236,In > Out
Sept 2021,90,29,1,832657,29741,862398,1,1,1,802916,Out > In
Sept 2021,90,31,530,44806543,908830815,953637358,158,523,2,864024272,In > Out
Sept 2021,90,32,5592,702148960,13310945261,14013094221,341,4903,3,12608796301,In > Out
Sept 2021,90,34,591,36440987,791072991,827513978,241,578,3,754632004,In > Out
Sept 2021,90,36,3,345889,553320,899209,3,3,1,207431,In > Out
Sept 2021,90,39,103,195508162,299857359,495365521,61,103,4,104349197,In > Out
Sept 2021,90,40,810,73214382,2950510467,3023724849,186,793,2,2877296085,In > Out
Sept 2021,90,42,10,415589,22124839,22540428,4,10,1,21709250,In > Out
Sept 2021,90,45,132,17828314,667487558,685315872,34,132,2,649659244,In > Out
Sept 2021,90,47,1400,166103255,694278679,860381934,266,1366,2,528175424,In > Out
Sept 2021,90,49,144,22599655,1154865802,1177465457,50,144,2,1132266147,In > Out
Sept 2021,90,52,45,2102479,27842989,29945468,33,45,1,25740510,In > Out
Sept 2021,90,53,20,18034717,845389780,863424497,13,20,2,827355063,In > Out
Sept 2021,90,54,813,103662051,1424702220,1528364271,117,796,3,1321040169,In > Out
Sept 2021,90,55,1,33200,74080,107280,1,1,1,40880,In > Out
Sept 2021,90,6,1,167085,15745694,15912779,1,1,1,15578609,In > Out
Sept 2021,90,62,380,29710400,551719349,581429749,115,379,2,522008949,In > Out
Sept 2021,90,69,3,780020,1551317,2331337,3,3,1,771297,In > Out
Sept 2021,90,7,3,523769,44903,568672,1,3,1,478866,Out > In
Sept 2021,90,71,1,168333,21589,189922,1,1,1,146744,Out > In
Sept 2021,90,72,477,549818871,1207293056,1757111927,161,472,5,657474185,In > Out
Sept 2021,90,73,76,6266654,7551850,13818504,32,76,2,1285196,In > Out
Sept 2021,90,76,805,97406399,2954135565,3051541964,153,786,2,2856729166,In > Out
Sept 2021,90,80,551,76395341,1032281134,1108676475,199,369,2,955885793,In > Out
Sept 2021,90,82,1602,143271614,3739629888,3882901502,73,1508,2,3596358274,In > Out
Sept 2021,90,84,8,450573,729595,1180168,2,8,1,279022,In > Out
Sept 2021,90,86,2,197710,40671,238381,1,2,1,157039,Out > In
Sept 2021,90,87,111,672845036,1483492810,2156337846,59,111,4,810647774,In > Out
Sept 2021,90,90,40,4021204,101992402,106013606,21,40,1,97971198,In > Out
Sept 2021,90,92,7,714540,32245509,32960049,5,7,1,31530969,In > Out
Sept 2021,90,97,2,71386,584740,656126,2,2,1,513354,In > Out
Sept 2021,91,10,9,951426,78133456,79084882,5,9,2,77182030,In > Out
Sept 2021,91,104,21,761816,25395346,26157162,10,21,2,24633530,In > Out
Sept 2021,91,113,75,2221868,279615949,281837817,19,75,2,277394081,In > Out
Sept 2021,91,117,2389,486893378,7349015615,7835908993,632,2216,4,6862122237,In > Out
Sept 2021,91,119,100,11957555,574205806,586163361,32,100,2,562248251,In > Out
Sept 2021,91,120,117,11628617,420811541,432440158,34,117,2,409182924,In > Out
Sept 2021,91,121,251,23225809,210574093,233799902,94,251,2,187348284,In > Out
Sept 2021,91,122,67,6002217,472034545,478036762,32,67,2,466032328,In > Out
Sept 2021,91,123,419,13024052,1461502705,1474526757,52,419,2,1448478653,In > Out
Sept 2021,91,125,140,5288861,101913854,107202715,16,139,2,96624993,In > Out
Sept 2021,91,13,133,11947061,554658023,566605084,36,133,2,542710962,In > Out
Sept 2021,91,131,1359,149204095,1411184954,1560389049,420,1302,3,1261980859,In > Out
Sept 2021,91,135,181,7354602,224801133,232155735,93,181,2,217446531,In > Out
Sept 2021,91,138,919,68089507,4531736355,4599825862,71,919,2,4463646848,In > Out
Sept 2021,91,139,1235,198405036,1371903787,1570308823,186,1203,4,1173498751,In > Out
Sept 2021,91,145,286,27064950,1998934678,2025999628,83,285,2,1971869728,In > Out
Sept 2021,91,146,497,6442013,600177478,606619491,35,497,2,593735465,In > Out
Sept 2021,91,148,469,57724882,634632165,692357047,159,467,4,576907283,In > Out
Sept 2021,91,150,779,120264632,1569151948,1689416580,237,762,3,1448887316,In > Out
Sept 2021,91,151,2112,396564543,1655495624,2052060167,231,1970,6,1258931081,In > Out
Sept 2021,91,154,840,132462379,5025463440,5157925819,241,805,2,4893001061,In > Out
Sept 2021,91,156,1038,916141548,44192109740,45108251288,515,564,377,43275968192,In > Out
Sept 2021,91,16,89,11977058,642148318,654125376,26,89,2,630171260,In > Out
Sept 2021,91,162,332,40027173,1873420659,1913447832,47,332,2,1833393486,In > Out
Sept 2021,91,168,342,47088339,2498138592,2545226931,59,341,2,2451050253,In > Out
Sept 2021,91,17,31,16547026,880763569,897310595,9,31,2,864216543,In > Out
Sept 2021,91,184,1698,1453658811,8007980374,9461639185,543,1602,13,6554321563,In > Out
Sept 2021,91,19,24,2332329,343011015,345343344,8,24,2,340678686,In > Out
Sept 2021,91,20,112,29442419,1033659368,1063101787,40,112,2,1004216949,In > Out
Sept 2021,91,200,27,1765298,271518416,273283714,9,27,2,269753118,In > Out
Sept 2021,91,225,147,31528895,1817038959,1848567854,17,147,2,1785510064,In > Out
Sept 2021,91,227,10,2215351,91756008,93971359,5,10,2,89540657,In > Out
Sept 2021,91,228,11,348759,69150637,69499396,6,11,2,68801878,In > Out
Sept 2021,91,27,14,832993,125176364,126009357,10,14,2,124343371,In > Out
Sept 2021,91,37,307,33254292,1449081316,1482335608,56,307,2,1415827024,In > Out
Sept 2021,91,40,98,7465076,887671671,895136747,16,98,2,880206595,In > Out
Sept 2021,91,46,431,54610924,983550915,1038161839,48,431,2,928939991,In > Out
Sept 2021,91,48,856,113313305,4555413807,4668727112,62,838,2,4442100502,In > Out
Sept 2021,91,60,367,23744651,1997551487,2021296138,55,367,2,1973806836,In > Out
Sept 2021,91,62,239,19943394,636711977,656655371,105,239,3,616768583,In > Out
Sept 2021,91,64,401,79425219,555019050,634444269,140,399,2,475593831,In > Out
Sept 2021,91,71,40,3390032,335218798,338608830,12,40,2,331828766,In > Out
Sept 2021,91,78,309,20667422,2804241841,2824909263,56,309,2,2783574419,In > Out
Sept 2021,91,87,94,10800145,415746370,426546515,32,94,2,404946225,In > Out
Sept 2021,91,94,7,258378,81575572,81833950,5,7,2,81317194,In > Out
Sept 2021,92,225,5,1146942,217104,1364046,5,5,2,929838,Out > In
Sept 2021,92,228,288,350203270,369143950,719347220,51,285,2,18940680,In > Out
Sept 2021,92,250,76,8537597,278725701,287263298,18,76,2,270188104,In > Out
Sept 2021,92,51,119,15419844,285573595,300993439,38,119,3,270153751,In > Out
Sept 2021,94,22,711,329567652,41172140,370739792,55,631,635,288395512,Out > In
Sept 2021,94,25,14,1837984,22975675,24813659,2,8,2,21137691,In > Out
Sept 2021,94,51,1050,1213670459,25303112,1238973571,1,1034,935,1188367347,Out > In
Sept 2021,96,125,5,10633354,545179,11178533,5,1,5,10088175,Out > In
Sept 2021,96,183,1,1316774,15206,1331980,1,1,1,1301568,Out > In
Sept 2021,96,192,1,253356,363972,617328,1,1,1,110616,In > Out
Sept 2021,96,193,89,11054279990,2256607236,13310887226,57,1,88,8797672754,Out > In
Sept 2021,96,60,8,25588284,9330666,34918950,8,1,8,16257618,Out > In
Sept 2021,96,78,50,164295977,3615742,167911719,18,2,50,160680235,Out > In
Sept 2021,98,10,203,80069712,716204846,796274558,102,202,7,636135134,In > Out
Sept 2021,98,101,25,4432997,52519702,56952699,19,25,1,48086705,In > Out
Sept 2021,98,102,670,932392628,6466245163,7398637791,214,665,7,5533852535,In > Out
Sept 2021,98,104,406,265682066,1225889636,1491571702,169,403,7,960207570,In > Out
Sept 2021,98,107,293,37106616,1863141267,1900247883,130,290,5,1826034651,In > Out
Sept 2021,98,108,908,105935854,6655518988,6761454842,215,894,3,6549583134,In > Out
Sept 2021,98,11,1343,674334629,4541376121,5215710750,417,1297,9,3867041492,In > Out
Sept 2021,98,110,40,1410030,53653575,55063605,27,40,2,52243545,In > Out
Sept 2021,98,111,704,1273143679,5086211089,6359354768,267,689,20,3813067410,In > Out
Sept 2021,98,113,1222,116551648,5376240905,5492792553,200,1180,7,5259689257,In > Out
Sept 2021,98,114,860,476465051,3164070050,3640535101,245,839,8,2687604999,In > Out
Sept 2021,98,115,570,69545367,3209414989,3278960356,137,559,4,3139869622,In > Out
Sept 2021,98,12,291,93425757,842705989,936131746,112,291,4,749280232,In > Out
Sept 2021,98,120,615,318396028,2836496127,3154892155,151,610,3,2518100099,In > Out
Sept 2021,98,122,198,34151010,207395395,241546405,112,198,4,173244385,In > Out
Sept 2021,98,123,590,771513908,6009981728,6781495636,228,583,9,5238467820,In > Out
Sept 2021,98,124,861,121445421,4022070018,4143515439,279,851,4,3900624597,In > Out
Sept 2021,98,125,844,436861485,4766227973,5203089458,248,820,4,4329366488,In > Out
Sept 2021,98,126,909,1431900530,2194614669,3626515199,243,891,14,762714139,In > Out
Sept 2021,98,128,244,83363719,291867496,375231215,97,240,9,208503777,In > Out
Sept 2021,98,13,859,1068084442,1661515452,2729599894,298,846,6,593431010,In > Out
Sept 2021,98,130,501,125692704,2742922173,2868614877,174,497,8,2617229469,In > Out
Sept 2021,98,132,766,528628634,2534701285,3063329919,273,764,6,2006072651,In > Out
Sept 2021,98,133,707,168387297,1403167892,1571555189,220,703,6,1234780595,In > Out
Sept 2021,98,134,1517,2562029334,13542519859,16104549193,396,1469,24,10980490525,In > Out
Sept 2021,98,135,407,71563509,865247278,936810787,120,406,4,793683769,In > Out
Sept 2021,98,136,221,127815251,1637397824,1765213075,156,219,3,1509582573,In > Out
Sept 2021,98,137,938,3882352132,21453909895,25336262027,266,930,11,17571557763,In > Out
Sept 2021,98,138,1158,341239958,9713790194,10055030152,277,1134,5,9372550236,In > Out
Sept 2021,98,139,645,334710417,2417234806,2751945223,230,623,8,2082524389,In > Out
Sept 2021,98,14,411,84348704,1603220141,1687568845,188,406,3,1518871437,In > Out
Sept 2021,98,140,575,569830561,4489917417,5059747978,150,566,6,3920086856,In > Out
Sept 2021,98,141,512,119911838,9027383251,9147295089,143,509,5,8907471413,In > Out
Sept 2021,98,142,900,430612833,2464277744,2894890577,241,886,7,2033664911,In > Out
Sept 2021,98,143,262,195676278,1006377564,1202053842,97,262,6,810701286,In > Out
Sept 2021,98,145,935,225372005,7593522462,7818894467,269,902,4,7368150457,In > Out
Sept 2021,98,146,1406,303866256,9649592880,9953459136,332,1284,5,9345726624,In > Out
Sept 2021,98,147,1041,237574156,25878063955,26115638111,318,1017,1,25640489799,In > Out
Sept 2021,98,148,644,160632415,10726896204,10887528619,224,628,7,10566263789,In > Out
Sept 2021,98,149,450,102372491,1833248755,1935621246,172,447,7,1730876264,In > Out
Sept 2021,98,15,1405,1298235962,11221273664,12519509626,387,1340,7,9923037702,In > Out
Sept 2021,98,150,945,1532992529,5159413861,6692406390,233,934,4,3626421332,In > Out
Sept 2021,98,152,228,65793566,969330428,1035123994,74,228,6,903536862,In > Out
Sept 2021,98,153,303,48693402,1326946268,1375639670,177,303,6,1278252866,In > Out
Sept 2021,98,154,885,840479977,12402468872,13242948849,227,881,6,11561988895,In > Out
Sept 2021,98,156,871,147376598,3168492748,3315869346,209,851,5,3021116150,In > Out
Sept 2021,98,157,344,1081505967,1499635327,2581141294,136,342,7,418129360,In > Out
Sept 2021,98,16,578,167605152,2547498070,2715103222,195,575,4,2379892918,In > Out
Sept 2021,98,162,674,63386832,2985068097,3048454929,254,661,5,2921681265,In > Out
Sept 2021,98,163,667,76995644,2737535738,2814531382,226,661,5,2660540094,In > Out
Sept 2021,98,164,560,571625377,10724830032,11296455409,202,549,9,10153204655,In > Out
Sept 2021,98,168,608,209546570,5124807745,5334354315,245,598,4,4915261175,In > Out
Sept 2021,98,169,729,130814625,4449636677,4580451302,228,713,2,4318822052,In > Out
Sept 2021,98,17,878,218149769,5231045316,5449195085,207,848,11,5012895547,In > Out
Sept 2021,98,170,769,1072859180,3479324158,4552183338,197,742,5,2406464978,In > Out
Sept 2021,98,171,2768,1640646741,48709756429,50350403170,675,2729,11,47069109688,In > Out
Sept 2021,98,172,557,184713367,3239918011,3424631378,184,554,11,3055204644,In > Out
Sept 2021,98,173,383,145002217,3125965090,3270967307,102,382,6,2980962873,In > Out
Sept 2021,98,177,228,54423227,2013406140,2067829367,85,228,3,1958982913,In > Out
Sept 2021,98,179,835,228369347,3101273796,3329643143,252,832,4,2872904449,In > Out
Sept 2021,98,18,505,224379965,2334832411,2559212376,221,500,5,2110452446,In > Out
Sept 2021,98,180,98,7735372,509783842,517519214,44,98,2,502048470,In > Out
Sept 2021,98,181,1169,415466562,5594282407,6009748969,321,1149,6,5178815845,In > Out
Sept 2021,98,182,1416,922953282,7083170987,8006124269,448,1341,8,6160217705,In > Out
Sept 2021,98,184,356,220756203,925172648,1145928851,137,355,8,704416445,In > Out
Sept 2021,98,185,671,526422594,6630837541,7157260135,232,664,8,6104414947,In > Out
Sept 2021,98,186,688,818219991,3051893525,3870113516,251,687,5,2233673534,In > Out
Sept 2021,98,188,426,159904466,2211075895,2370980361,187,424,11,2051171429,In > Out
Sept 2021,98,194,216,24418926,529226504,553645430,115,215,4,504807578,In > Out
Sept 2021,98,195,758,114017804,3543958627,3657976431,147,747,6,3429940823,In > Out
Sept 2021,98,196,436,236660893,1679925070,1916585963,168,432,4,1443264177,In > Out
Sept 2021,98,198,635,386384289,6133426553,6519810842,210,590,5,5747042264,In > Out
Sept 2021,98,199,917,288802759,6606408077,6895210836,269,888,6,6317605318,In > Out
Sept 2021,98,20,226,28710315,819772513,848482828,84,225,2,791062198,In > Out
Sept 2021,98,200,725,63818951,5254521017,5318339968,235,721,5,5190702066,In > Out
Sept 2021,98,203,911,94631382,2633848053,2728479435,290,903,6,2539216671,In > Out
Sept 2021,98,204,320,89772809,621169674,710942483,127,314,5,531396865,In > Out
Sept 2021,98,206,1181,347156125,6682725400,7029881525,221,1151,5,6335569275,In > Out
Sept 2021,98,208,792,182405456,2999692138,3182097594,244,752,3,2817286682,In > Out
Sept 2021,98,210,1601,442584119,6546652465,6989236584,375,1551,9,6104068346,In > Out
Sept 2021,98,211,238,25325681,344111595,369437276,85,238,4,318785914,In > Out
Sept 2021,98,212,510,770863014,2304464759,3075327773,161,499,5,1533601745,In > Out
Sept 2021,98,216,464,146701916,4314500429,4461202345,171,457,4,4167798513,In > Out
Sept 2021,98,219,1155,214768787,7901736981,8116505768,312,1118,8,7686968194,In > Out
Sept 2021,98,22,78,14369846,105240990,119610836,42,78,4,90871144,In > Out
Sept 2021,98,220,572,299697257,1487351154,1787048411,209,563,5,1187653897,In > Out
Sept 2021,98,221,1272,170855320,2402265372,2573120692,196,1244,5,2231410052,In > Out
Sept 2021,98,222,462,151172265,2888592967,3039765232,118,460,5,2737420702,In > Out
Sept 2021,98,223,354,97553675,3356037161,3453590836,139,346,5,3258483486,In > Out
Sept 2021,98,23,503,980673062,2265418713,3246091775,151,490,21,1284745651,In > Out
Sept 2021,98,26,957,115140369,2888110069,3003250438,214,943,4,2772969700,In > Out
Sept 2021,98,27,1734,594379088,9594550490,10188929578,140,1728,7,9000171402,In > Out
Sept 2021,98,28,385,79329900,2304115302,2383445202,124,380,3,2224785402,In > Out
Sept 2021,98,29,928,496569187,10156869415,10653438602,286,909,9,9660300228,In > Out
Sept 2021,98,30,1314,231306662,7159975936,7391282598,419,1267,9,6928669274,In > Out
Sept 2021,98,31,670,147396489,2893460549,3040857038,208,654,6,2746064060,In > Out
Sept 2021,98,34,501,555935413,2870641394,3426576807,243,497,23,2314705981,In > Out
Sept 2021,98,35,927,619013112,9700064515,10319077627,351,902,4,9081051403,In > Out
Sept 2021,98,37,339,33012165,866787881,899800046,151,338,6,833775716,In > Out
Sept 2021,98,4,592,47034983,1184154379,1231189362,142,592,5,1137119396,In > Out
Sept 2021,98,40,600,260184515,1670288046,1930472561,168,589,21,1410103531,In > Out
Sept 2021,98,43,2238,377577010,18486367347,18863944357,456,2054,6,18108790337,In > Out
Sept 2021,98,44,1271,861951260,13059583833,13921535093,362,1239,6,12197632573,In > Out
Sept 2021,98,46,1029,182991418,2295282354,2478273772,286,1016,3,2112290936,In > Out
Sept 2021,98,49,857,196044833,5795338780,5991383613,361,849,3,5599293947,In > Out
Sept 2021,98,54,306,95068970,1277466551,1372535521,135,304,5,1182397581,In > Out
Sept 2021,98,56,1096,2398693102,4771592679,7170285781,315,1078,6,2372899577,In > Out
Sept 2021,98,57,619,119258041,4198029059,4317287100,155,561,4,4078771018,In > Out
Sept 2021,98,59,1422,2003955050,6230921762,8234876812,377,1383,11,4226966712,In > Out
Sept 2021,98,60,441,66084871,1722374741,1788459612,211,435,5,1656289870,In > Out
Sept 2021,98,61,443,236856233,1868476195,2105332428,167,441,8,1631619962,In > Out
Sept 2021,98,62,1275,6071752342,13496147725,19567900067,262,1240,14,7424395383,In > Out
Sept 2021,98,64,2048,208164932,5425509361,5633674293,363,1956,3,5217344429,In > Out
Sept 2021,98,65,1876,198920167,12162723962,12361644129,446,1788,6,11963803795,In > Out
Sept 2021,98,66,768,1143404901,5504384645,6647789546,245,750,7,4360979744,In > Out
Sept 2021,98,68,1670,282523029,12844462442,13126985471,258,1619,5,12561939413,In > Out
Sept 2021,98,70,1081,117265574,5366605080,5483870654,241,1055,6,5249339506,In > Out
Sept 2021,98,72,937,6747095658,8076508096,14823603754,259,926,7,1329412438,In > Out
Sept 2021,98,73,1662,648512436,4461655066,5110167502,297,1638,4,3813142630,In > Out
Sept 2021,98,76,673,227264773,2844181632,3071446405,193,665,5,2616916859,In > Out
Sept 2021,98,77,764,168828345,14949446968,15118275313,329,755,3,14780618623,In > Out
Sept 2021,98,78,766,358381998,4367815152,4726197150,199,751,6,4009433154,In > Out
Sept 2021,98,79,2125,1042002829,29742654703,30784657532,377,2017,28,28700651874,In > Out
Sept 2021,98,8,367,77567746,1231195177,1308762923,118,366,3,1153627431,In > Out
Sept 2021,98,80,700,384098443,1967106138,2351204581,184,685,9,1583007695,In > Out
Sept 2021,98,81,941,460612058,5391336100,5851948158,325,930,8,4930724042,In > Out
Sept 2021,98,82,845,552902015,4716514408,5269416423,267,829,8,4163612393,In > Out
Sept 2021,98,83,373,183579652,2898397405,3081977057,155,372,8,2714817753,In > Out
Sept 2021,98,86,1307,286792141,12772966796,13059758937,203,1288,6,12486174655,In > Out
Sept 2021,98,87,637,82205024,4962568693,5044773717,250,629,4,4880363669,In > Out
Sept 2021,98,93,262,31829026,993378749,1025207775,112,255,3,961549723,In > Out
Sept 2021,98,94,1781,291938878,15114248875,15406187753,400,1729,3,14822309997,In > Out
Sept 2021,98,96,331,1082391070,1923034198,3005425268,147,330,5,840643128,In > Out
Sept 2021,98,97,670,331463527,3508725366,3840188893,233,655,7,3177261839,In > Out
Sept 2021,98,98,1381,175351670,3649603082,3824954752,411,1317,13,3474251412,In > Out
Sept 2021,98,99,484,87075429,682775298,769850727,111,483,5,595699869,In > Out
Sept 2021,99,119,222,22900695,1981857214,2004757909,72,222,2,1958956519,In > Out
Sept 2021,99,121,75,11190419,622754699,633945118,40,75,2,611564280,In > Out
Sept 2021,99,130,333,12039110,247874266,259913376,72,333,2,235835156,In > Out
Sept 2021,99,136,4807,755806841,5696626328,6452433169,632,4181,3,4940819487,In > Out
Sept 2021,99,153,691,121708270,963244705,1084952975,101,678,2,841536435,In > Out
Sept 2021,99,180,1638,429558599,15665710329,16095268928,296,1566,4,15236151730,In > Out
Sept 2021,99,183,424,71496019,1357660822,1429156841,164,420,4,1286164803,In > Out
Sept 2021,99,244,96,12821807,419971564,432793371,31,96,2,407149757,In > Out
Sept 2021,99,57,63,1458528,92987839,94446367,13,63,2,91529311,In > Out
Sept 2021,99,77,530,65934310,364507113,430441423,127,526,3,298572803,In > Out
